img_name,label_text,x_diff,x_left,x_pixels,y_diff,y_pixels,y_top,label,x_right,y_btm,img_path,x_center,y_center,x_center_scaled,y_center_scaled,width_scaled,height_scaled
2703-2021_03_20_074318.jpg,car,35,510,640,27,360,187,1,545,214,LTAdatasets/2703/annotate/2703-2021_03_20_074318.jpg,527.5,200.5,0.82421875,0.5569444444444445,0.0546875,0.075
2703-2021_03_20_074318.jpg,car,19,421,640,18,360,134,1,440,152,LTAdatasets/2703/annotate/2703-2021_03_20_074318.jpg,430.5,143.0,0.67265625,0.3972222222222222,0.0296875,0.05
2703-2021_03_20_074318.jpg,car,17,441,640,11,360,125,1,458,136,LTAdatasets/2703/annotate/2703-2021_03_20_074318.jpg,449.5,130.5,0.70234375,0.3625,0.0265625,0.030555555555555555
2703-2021_03_20_074318.jpg,car,20,349,640,17,360,116,1,369,133,LTAdatasets/2703/annotate/2703-2021_03_20_074318.jpg,359.0,124.5,0.5609375,0.3458333333333333,0.03125,0.04722222222222222
2703-2021_03_20_074318.jpg,car,36,184,640,23,360,182,1,220,205,LTAdatasets/2703/annotate/2703-2021_03_20_074318.jpg,202.0,193.5,0.315625,0.5375,0.05625,0.06388888888888888
2703-2021_03_20_074318.jpg,car,17,402,640,11,360,112,1,419,123,LTAdatasets/2703/annotate/2703-2021_03_20_074318.jpg,410.5,117.5,0.64140625,0.3263888888888889,0.0265625,0.030555555555555555
2703-2021_03_20_074318.jpg,lorry_truck,19,454,640,15,360,111,2,473,126,LTAdatasets/2703/annotate/2703-2021_03_20_074318.jpg,463.5,118.5,0.72421875,0.32916666666666666,0.0296875,0.041666666666666664
2703-2021_03_20_182451.jpg,lorry_truck,56,39,640,39,360,226,2,95,265,LTAdatasets/2703/annotate/2703-2021_03_20_182451.jpg,67.0,245.5,0.1046875,0.6819444444444445,0.0875,0.10833333333333334
2703-2021_03_20_182451.jpg,lorry_truck,30,262,640,17,360,114,2,292,131,LTAdatasets/2703/annotate/2703-2021_03_20_182451.jpg,277.0,122.5,0.4328125,0.3402777777777778,0.046875,0.04722222222222222
2703-2021_03_20_182451.jpg,lorry_truck,27,453,640,22,360,107,2,480,129,LTAdatasets/2703/annotate/2703-2021_03_20_182451.jpg,466.5,118.0,0.72890625,0.3277777777777778,0.0421875,0.06111111111111111
2703-2021_03_20_182451.jpg,car,14,429,640,12,360,112,1,443,124,LTAdatasets/2703/annotate/2703-2021_03_20_182451.jpg,436.0,118.0,0.68125,0.3277777777777778,0.021875,0.03333333333333333
2703-2021_03_20_182451.jpg,car,51,100,640,45,360,227,1,151,272,LTAdatasets/2703/annotate/2703-2021_03_20_182451.jpg,125.5,249.5,0.19609375,0.6930555555555555,0.0796875,0.125
2703-2021_03_20_182451.jpg,car,40,140,640,23,360,191,1,180,214,LTAdatasets/2703/annotate/2703-2021_03_20_182451.jpg,160.0,202.5,0.25,0.5625,0.0625,0.06388888888888888
2703-2021_03_20_182451.jpg,car,33,218,640,28,360,171,1,251,199,LTAdatasets/2703/annotate/2703-2021_03_20_182451.jpg,234.5,185.0,0.36640625,0.5138888888888888,0.0515625,0.07777777777777778
2703-2021_03_20_182451.jpg,car,23,411,640,16,360,123,1,434,139,LTAdatasets/2703/annotate/2703-2021_03_20_182451.jpg,422.5,131.0,0.66015625,0.3638888888888889,0.0359375,0.044444444444444446
2703-2021_03_20_182451.jpg,lorry_truck,21,260,640,23,360,130,2,281,153,LTAdatasets/2703/annotate/2703-2021_03_20_182451.jpg,270.5,141.5,0.42265625,0.39305555555555555,0.0328125,0.06388888888888888
2703-2021_03_20_182451.jpg,bus,21,237,640,19,360,130,5,258,149,LTAdatasets/2703/annotate/2703-2021_03_20_182451.jpg,247.5,139.5,0.38671875,0.3875,0.0328125,0.05277777777777778
2703-2021_03_20_182451.jpg,car,36,73,640,19,360,179,1,109,198,LTAdatasets/2703/annotate/2703-2021_03_20_182451.jpg,91.0,188.5,0.1421875,0.5236111111111111,0.05625,0.05277777777777778
2703-2021_03_20_182451.jpg,lorry_truck,14,375,640,18,360,101,2,389,119,LTAdatasets/2703/annotate/2703-2021_03_20_182451.jpg,382.0,110.0,0.596875,0.3055555555555556,0.021875,0.05
2703-2021_03_20_095205.jpg,van,31,350,640,28,360,156,3,381,184,LTAdatasets/2703/annotate/2703-2021_03_20_095205.jpg,365.5,170.0,0.57109375,0.4722222222222222,0.0484375,0.07777777777777778
2703-2021_03_20_095205.jpg,car,26,221,640,16,360,159,1,247,175,LTAdatasets/2703/annotate/2703-2021_03_20_095205.jpg,234.0,167.0,0.365625,0.4638888888888889,0.040625,0.044444444444444446
2703-2021_03_20_095205.jpg,car,41,138,640,28,360,199,1,179,227,LTAdatasets/2703/annotate/2703-2021_03_20_095205.jpg,158.5,213.0,0.24765625,0.5916666666666667,0.0640625,0.07777777777777778
2703-2021_03_20_095205.jpg,bike,23,528,640,24,360,158,4,551,182,LTAdatasets/2703/annotate/2703-2021_03_20_095205.jpg,539.5,170.0,0.84296875,0.4722222222222222,0.0359375,0.06666666666666667
2703-2021_03_20_095205.jpg,car,26,483,640,23,360,131,1,509,154,LTAdatasets/2703/annotate/2703-2021_03_20_095205.jpg,496.0,142.5,0.775,0.3958333333333333,0.040625,0.06388888888888888
2703-2021_03_20_095205.jpg,car,21,426,640,15,360,109,1,447,124,LTAdatasets/2703/annotate/2703-2021_03_20_095205.jpg,436.5,116.5,0.68203125,0.3236111111111111,0.0328125,0.041666666666666664
2703-2021_03_20_095205.jpg,car,21,339,640,15,360,124,1,360,139,LTAdatasets/2703/annotate/2703-2021_03_20_095205.jpg,349.5,131.5,0.54609375,0.36527777777777776,0.0328125,0.041666666666666664
2703-2021_03_20_095205.jpg,lorry_truck,15,374,640,20,360,118,2,389,138,LTAdatasets/2703/annotate/2703-2021_03_20_095205.jpg,381.5,128.0,0.59609375,0.35555555555555557,0.0234375,0.05555555555555555
2703-2021_03_20_095205.jpg,lorry_truck,47,128,640,22,360,141,2,175,163,LTAdatasets/2703/annotate/2703-2021_03_20_095205.jpg,151.5,152.0,0.23671875,0.4222222222222222,0.0734375,0.06111111111111111
2703-2021_03_20_095205.jpg,lorry_truck,42,28,640,24,360,187,2,70,211,LTAdatasets/2703/annotate/2703-2021_03_20_095205.jpg,49.0,199.0,0.0765625,0.5527777777777778,0.065625,0.06666666666666667
2703-2021_03_20_084001.jpg,car,43,173,640,21,360,187,1,216,208,LTAdatasets/2703/annotate/2703-2021_03_20_084001.jpg,194.5,197.5,0.30390625,0.5486111111111112,0.0671875,0.058333333333333334
2703-2021_03_20_084001.jpg,car,19,371,640,16,360,141,1,390,157,LTAdatasets/2703/annotate/2703-2021_03_20_084001.jpg,380.5,149.0,0.59453125,0.41388888888888886,0.0296875,0.044444444444444446
2703-2021_03_20_084001.jpg,car,43,575,640,41,360,198,1,618,239,LTAdatasets/2703/annotate/2703-2021_03_20_084001.jpg,596.5,218.5,0.93203125,0.6069444444444444,0.0671875,0.11388888888888889
2703-2021_03_20_195736.jpg,bike,21,501,640,17,360,145,4,522,162,LTAdatasets/2703/annotate/2703-2021_03_20_195736.jpg,511.5,153.5,0.79921875,0.4263888888888889,0.0328125,0.04722222222222222
2703-2021_03_20_195736.jpg,car,25,442,640,22,360,128,1,467,150,LTAdatasets/2703/annotate/2703-2021_03_20_195736.jpg,454.5,139.0,0.71015625,0.3861111111111111,0.0390625,0.06111111111111111
2703-2021_03_20_195736.jpg,lorry_truck,19,372,640,25,360,106,2,391,131,LTAdatasets/2703/annotate/2703-2021_03_20_195736.jpg,381.5,118.5,0.59609375,0.32916666666666666,0.0296875,0.06944444444444445
2703-2021_03_20_204018.jpg,bus,59,579,640,100,360,155,5,638,255,LTAdatasets/2703/annotate/2703-2021_03_20_204018.jpg,608.5,205.0,0.95078125,0.5694444444444444,0.0921875,0.2777777777777778
2703-2021_03_20_204018.jpg,car,45,525,640,38,360,208,1,570,246,LTAdatasets/2703/annotate/2703-2021_03_20_204018.jpg,547.5,227.0,0.85546875,0.6305555555555555,0.0703125,0.10555555555555556
2703-2021_03_20_204018.jpg,car,26,455,640,27,360,156,1,481,183,LTAdatasets/2703/annotate/2703-2021_03_20_204018.jpg,468.0,169.5,0.73125,0.4708333333333333,0.040625,0.075
2703-2021_03_20_204018.jpg,car,33,30,640,17,360,199,1,63,216,LTAdatasets/2703/annotate/2703-2021_03_20_204018.jpg,46.5,207.5,0.07265625,0.5763888888888888,0.0515625,0.04722222222222222
2703-2021_03_20_202217.jpg,bike,9,190,640,17,360,137,4,199,154,LTAdatasets/2703/annotate/2703-2021_03_20_202217.jpg,194.5,145.5,0.30390625,0.4041666666666667,0.0140625,0.04722222222222222
2703-2021_03_20_094024.jpg,van,33,442,640,32,360,160,3,475,192,LTAdatasets/2703/annotate/2703-2021_03_20_094024.jpg,458.5,176.0,0.71640625,0.4888888888888889,0.0515625,0.08888888888888889
2703-2021_03_20_094024.jpg,car,19,436,640,18,360,140,1,455,158,LTAdatasets/2703/annotate/2703-2021_03_20_094024.jpg,445.5,149.0,0.69609375,0.41388888888888886,0.0296875,0.05
2703-2021_03_20_094024.jpg,car,29,196,640,21,360,171,1,225,192,LTAdatasets/2703/annotate/2703-2021_03_20_094024.jpg,210.5,181.5,0.32890625,0.5041666666666667,0.0453125,0.058333333333333334
2703-2021_03_20_094024.jpg,bike,20,57,640,21,360,184,4,77,205,LTAdatasets/2703/annotate/2703-2021_03_20_094024.jpg,67.0,194.5,0.1046875,0.5402777777777777,0.03125,0.058333333333333334
2703-2021_03_20_094024.jpg,car,36,281,640,55,360,210,1,317,265,LTAdatasets/2703/annotate/2703-2021_03_20_094024.jpg,299.0,237.5,0.4671875,0.6597222222222222,0.05625,0.1527777777777778
2703-2021_03_20_094024.jpg,lorry_truck,38,602,640,66,360,203,2,640,269,LTAdatasets/2703/annotate/2703-2021_03_20_094024.jpg,621.0,236.0,0.9703125,0.6555555555555556,0.059375,0.18333333333333332
2703-2021_03_20_094024.jpg,car,20,452,640,19,360,130,1,472,149,LTAdatasets/2703/annotate/2703-2021_03_20_094024.jpg,462.0,139.5,0.721875,0.3875,0.03125,0.05277777777777778
2703-2021_03_20_094024.jpg,car,18,367,640,20,360,131,1,385,151,LTAdatasets/2703/annotate/2703-2021_03_20_094024.jpg,376.0,141.0,0.5875,0.39166666666666666,0.028125,0.05555555555555555
2703-2021_03_20_094024.jpg,car,20,463,640,18,360,118,1,483,136,LTAdatasets/2703/annotate/2703-2021_03_20_094024.jpg,473.0,127.0,0.7390625,0.3527777777777778,0.03125,0.05
2703-2021_03_20_094024.jpg,van,33,111,640,20,360,157,3,144,177,LTAdatasets/2703/annotate/2703-2021_03_20_094024.jpg,127.5,167.0,0.19921875,0.4638888888888889,0.0515625,0.05555555555555555
2703-2021_03_20_094024.jpg,lorry_truck,43,221,640,22,360,104,2,264,126,LTAdatasets/2703/annotate/2703-2021_03_20_094024.jpg,242.5,115.0,0.37890625,0.3194444444444444,0.0671875,0.06111111111111111
2703-2021_03_20_094024.jpg,car,20,432,640,17,360,115,1,452,132,LTAdatasets/2703/annotate/2703-2021_03_20_094024.jpg,442.0,123.5,0.690625,0.34305555555555556,0.03125,0.04722222222222222
2703-2021_03_20_090102.jpg,car,28,435,640,20,360,148,1,463,168,LTAdatasets/2703/annotate/2703-2021_03_20_090102.jpg,449.0,158.0,0.7015625,0.4388888888888889,0.04375,0.05555555555555555
2703-2021_03_20_090102.jpg,car,23,472,640,16,360,150,1,495,166,LTAdatasets/2703/annotate/2703-2021_03_20_090102.jpg,483.5,158.0,0.75546875,0.4388888888888889,0.0359375,0.044444444444444446
2703-2021_03_20_090102.jpg,car,48,537,640,55,360,208,1,585,263,LTAdatasets/2703/annotate/2703-2021_03_20_090102.jpg,561.0,235.5,0.8765625,0.6541666666666667,0.075,0.1527777777777778
2703-2021_03_20_090102.jpg,car,24,318,640,31,360,170,1,342,201,LTAdatasets/2703/annotate/2703-2021_03_20_090102.jpg,330.0,185.5,0.515625,0.5152777777777777,0.0375,0.08611111111111111
2703-2021_03_20_090102.jpg,lorry_truck,34,361,640,50,360,135,2,395,185,LTAdatasets/2703/annotate/2703-2021_03_20_090102.jpg,378.0,160.0,0.590625,0.4444444444444444,0.053125,0.1388888888888889
2703-2021_03_20_090102.jpg,car,22,330,640,22,360,138,1,352,160,LTAdatasets/2703/annotate/2703-2021_03_20_090102.jpg,341.0,149.0,0.5328125,0.41388888888888886,0.034375,0.06111111111111111
2703-2021_03_20_090102.jpg,car,16,440,640,12,360,122,1,456,134,LTAdatasets/2703/annotate/2703-2021_03_20_090102.jpg,448.0,128.0,0.7,0.35555555555555557,0.025,0.03333333333333333
2703-2021_03_20_194315.jpg,car,29,180,640,26,360,181,1,209,207,LTAdatasets/2703/annotate/2703-2021_03_20_194315.jpg,194.5,194.0,0.30390625,0.5388888888888889,0.0453125,0.07222222222222222
2703-2021_03_20_194315.jpg,car,25,209,640,16,360,153,1,234,169,LTAdatasets/2703/annotate/2703-2021_03_20_194315.jpg,221.5,161.0,0.34609375,0.44722222222222224,0.0390625,0.044444444444444446
2703-2021_03_20_194315.jpg,car,23,254,640,25,360,161,1,277,186,LTAdatasets/2703/annotate/2703-2021_03_20_194315.jpg,265.5,173.5,0.41484375,0.48194444444444445,0.0359375,0.06944444444444445
2703-2021_03_20_194315.jpg,car,21,255,640,15,360,143,1,276,158,LTAdatasets/2703/annotate/2703-2021_03_20_194315.jpg,265.5,150.5,0.41484375,0.41805555555555557,0.0328125,0.041666666666666664
2703-2021_03_20_194315.jpg,bike,15,524,640,27,360,175,4,539,202,LTAdatasets/2703/annotate/2703-2021_03_20_194315.jpg,531.5,188.5,0.83046875,0.5236111111111111,0.0234375,0.075
2703-2021_03_20_194315.jpg,bike,15,481,640,20,360,157,4,496,177,LTAdatasets/2703/annotate/2703-2021_03_20_194315.jpg,488.5,167.0,0.76328125,0.4638888888888889,0.0234375,0.05555555555555555
2703-2021_03_20_194315.jpg,lorry_truck,32,487,640,23,360,137,2,519,160,LTAdatasets/2703/annotate/2703-2021_03_20_194315.jpg,503.0,148.5,0.7859375,0.4125,0.05,0.06388888888888888
2703-2021_03_20_194315.jpg,lorry_truck,38,293,640,48,360,189,2,331,237,LTAdatasets/2703/annotate/2703-2021_03_20_194315.jpg,312.0,213.0,0.4875,0.5916666666666667,0.059375,0.13333333333333333
2703-2021_03_20_194315.jpg,car,69,528,640,83,360,277,1,597,360,LTAdatasets/2703/annotate/2703-2021_03_20_194315.jpg,562.5,318.5,0.87890625,0.8847222222222222,0.1078125,0.23055555555555557
2703-2021_03_20_194315.jpg,lorry_truck,47,69,640,25,360,167,2,116,192,LTAdatasets/2703/annotate/2703-2021_03_20_194315.jpg,92.5,179.5,0.14453125,0.4986111111111111,0.0734375,0.06944444444444445
2703-2021_03_20_185453.jpg,car,25,462,640,20,360,144,1,487,164,LTAdatasets/2703/annotate/2703-2021_03_20_185453.jpg,474.5,154.0,0.74140625,0.42777777777777776,0.0390625,0.05555555555555555
2703-2021_03_20_185453.jpg,car,26,202,640,22,360,172,1,228,194,LTAdatasets/2703/annotate/2703-2021_03_20_185453.jpg,215.0,183.0,0.3359375,0.5083333333333333,0.040625,0.06111111111111111
2703-2021_03_20_185453.jpg,car,58,128,640,38,360,241,1,186,279,LTAdatasets/2703/annotate/2703-2021_03_20_185453.jpg,157.0,260.0,0.2453125,0.7222222222222222,0.090625,0.10555555555555556
2703-2021_03_20_185453.jpg,car,43,596,640,82,360,267,1,639,349,LTAdatasets/2703/annotate/2703-2021_03_20_185453.jpg,617.5,308.0,0.96484375,0.8555555555555555,0.0671875,0.22777777777777777
2703-2021_03_20_185453.jpg,car,50,0,640,51,360,293,1,50,344,LTAdatasets/2703/annotate/2703-2021_03_20_185453.jpg,25.0,318.5,0.0390625,0.8847222222222222,0.078125,0.14166666666666666
2703-2021_03_20_185453.jpg,car,27,254,640,24,360,157,1,281,181,LTAdatasets/2703/annotate/2703-2021_03_20_185453.jpg,267.5,169.0,0.41796875,0.46944444444444444,0.0421875,0.06666666666666667
2703-2021_03_20_185453.jpg,bike,11,255,640,16,360,136,4,266,152,LTAdatasets/2703/annotate/2703-2021_03_20_185453.jpg,260.5,144.0,0.40703125,0.4,0.0171875,0.044444444444444446
2703-2021_03_20_185453.jpg,car,23,444,640,19,360,126,1,467,145,LTAdatasets/2703/annotate/2703-2021_03_20_185453.jpg,455.5,135.5,0.71171875,0.3763888888888889,0.0359375,0.05277777777777778
2703-2021_03_20_185453.jpg,car,20,476,640,20,360,125,1,496,145,LTAdatasets/2703/annotate/2703-2021_03_20_185453.jpg,486.0,135.0,0.759375,0.375,0.03125,0.05555555555555555
2703-2021_03_20_202758.jpg,car,50,53,640,42,360,258,1,103,300,LTAdatasets/2703/annotate/2703-2021_03_20_202758.jpg,78.0,279.0,0.121875,0.775,0.078125,0.11666666666666667
2703-2021_03_20_202758.jpg,car,75,37,640,48,360,301,1,112,349,LTAdatasets/2703/annotate/2703-2021_03_20_202758.jpg,74.5,325.0,0.11640625,0.9027777777777778,0.1171875,0.13333333333333333
2703-2021_03_20_202758.jpg,car,36,528,640,29,360,176,1,564,205,LTAdatasets/2703/annotate/2703-2021_03_20_202758.jpg,546.0,190.5,0.853125,0.5291666666666667,0.05625,0.08055555555555556
2703-2021_03_20_202758.jpg,bike,13,484,640,19,360,149,4,497,168,LTAdatasets/2703/annotate/2703-2021_03_20_202758.jpg,490.5,158.5,0.76640625,0.44027777777777777,0.0203125,0.05277777777777778
2703-2021_03_20_202758.jpg,bike,22,366,640,23,360,135,4,388,158,LTAdatasets/2703/annotate/2703-2021_03_20_202758.jpg,377.0,146.5,0.5890625,0.40694444444444444,0.034375,0.06388888888888888
2703-2021_03_20_202758.jpg,lorry_truck,24,260,640,15,360,133,2,284,148,LTAdatasets/2703/annotate/2703-2021_03_20_202758.jpg,272.0,140.5,0.425,0.3902777777777778,0.0375,0.041666666666666664
2703-2021_03_20_202758.jpg,bike,18,286,640,12,360,136,4,304,148,LTAdatasets/2703/annotate/2703-2021_03_20_202758.jpg,295.0,142.0,0.4609375,0.39444444444444443,0.028125,0.03333333333333333
2703-2021_03_20_202758.jpg,car,25,4,640,25,360,207,1,29,232,LTAdatasets/2703/annotate/2703-2021_03_20_202758.jpg,16.5,219.5,0.02578125,0.6097222222222223,0.0390625,0.06944444444444445
2703-2021_03_20_090702.jpg,bus,73,154,640,47,360,137,5,227,184,LTAdatasets/2703/annotate/2703-2021_03_20_090702.jpg,190.5,160.5,0.29765625,0.44583333333333336,0.1140625,0.13055555555555556
2703-2021_03_20_090702.jpg,car,27,498,640,21,360,142,1,525,163,LTAdatasets/2703/annotate/2703-2021_03_20_090702.jpg,511.5,152.5,0.79921875,0.4236111111111111,0.0421875,0.058333333333333334
2703-2021_03_20_090702.jpg,car,18,349,640,17,360,123,1,367,140,LTAdatasets/2703/annotate/2703-2021_03_20_090702.jpg,358.0,131.5,0.559375,0.36527777777777776,0.028125,0.04722222222222222
2703-2021_03_20_090702.jpg,lorry_truck,26,246,640,20,360,117,2,272,137,LTAdatasets/2703/annotate/2703-2021_03_20_090702.jpg,259.0,127.0,0.4046875,0.3527777777777778,0.040625,0.05555555555555555
2703-2021_03_20_090702.jpg,car,16,376,640,10,360,108,1,392,118,LTAdatasets/2703/annotate/2703-2021_03_20_090702.jpg,384.0,113.0,0.6,0.3138888888888889,0.025,0.027777777777777776
2703-2021_03_20_090702.jpg,lorry_truck,37,63,640,18,360,176,2,100,194,LTAdatasets/2703/annotate/2703-2021_03_20_090702.jpg,81.5,185.0,0.12734375,0.5138888888888888,0.0578125,0.05
2703-2021_03_20_084601.jpg,car,49,536,640,41,360,215,1,585,256,LTAdatasets/2703/annotate/2703-2021_03_20_084601.jpg,560.5,235.5,0.87578125,0.6541666666666667,0.0765625,0.11388888888888889
2703-2021_03_20_084601.jpg,lorry_truck,17,433,640,16,360,93,2,450,109,LTAdatasets/2703/annotate/2703-2021_03_20_084601.jpg,441.5,101.0,0.68984375,0.28055555555555556,0.0265625,0.044444444444444446
2703-2021_03_20_084601.jpg,car,29,246,640,24,360,159,1,275,183,LTAdatasets/2703/annotate/2703-2021_03_20_084601.jpg,260.5,171.0,0.40703125,0.475,0.0453125,0.06666666666666667
2703-2021_03_20_084601.jpg,lorry_truck,50,112,640,35,360,185,2,162,220,LTAdatasets/2703/annotate/2703-2021_03_20_084601.jpg,137.0,202.5,0.2140625,0.5625,0.078125,0.09722222222222222
2703-2021_03_20_084601.jpg,car,19,294,640,12,360,125,1,313,137,LTAdatasets/2703/annotate/2703-2021_03_20_084601.jpg,303.5,131.0,0.47421875,0.3638888888888889,0.0296875,0.03333333333333333
2703-2021_03_20_084601.jpg,car,23,210,640,9,360,128,1,233,137,LTAdatasets/2703/annotate/2703-2021_03_20_084601.jpg,221.5,132.5,0.34609375,0.3680555555555556,0.0359375,0.025
2703-2021_03_20_084301.jpg,car,43,504,640,34,360,182,1,547,216,LTAdatasets/2703/annotate/2703-2021_03_20_084301.jpg,525.5,199.0,0.82109375,0.5527777777777778,0.0671875,0.09444444444444444
2703-2021_03_20_084301.jpg,lorry_truck,31,492,640,17,360,137,2,523,154,LTAdatasets/2703/annotate/2703-2021_03_20_084301.jpg,507.5,145.5,0.79296875,0.4041666666666667,0.0484375,0.04722222222222222
2703-2021_03_20_084301.jpg,car,44,572,640,44,360,185,1,616,229,LTAdatasets/2703/annotate/2703-2021_03_20_084301.jpg,594.0,207.0,0.928125,0.575,0.06875,0.12222222222222222
2703-2021_03_20_084301.jpg,car,30,453,640,34,360,172,1,483,206,LTAdatasets/2703/annotate/2703-2021_03_20_084301.jpg,468.0,189.0,0.73125,0.525,0.046875,0.09444444444444444
2703-2021_03_20_084301.jpg,car,32,296,640,41,360,192,1,328,233,LTAdatasets/2703/annotate/2703-2021_03_20_084301.jpg,312.0,212.5,0.4875,0.5902777777777778,0.05,0.11388888888888889
2703-2021_03_20_084301.jpg,lorry_truck,29,219,640,21,360,138,2,248,159,LTAdatasets/2703/annotate/2703-2021_03_20_084301.jpg,233.5,148.5,0.36484375,0.4125,0.0453125,0.058333333333333334
2703-2021_03_20_084301.jpg,lorry_truck,24,268,640,17,360,113,2,292,130,LTAdatasets/2703/annotate/2703-2021_03_20_084301.jpg,280.0,121.5,0.4375,0.3375,0.0375,0.04722222222222222
2703-2021_03_20_084301.jpg,car,22,441,640,16,360,128,1,463,144,LTAdatasets/2703/annotate/2703-2021_03_20_084301.jpg,452.0,136.0,0.70625,0.37777777777777777,0.034375,0.044444444444444446
2703-2021_03_20_084301.jpg,van,13,465,640,19,360,115,3,478,134,LTAdatasets/2703/annotate/2703-2021_03_20_084301.jpg,471.5,124.5,0.73671875,0.3458333333333333,0.0203125,0.05277777777777778
2703-2021_03_20_084301.jpg,car,33,25,640,20,360,197,1,58,217,LTAdatasets/2703/annotate/2703-2021_03_20_084301.jpg,41.5,207.0,0.06484375,0.575,0.0515625,0.05555555555555555
2703-2021_03_20_084301.jpg,car,18,410,640,17,360,119,1,428,136,LTAdatasets/2703/annotate/2703-2021_03_20_084301.jpg,419.0,127.5,0.6546875,0.3541666666666667,0.028125,0.04722222222222222
2703-2021_03_20_182151.jpg,car,30,234,640,20,360,150,1,264,170,LTAdatasets/2703/annotate/2703-2021_03_20_182151.jpg,249.0,160.0,0.3890625,0.4444444444444444,0.046875,0.05555555555555555
2703-2021_03_20_182151.jpg,car,19,325,640,29,360,158,1,344,187,LTAdatasets/2703/annotate/2703-2021_03_20_182151.jpg,334.5,172.5,0.52265625,0.4791666666666667,0.0296875,0.08055555555555556
2703-2021_03_20_182151.jpg,van,31,263,640,19,360,148,3,294,167,LTAdatasets/2703/annotate/2703-2021_03_20_182151.jpg,278.5,157.5,0.43515625,0.4375,0.0484375,0.05277777777777778
2703-2021_03_20_182151.jpg,van,26,466,640,23,360,135,3,492,158,LTAdatasets/2703/annotate/2703-2021_03_20_182151.jpg,479.0,146.5,0.7484375,0.40694444444444444,0.040625,0.06388888888888888
2703-2021_03_20_182151.jpg,car,45,270,640,54,360,234,1,315,288,LTAdatasets/2703/annotate/2703-2021_03_20_182151.jpg,292.5,261.0,0.45703125,0.725,0.0703125,0.15
2703-2021_03_20_182151.jpg,van,21,260,640,21,360,126,3,281,147,LTAdatasets/2703/annotate/2703-2021_03_20_182151.jpg,270.5,136.5,0.42265625,0.37916666666666665,0.0328125,0.058333333333333334
2703-2021_03_20_182151.jpg,car,32,506,640,31,360,176,1,538,207,LTAdatasets/2703/annotate/2703-2021_03_20_182151.jpg,522.0,191.5,0.815625,0.5319444444444444,0.05,0.08611111111111111
2703-2021_03_20_182151.jpg,car,40,346,640,50,360,209,1,386,259,LTAdatasets/2703/annotate/2703-2021_03_20_182151.jpg,366.0,234.0,0.571875,0.65,0.0625,0.1388888888888889
2703-2021_03_20_182151.jpg,car,25,203,640,18,360,152,1,228,170,LTAdatasets/2703/annotate/2703-2021_03_20_182151.jpg,215.5,161.0,0.33671875,0.44722222222222224,0.0390625,0.05
2703-2021_03_20_182151.jpg,bike,19,178,640,24,360,189,4,197,213,LTAdatasets/2703/annotate/2703-2021_03_20_182151.jpg,187.5,201.0,0.29296875,0.5583333333333333,0.0296875,0.06666666666666667
2703-2021_03_20_182151.jpg,car,19,341,640,19,360,129,1,360,148,LTAdatasets/2703/annotate/2703-2021_03_20_182151.jpg,350.5,138.5,0.54765625,0.38472222222222224,0.0296875,0.05277777777777778
2703-2021_03_20_182151.jpg,car,15,376,640,15,360,117,1,391,132,LTAdatasets/2703/annotate/2703-2021_03_20_182151.jpg,383.5,124.5,0.59921875,0.3458333333333333,0.0234375,0.041666666666666664
2703-2021_03_20_182151.jpg,car,41,33,640,18,360,198,1,74,216,LTAdatasets/2703/annotate/2703-2021_03_20_182151.jpg,53.5,207.0,0.08359375,0.575,0.0640625,0.05
2703-2021_03_20_182151.jpg,car,20,469,640,15,360,123,1,489,138,LTAdatasets/2703/annotate/2703-2021_03_20_182151.jpg,479.0,130.5,0.7484375,0.3625,0.03125,0.041666666666666664
2703-2021_03_20_092543.jpg,car,21,278,640,12,360,124,1,299,136,LTAdatasets/2703/annotate/2703-2021_03_20_092543.jpg,288.5,130.0,0.45078125,0.3611111111111111,0.0328125,0.03333333333333333
2703-2021_03_20_092543.jpg,car,24,372,640,31,360,111,1,396,142,LTAdatasets/2703/annotate/2703-2021_03_20_092543.jpg,384.0,126.5,0.6,0.35138888888888886,0.0375,0.08611111111111111
2703-2021_03_20_092543.jpg,car,19,400,640,11,360,106,1,419,117,LTAdatasets/2703/annotate/2703-2021_03_20_092543.jpg,409.5,111.5,0.63984375,0.30972222222222223,0.0296875,0.030555555555555555
2703-2021_03_20_092543.jpg,bike,14,447,640,26,360,148,4,461,174,LTAdatasets/2703/annotate/2703-2021_03_20_092543.jpg,454.0,161.0,0.709375,0.44722222222222224,0.021875,0.07222222222222222
2703-2021_03_20_092543.jpg,car,42,538,640,37,360,171,1,580,208,LTAdatasets/2703/annotate/2703-2021_03_20_092543.jpg,559.0,189.5,0.8734375,0.5263888888888889,0.065625,0.10277777777777777
2703-2021_03_20_092543.jpg,car,39,196,640,31,360,189,1,235,220,LTAdatasets/2703/annotate/2703-2021_03_20_092543.jpg,215.5,204.5,0.33671875,0.5680555555555555,0.0609375,0.08611111111111111
2703-2021_03_20_092543.jpg,bike,19,234,640,19,360,140,4,253,159,LTAdatasets/2703/annotate/2703-2021_03_20_092543.jpg,243.5,149.5,0.38046875,0.4152777777777778,0.0296875,0.05277777777777778
2703-2021_03_20_092543.jpg,lorry_truck,44,71,640,26,360,160,2,115,186,LTAdatasets/2703/annotate/2703-2021_03_20_092543.jpg,93.0,173.0,0.1453125,0.48055555555555557,0.06875,0.07222222222222222
2703-2021_03_20_092543.jpg,lorry_truck,108,34,640,70,360,186,2,142,256,LTAdatasets/2703/annotate/2703-2021_03_20_092543.jpg,88.0,221.0,0.1375,0.6138888888888889,0.16875,0.19444444444444445
2703-2021_03_20_092543.jpg,car,15,432,640,14,360,116,1,447,130,LTAdatasets/2703/annotate/2703-2021_03_20_092543.jpg,439.5,123.0,0.68671875,0.3416666666666667,0.0234375,0.03888888888888889
2703-2021_03_20_192735.jpg,car,23,255,640,14,360,162,1,278,176,LTAdatasets/2703/annotate/2703-2021_03_20_192735.jpg,266.5,169.0,0.41640625,0.46944444444444444,0.0359375,0.03888888888888889
2703-2021_03_20_192735.jpg,lorry_truck,30,219,640,32,360,149,2,249,181,LTAdatasets/2703/annotate/2703-2021_03_20_192735.jpg,234.0,165.0,0.365625,0.4583333333333333,0.046875,0.08888888888888889
2703-2021_03_20_192735.jpg,car,57,302,640,60,360,300,1,359,360,LTAdatasets/2703/annotate/2703-2021_03_20_192735.jpg,330.5,330.0,0.51640625,0.9166666666666666,0.0890625,0.16666666666666666
2703-2021_03_20_192735.jpg,lorry_truck,53,88,640,46,360,216,2,141,262,LTAdatasets/2703/annotate/2703-2021_03_20_192735.jpg,114.5,239.0,0.17890625,0.6638888888888889,0.0828125,0.12777777777777777
2703-2021_03_20_192735.jpg,car,62,45,640,48,360,309,1,107,357,LTAdatasets/2703/annotate/2703-2021_03_20_192735.jpg,76.0,333.0,0.11875,0.925,0.096875,0.13333333333333333
2703-2021_03_20_192735.jpg,car,23,187,640,18,360,133,1,210,151,LTAdatasets/2703/annotate/2703-2021_03_20_192735.jpg,198.5,142.0,0.31015625,0.39444444444444443,0.0359375,0.05
2703-2021_03_20_192735.jpg,bike,8,270,640,17,360,124,4,278,141,LTAdatasets/2703/annotate/2703-2021_03_20_192735.jpg,274.0,132.5,0.428125,0.3680555555555556,0.0125,0.04722222222222222
2703-2021_03_20_192735.jpg,car,18,295,640,17,360,126,1,313,143,LTAdatasets/2703/annotate/2703-2021_03_20_192735.jpg,304.0,134.5,0.475,0.3736111111111111,0.028125,0.04722222222222222
2703-2021_03_20_203058.jpg,lorry_truck,50,532,640,42,360,155,2,582,197,LTAdatasets/2703/annotate/2703-2021_03_20_203058.jpg,557.0,176.0,0.8703125,0.4888888888888889,0.078125,0.11666666666666667
2703-2021_03_20_203058.jpg,car,28,478,640,24,360,162,1,506,186,LTAdatasets/2703/annotate/2703-2021_03_20_203058.jpg,492.0,174.0,0.76875,0.48333333333333334,0.04375,0.06666666666666667
2703-2021_03_20_203058.jpg,car,48,592,640,56,360,271,1,640,327,LTAdatasets/2703/annotate/2703-2021_03_20_203058.jpg,616.0,299.0,0.9625,0.8305555555555556,0.075,0.15555555555555556
2703-2021_03_20_203058.jpg,car,24,362,640,26,360,133,1,386,159,LTAdatasets/2703/annotate/2703-2021_03_20_203058.jpg,374.0,146.0,0.584375,0.40555555555555556,0.0375,0.07222222222222222
2703-2021_03_20_203058.jpg,van,31,189,640,32,360,174,3,220,206,LTAdatasets/2703/annotate/2703-2021_03_20_203058.jpg,204.5,190.0,0.31953125,0.5277777777777778,0.0484375,0.08888888888888889
2703-2021_03_20_203058.jpg,lorry_truck,46,123,640,39,360,176,2,169,215,LTAdatasets/2703/annotate/2703-2021_03_20_203058.jpg,146.0,195.5,0.228125,0.5430555555555555,0.071875,0.10833333333333334
2703-2021_03_20_203058.jpg,car,23,462,640,19,360,121,1,485,140,LTAdatasets/2703/annotate/2703-2021_03_20_203058.jpg,473.5,130.5,0.73984375,0.3625,0.0359375,0.05277777777777778
2703-2021_03_20_203058.jpg,car,36,2,640,44,360,308,1,38,352,LTAdatasets/2703/annotate/2703-2021_03_20_203058.jpg,20.0,330.0,0.03125,0.9166666666666666,0.05625,0.12222222222222222
2703-2021_03_20_074618.jpg,car,29,424,640,22,360,135,1,453,157,LTAdatasets/2703/annotate/2703-2021_03_20_074618.jpg,438.5,146.0,0.68515625,0.40555555555555556,0.0453125,0.06111111111111111
2703-2021_03_20_074618.jpg,van,49,512,640,44,360,185,3,561,229,LTAdatasets/2703/annotate/2703-2021_03_20_074618.jpg,536.5,207.0,0.83828125,0.575,0.0765625,0.12222222222222222
2703-2021_03_20_074618.jpg,van,18,428,640,14,360,112,3,446,126,LTAdatasets/2703/annotate/2703-2021_03_20_074618.jpg,437.0,119.0,0.6828125,0.33055555555555555,0.028125,0.03888888888888889
2703-2021_03_20_074618.jpg,car,18,456,640,15,360,114,1,474,129,LTAdatasets/2703/annotate/2703-2021_03_20_074618.jpg,465.0,121.5,0.7265625,0.3375,0.028125,0.041666666666666664
2703-2021_03_20_074618.jpg,bike,12,408,640,14,360,114,4,420,128,LTAdatasets/2703/annotate/2703-2021_03_20_074618.jpg,414.0,121.0,0.646875,0.33611111111111114,0.01875,0.03888888888888889
2703-2021_03_20_195136.jpg,car,21,427,640,18,360,112,1,448,130,LTAdatasets/2703/annotate/2703-2021_03_20_195136.jpg,437.5,121.0,0.68359375,0.33611111111111114,0.0328125,0.05
2703-2021_03_20_195136.jpg,car,31,445,640,26,360,167,1,476,193,LTAdatasets/2703/annotate/2703-2021_03_20_195136.jpg,460.5,180.0,0.71953125,0.5,0.0484375,0.07222222222222222
2703-2021_03_20_195136.jpg,car,31,509,640,23,360,155,1,540,178,LTAdatasets/2703/annotate/2703-2021_03_20_195136.jpg,524.5,166.5,0.81953125,0.4625,0.0484375,0.06388888888888888
2703-2021_03_20_195136.jpg,car,47,593,640,63,360,274,1,640,337,LTAdatasets/2703/annotate/2703-2021_03_20_195136.jpg,616.5,305.5,0.96328125,0.8486111111111111,0.0734375,0.175
2703-2021_03_20_195136.jpg,car,23,354,640,37,360,159,1,377,196,LTAdatasets/2703/annotate/2703-2021_03_20_195136.jpg,365.5,177.5,0.57109375,0.4930555555555556,0.0359375,0.10277777777777777
2703-2021_03_20_195136.jpg,car,28,174,640,21,360,172,1,202,193,LTAdatasets/2703/annotate/2703-2021_03_20_195136.jpg,188.0,182.5,0.29375,0.5069444444444444,0.04375,0.058333333333333334
2703-2021_03_20_195136.jpg,car,22,1,640,41,360,278,1,23,319,LTAdatasets/2703/annotate/2703-2021_03_20_195136.jpg,12.0,298.5,0.01875,0.8291666666666667,0.034375,0.11388888888888889
2703-2021_03_20_195136.jpg,bike,14,409,640,14,360,117,4,423,131,LTAdatasets/2703/annotate/2703-2021_03_20_195136.jpg,416.0,124.0,0.65,0.34444444444444444,0.021875,0.03888888888888889
2703-2021_03_20_081920.jpg,car,22,424,640,19,360,141,1,446,160,LTAdatasets/2703/annotate/2703-2021_03_20_081920.jpg,435.0,150.5,0.6796875,0.41805555555555557,0.034375,0.05277777777777778
2703-2021_03_20_081920.jpg,car,25,443,640,25,360,124,1,468,149,LTAdatasets/2703/annotate/2703-2021_03_20_081920.jpg,455.5,136.5,0.71171875,0.37916666666666665,0.0390625,0.06944444444444445
2703-2021_03_20_080119.jpg,van,24,441,640,20,360,126,3,465,146,LTAdatasets/2703/annotate/2703-2021_03_20_080119.jpg,453.0,136.0,0.7078125,0.37777777777777777,0.0375,0.05555555555555555
2703-2021_03_20_080119.jpg,lorry_truck,54,468,640,58,360,172,2,522,230,LTAdatasets/2703/annotate/2703-2021_03_20_080119.jpg,495.0,201.0,0.7734375,0.5583333333333333,0.084375,0.16111111111111112
2703-2021_03_20_080119.jpg,bike,21,574,640,30,360,182,4,595,212,LTAdatasets/2703/annotate/2703-2021_03_20_080119.jpg,584.5,197.0,0.91328125,0.5472222222222223,0.0328125,0.08333333333333333
2703-2021_03_20_080119.jpg,van,43,597,640,96,360,255,3,640,351,LTAdatasets/2703/annotate/2703-2021_03_20_080119.jpg,618.5,303.0,0.96640625,0.8416666666666667,0.0671875,0.26666666666666666
2703-2021_03_20_080119.jpg,car,26,237,640,29,360,164,1,263,193,LTAdatasets/2703/annotate/2703-2021_03_20_080119.jpg,250.0,178.5,0.390625,0.49583333333333335,0.040625,0.08055555555555556
2703-2021_03_20_091623.jpg,van,23,451,640,20,360,110,3,474,130,LTAdatasets/2703/annotate/2703-2021_03_20_091623.jpg,462.5,120.0,0.72265625,0.3333333333333333,0.0359375,0.05555555555555555
2703-2021_03_20_091623.jpg,van,32,505,640,31,360,145,3,537,176,LTAdatasets/2703/annotate/2703-2021_03_20_091623.jpg,521.0,160.5,0.8140625,0.44583333333333336,0.05,0.08611111111111111
2703-2021_03_20_091623.jpg,bus,29,251,640,32,360,105,5,280,137,LTAdatasets/2703/annotate/2703-2021_03_20_091623.jpg,265.5,121.0,0.41484375,0.33611111111111114,0.0453125,0.08888888888888889
2703-2021_03_20_091623.jpg,car,23,149,640,20,360,146,1,172,166,LTAdatasets/2703/annotate/2703-2021_03_20_091623.jpg,160.5,156.0,0.25078125,0.43333333333333335,0.0359375,0.05555555555555555
2703-2021_03_20_091623.jpg,lorry_truck,81,37,640,51,360,237,2,118,288,LTAdatasets/2703/annotate/2703-2021_03_20_091623.jpg,77.5,262.5,0.12109375,0.7291666666666666,0.1265625,0.14166666666666666
2703-2021_03_20_193115.jpg,car,53,138,640,37,360,236,1,191,273,LTAdatasets/2703/annotate/2703-2021_03_20_193115.jpg,164.5,254.5,0.25703125,0.7069444444444445,0.0828125,0.10277777777777777
2703-2021_03_20_193115.jpg,car,25,286,640,18,360,134,1,311,152,LTAdatasets/2703/annotate/2703-2021_03_20_193115.jpg,298.5,143.0,0.46640625,0.3972222222222222,0.0390625,0.05
2703-2021_03_20_193115.jpg,car,62,47,640,39,360,270,1,109,309,LTAdatasets/2703/annotate/2703-2021_03_20_193115.jpg,78.0,289.5,0.121875,0.8041666666666667,0.096875,0.10833333333333334
2703-2021_03_20_193115.jpg,car,22,204,640,16,360,132,1,226,148,LTAdatasets/2703/annotate/2703-2021_03_20_193115.jpg,215.0,140.0,0.3359375,0.3888888888888889,0.034375,0.044444444444444446
2703-2021_03_20_193115.jpg,car,29,350,640,34,360,185,1,379,219,LTAdatasets/2703/annotate/2703-2021_03_20_193115.jpg,364.5,202.0,0.56953125,0.5611111111111111,0.0453125,0.09444444444444444
2703-2021_03_20_193115.jpg,car,16,370,640,18,360,144,1,386,162,LTAdatasets/2703/annotate/2703-2021_03_20_193115.jpg,378.0,153.0,0.590625,0.425,0.025,0.05
2703-2021_03_20_193115.jpg,car,24,432,640,22,360,147,1,456,169,LTAdatasets/2703/annotate/2703-2021_03_20_193115.jpg,444.0,158.0,0.69375,0.4388888888888889,0.0375,0.06111111111111111
2703-2021_03_20_193115.jpg,car,22,455,640,19,360,118,1,477,137,LTAdatasets/2703/annotate/2703-2021_03_20_193115.jpg,466.0,127.5,0.728125,0.3541666666666667,0.034375,0.05277777777777778
2703-2021_03_20_193115.jpg,lorry_truck,18,272,640,15,360,130,2,290,145,LTAdatasets/2703/annotate/2703-2021_03_20_193115.jpg,281.0,137.5,0.4390625,0.3819444444444444,0.028125,0.041666666666666664
2703-2021_03_20_073717.jpg,car,21,450,640,18,360,134,1,471,152,LTAdatasets/2703/annotate/2703-2021_03_20_073717.jpg,460.5,143.0,0.71953125,0.3972222222222222,0.0328125,0.05
2703-2021_03_20_073717.jpg,lorry_truck,21,426,640,19,360,128,2,447,147,LTAdatasets/2703/annotate/2703-2021_03_20_073717.jpg,436.5,137.5,0.68203125,0.3819444444444444,0.0328125,0.05277777777777778
2703-2021_03_20_073717.jpg,car,21,488,640,25,360,134,1,509,159,LTAdatasets/2703/annotate/2703-2021_03_20_073717.jpg,498.5,146.5,0.77890625,0.40694444444444444,0.0328125,0.06944444444444445
2703-2021_03_20_073717.jpg,van,28,356,640,39,360,181,3,384,220,LTAdatasets/2703/annotate/2703-2021_03_20_073717.jpg,370.0,200.5,0.578125,0.5569444444444445,0.04375,0.10833333333333334
2703-2021_03_20_073717.jpg,lorry_truck,19,375,640,22,360,112,2,394,134,LTAdatasets/2703/annotate/2703-2021_03_20_073717.jpg,384.5,123.0,0.60078125,0.3416666666666667,0.0296875,0.06111111111111111
2703-2021_03_20_073717.jpg,car,16,423,640,11,360,110,1,439,121,LTAdatasets/2703/annotate/2703-2021_03_20_073717.jpg,431.0,115.5,0.6734375,0.32083333333333336,0.025,0.030555555555555555
2703-2021_03_20_094305.jpg,lorry_truck,28,476,640,21,360,128,2,504,149,LTAdatasets/2703/annotate/2703-2021_03_20_094305.jpg,490.0,138.5,0.765625,0.38472222222222224,0.04375,0.058333333333333334
2703-2021_03_20_094305.jpg,car,30,169,640,29,360,185,1,199,214,LTAdatasets/2703/annotate/2703-2021_03_20_094305.jpg,184.0,199.5,0.2875,0.5541666666666667,0.046875,0.08055555555555556
2703-2021_03_20_094305.jpg,bike,12,501,640,19,360,154,4,513,173,LTAdatasets/2703/annotate/2703-2021_03_20_094305.jpg,507.0,163.5,0.7921875,0.45416666666666666,0.01875,0.05277777777777778
2703-2021_03_20_094305.jpg,car,31,350,640,41,360,193,1,381,234,LTAdatasets/2703/annotate/2703-2021_03_20_094305.jpg,365.5,213.5,0.57109375,0.5930555555555556,0.0484375,0.11388888888888889
2703-2021_03_20_094305.jpg,car,28,227,640,23,360,177,1,255,200,LTAdatasets/2703/annotate/2703-2021_03_20_094305.jpg,241.0,188.5,0.3765625,0.5236111111111111,0.04375,0.06388888888888888
2703-2021_03_20_094305.jpg,car,28,229,640,19,360,152,1,257,171,LTAdatasets/2703/annotate/2703-2021_03_20_094305.jpg,243.0,161.5,0.3796875,0.4486111111111111,0.04375,0.05277777777777778
2703-2021_03_20_094305.jpg,car,30,120,640,19,360,154,1,150,173,LTAdatasets/2703/annotate/2703-2021_03_20_094305.jpg,135.0,163.5,0.2109375,0.45416666666666666,0.046875,0.05277777777777778
2703-2021_03_20_094305.jpg,car,83,29,640,51,360,302,1,112,353,LTAdatasets/2703/annotate/2703-2021_03_20_094305.jpg,70.5,327.5,0.11015625,0.9097222222222222,0.1296875,0.14166666666666666
2703-2021_03_20_094305.jpg,car,15,304,640,14,360,122,1,319,136,LTAdatasets/2703/annotate/2703-2021_03_20_094305.jpg,311.5,129.0,0.48671875,0.35833333333333334,0.0234375,0.03888888888888889
2703-2021_03_20_094305.jpg,lorry_truck,20,270,640,18,360,118,2,290,136,LTAdatasets/2703/annotate/2703-2021_03_20_094305.jpg,280.0,127.0,0.4375,0.3527777777777778,0.03125,0.05
2703-2021_03_20_094305.jpg,van,20,433,640,19,360,116,3,453,135,LTAdatasets/2703/annotate/2703-2021_03_20_094305.jpg,443.0,125.5,0.6921875,0.3486111111111111,0.03125,0.05277777777777778
2703-2021_03_20_094305.jpg,van,40,29,640,22,360,189,3,69,211,LTAdatasets/2703/annotate/2703-2021_03_20_094305.jpg,49.0,200.0,0.0765625,0.5555555555555556,0.0625,0.06111111111111111
2703-2021_03_20_094305.jpg,car,23,186,640,19,360,129,1,209,148,LTAdatasets/2703/annotate/2703-2021_03_20_094305.jpg,197.5,138.5,0.30859375,0.38472222222222224,0.0359375,0.05277777777777778
2703-2021_03_20_094305.jpg,lorry_truck,21,217,640,19,360,116,2,238,135,LTAdatasets/2703/annotate/2703-2021_03_20_094305.jpg,227.5,125.5,0.35546875,0.3486111111111111,0.0328125,0.05277777777777778
2703-2021_03_20_093424.jpg,car,60,538,640,65,360,292,1,598,357,LTAdatasets/2703/annotate/2703-2021_03_20_093424.jpg,568.0,324.5,0.8875,0.9013888888888889,0.09375,0.18055555555555555
2703-2021_03_20_093424.jpg,car,46,557,640,53,360,229,1,603,282,LTAdatasets/2703/annotate/2703-2021_03_20_093424.jpg,580.0,255.5,0.90625,0.7097222222222223,0.071875,0.14722222222222223
2703-2021_03_20_093424.jpg,van,41,599,640,73,360,209,3,640,282,LTAdatasets/2703/annotate/2703-2021_03_20_093424.jpg,619.5,245.5,0.96796875,0.6819444444444445,0.0640625,0.20277777777777778
2703-2021_03_20_093424.jpg,car,30,462,640,37,360,175,1,492,212,LTAdatasets/2703/annotate/2703-2021_03_20_093424.jpg,477.0,193.5,0.7453125,0.5375,0.046875,0.10277777777777777
2703-2021_03_20_093424.jpg,car,32,475,640,24,360,154,1,507,178,LTAdatasets/2703/annotate/2703-2021_03_20_093424.jpg,491.0,166.0,0.7671875,0.46111111111111114,0.05,0.06666666666666667
2703-2021_03_20_093424.jpg,car,47,240,640,57,360,251,1,287,308,LTAdatasets/2703/annotate/2703-2021_03_20_093424.jpg,263.5,279.5,0.41171875,0.7763888888888889,0.0734375,0.15833333333333333
2703-2021_03_20_093424.jpg,car,13,423,640,20,360,128,1,436,148,LTAdatasets/2703/annotate/2703-2021_03_20_093424.jpg,429.5,138.0,0.67109375,0.38333333333333336,0.0203125,0.05555555555555555
2703-2021_03_20_093424.jpg,van,24,363,640,25,360,133,3,387,158,LTAdatasets/2703/annotate/2703-2021_03_20_093424.jpg,375.0,145.5,0.5859375,0.4041666666666667,0.0375,0.06944444444444445
2703-2021_03_20_190634.jpg,car,37,571,640,37,360,194,1,608,231,LTAdatasets/2703/annotate/2703-2021_03_20_190634.jpg,589.5,212.5,0.92109375,0.5902777777777778,0.0578125,0.10277777777777777
2703-2021_03_20_190634.jpg,car,48,118,640,35,360,221,1,166,256,LTAdatasets/2703/annotate/2703-2021_03_20_190634.jpg,142.0,238.5,0.221875,0.6625,0.075,0.09722222222222222
2703-2021_03_20_190634.jpg,car,42,195,640,28,360,208,1,237,236,LTAdatasets/2703/annotate/2703-2021_03_20_190634.jpg,216.0,222.0,0.3375,0.6166666666666667,0.065625,0.07777777777777778
2703-2021_03_20_190634.jpg,bike,23,250,640,34,360,261,4,273,295,LTAdatasets/2703/annotate/2703-2021_03_20_190634.jpg,261.5,278.0,0.40859375,0.7722222222222223,0.0359375,0.09444444444444444
2703-2021_03_20_190634.jpg,car,32,444,640,32,360,159,1,476,191,LTAdatasets/2703/annotate/2703-2021_03_20_190634.jpg,460.0,175.0,0.71875,0.4861111111111111,0.05,0.08888888888888889
2703-2021_03_20_190634.jpg,car,45,525,640,32,360,206,1,570,238,LTAdatasets/2703/annotate/2703-2021_03_20_190634.jpg,547.5,222.0,0.85546875,0.6166666666666667,0.0703125,0.08888888888888889
2703-2021_03_20_190634.jpg,car,29,259,640,16,360,149,1,288,165,LTAdatasets/2703/annotate/2703-2021_03_20_190634.jpg,273.5,157.0,0.42734375,0.4361111111111111,0.0453125,0.044444444444444446
2703-2021_03_20_190634.jpg,car,34,31,640,15,360,201,1,65,216,LTAdatasets/2703/annotate/2703-2021_03_20_190634.jpg,48.0,208.5,0.075,0.5791666666666667,0.053125,0.041666666666666664
2703-2021_03_20_083640.jpg,car,45,529,640,45,360,199,1,574,244,LTAdatasets/2703/annotate/2703-2021_03_20_083640.jpg,551.5,221.5,0.86171875,0.6152777777777778,0.0703125,0.125
2703-2021_03_20_083640.jpg,car,27,466,640,32,360,182,1,493,214,LTAdatasets/2703/annotate/2703-2021_03_20_083640.jpg,479.5,198.0,0.74921875,0.55,0.0421875,0.08888888888888889
2703-2021_03_20_083640.jpg,car,28,414,640,15,360,129,1,442,144,LTAdatasets/2703/annotate/2703-2021_03_20_083640.jpg,428.0,136.5,0.66875,0.37916666666666665,0.04375,0.041666666666666664
2703-2021_03_20_083640.jpg,lorry_truck,19,459,640,22,360,109,2,478,131,LTAdatasets/2703/annotate/2703-2021_03_20_083640.jpg,468.5,120.0,0.73203125,0.3333333333333333,0.0296875,0.06111111111111111
2703-2021_03_20_090402.jpg,lorry_truck,29,494,640,17,360,137,2,523,154,LTAdatasets/2703/annotate/2703-2021_03_20_090402.jpg,508.5,145.5,0.79453125,0.4041666666666667,0.0453125,0.04722222222222222
2703-2021_03_20_090402.jpg,car,53,159,640,33,360,211,1,212,244,LTAdatasets/2703/annotate/2703-2021_03_20_090402.jpg,185.5,227.5,0.28984375,0.6319444444444444,0.0828125,0.09166666666666666
2703-2021_03_20_090402.jpg,lorry_truck,66,304,640,84,360,255,2,370,339,LTAdatasets/2703/annotate/2703-2021_03_20_090402.jpg,337.0,297.0,0.5265625,0.825,0.103125,0.23333333333333334
2703-2021_03_20_090402.jpg,lorry_truck,46,527,640,44,360,172,2,573,216,LTAdatasets/2703/annotate/2703-2021_03_20_090402.jpg,550.0,194.0,0.859375,0.5388888888888889,0.071875,0.12222222222222222
2703-2021_03_20_090402.jpg,bike,31,549,640,51,360,272,4,580,323,LTAdatasets/2703/annotate/2703-2021_03_20_090402.jpg,564.5,297.5,0.88203125,0.8263888888888888,0.0484375,0.14166666666666666
2703-2021_03_20_090402.jpg,bike,2,511,640,2,360,147,4,513,149,LTAdatasets/2703/annotate/2703-2021_03_20_090402.jpg,512.0,148.0,0.8,0.4111111111111111,0.003125,0.005555555555555556
2703-2021_03_20_090402.jpg,van,21,451,640,17,360,126,3,472,143,LTAdatasets/2703/annotate/2703-2021_03_20_090402.jpg,461.5,134.5,0.72109375,0.3736111111111111,0.0328125,0.04722222222222222
2703-2021_03_20_090402.jpg,bike,19,226,640,16,360,155,4,245,171,LTAdatasets/2703/annotate/2703-2021_03_20_090402.jpg,235.5,163.0,0.36796875,0.4527777777777778,0.0296875,0.044444444444444446
2703-2021_03_20_090402.jpg,bike,14,415,640,13,360,118,4,429,131,LTAdatasets/2703/annotate/2703-2021_03_20_090402.jpg,422.0,124.5,0.659375,0.3458333333333333,0.021875,0.03611111111111111
2703-2021_03_20_090402.jpg,car,17,425,640,15,360,135,1,442,150,LTAdatasets/2703/annotate/2703-2021_03_20_090402.jpg,433.5,142.5,0.67734375,0.3958333333333333,0.0265625,0.041666666666666664
2703-2021_03_20_090402.jpg,car,18,276,640,10,360,130,1,294,140,LTAdatasets/2703/annotate/2703-2021_03_20_090402.jpg,285.0,135.0,0.4453125,0.375,0.028125,0.027777777777777776
2703-2021_03_20_090402.jpg,lorry_truck,37,185,640,15,360,125,2,222,140,LTAdatasets/2703/annotate/2703-2021_03_20_090402.jpg,203.5,132.5,0.31796875,0.3680555555555556,0.0578125,0.041666666666666664
2703-2021_03_20_185753.jpg,car,34,166,640,19,360,199,1,200,218,LTAdatasets/2703/annotate/2703-2021_03_20_185753.jpg,183.0,208.5,0.2859375,0.5791666666666667,0.053125,0.05277777777777778
2703-2021_03_20_185753.jpg,bike,21,157,640,21,360,176,4,178,197,LTAdatasets/2703/annotate/2703-2021_03_20_185753.jpg,167.5,186.5,0.26171875,0.5180555555555556,0.0328125,0.058333333333333334
2703-2021_03_20_185753.jpg,car,38,470,640,37,360,199,1,508,236,LTAdatasets/2703/annotate/2703-2021_03_20_185753.jpg,489.0,217.5,0.7640625,0.6041666666666666,0.059375,0.10277777777777777
2703-2021_03_20_185753.jpg,bus,30,436,640,30,360,93,5,466,123,LTAdatasets/2703/annotate/2703-2021_03_20_185753.jpg,451.0,108.0,0.7046875,0.3,0.046875,0.08333333333333333
2703-2021_03_20_185753.jpg,van,25,242,640,21,360,141,3,267,162,LTAdatasets/2703/annotate/2703-2021_03_20_185753.jpg,254.5,151.5,0.39765625,0.42083333333333334,0.0390625,0.058333333333333334
2703-2021_03_20_185753.jpg,bike,7,274,640,16,360,133,4,281,149,LTAdatasets/2703/annotate/2703-2021_03_20_185753.jpg,277.5,141.0,0.43359375,0.39166666666666666,0.0109375,0.044444444444444446
2703-2021_03_20_180410.jpg,car,26,538,640,21,360,175,1,564,196,LTAdatasets/2703/annotate/2703-2021_03_20_180410.jpg,551.0,185.5,0.8609375,0.5152777777777777,0.040625,0.058333333333333334
2703-2021_03_20_180410.jpg,car,36,506,640,27,360,191,1,542,218,LTAdatasets/2703/annotate/2703-2021_03_20_180410.jpg,524.0,204.5,0.81875,0.5680555555555555,0.05625,0.075
2703-2021_03_20_180410.jpg,car,45,499,640,56,360,238,1,544,294,LTAdatasets/2703/annotate/2703-2021_03_20_180410.jpg,521.5,266.0,0.81484375,0.7388888888888889,0.0703125,0.15555555555555556
2703-2021_03_20_180410.jpg,van,24,491,640,25,360,132,3,515,157,LTAdatasets/2703/annotate/2703-2021_03_20_180410.jpg,503.0,144.5,0.7859375,0.4013888888888889,0.0375,0.06944444444444445
2703-2021_03_20_180410.jpg,car,18,296,640,12,360,127,1,314,139,LTAdatasets/2703/annotate/2703-2021_03_20_180410.jpg,305.0,133.0,0.4765625,0.36944444444444446,0.028125,0.03333333333333333
2703-2021_03_20_180410.jpg,car,21,250,640,16,360,140,1,271,156,LTAdatasets/2703/annotate/2703-2021_03_20_180410.jpg,260.5,148.0,0.40703125,0.4111111111111111,0.0328125,0.044444444444444446
2703-2021_03_20_180410.jpg,car,25,188,640,16,360,134,1,213,150,LTAdatasets/2703/annotate/2703-2021_03_20_180410.jpg,200.5,142.0,0.31328125,0.39444444444444443,0.0390625,0.044444444444444446
2703-2021_03_20_180410.jpg,bike,7,271,640,10,360,124,4,278,134,LTAdatasets/2703/annotate/2703-2021_03_20_180410.jpg,274.5,129.0,0.42890625,0.35833333333333334,0.0109375,0.027777777777777776
2703-2021_03_20_192515.jpg,car,20,254,640,12,360,141,1,274,153,LTAdatasets/2703/annotate/2703-2021_03_20_192515.jpg,264.0,147.0,0.4125,0.4083333333333333,0.03125,0.03333333333333333
2703-2021_03_20_192515.jpg,car,45,28,640,35,360,284,1,73,319,LTAdatasets/2703/annotate/2703-2021_03_20_192515.jpg,50.5,301.5,0.07890625,0.8375,0.0703125,0.09722222222222222
2703-2021_03_20_192515.jpg,car,14,297,640,13,360,128,1,311,141,LTAdatasets/2703/annotate/2703-2021_03_20_192515.jpg,304.0,134.5,0.475,0.3736111111111111,0.021875,0.03611111111111111
2703-2021_03_20_192515.jpg,car,22,181,640,11,360,142,1,203,153,LTAdatasets/2703/annotate/2703-2021_03_20_192515.jpg,192.0,147.5,0.3,0.4097222222222222,0.034375,0.030555555555555555
2703-2021_03_20_192515.jpg,lorry_truck,37,78,640,18,360,174,2,115,192,LTAdatasets/2703/annotate/2703-2021_03_20_192515.jpg,96.5,183.0,0.15078125,0.5083333333333333,0.0578125,0.05
2703-2021_03_20_192515.jpg,car,20,433,640,14,360,119,1,453,133,LTAdatasets/2703/annotate/2703-2021_03_20_192515.jpg,443.0,126.0,0.6921875,0.35,0.03125,0.03888888888888889
2703-2021_03_20_182752.jpg,car,31,542,640,25,360,169,1,573,194,LTAdatasets/2703/annotate/2703-2021_03_20_182752.jpg,557.5,181.5,0.87109375,0.5041666666666667,0.0484375,0.06944444444444445
2703-2021_03_20_182752.jpg,car,26,471,640,23,360,155,1,497,178,LTAdatasets/2703/annotate/2703-2021_03_20_182752.jpg,484.0,166.5,0.75625,0.4625,0.040625,0.06388888888888888
2703-2021_03_20_182752.jpg,car,17,488,640,18,360,132,1,505,150,LTAdatasets/2703/annotate/2703-2021_03_20_182752.jpg,496.5,141.0,0.77578125,0.39166666666666666,0.0265625,0.05
2703-2021_03_20_182752.jpg,car,31,609,640,47,360,220,1,640,267,LTAdatasets/2703/annotate/2703-2021_03_20_182752.jpg,624.5,243.5,0.97578125,0.6763888888888889,0.0484375,0.13055555555555556
2703-2021_03_20_182752.jpg,car,25,323,640,28,360,160,1,348,188,LTAdatasets/2703/annotate/2703-2021_03_20_182752.jpg,335.5,174.0,0.52421875,0.48333333333333334,0.0390625,0.07777777777777778
2703-2021_03_20_182752.jpg,bike,15,220,640,14,360,168,4,235,182,LTAdatasets/2703/annotate/2703-2021_03_20_182752.jpg,227.5,175.0,0.35546875,0.4861111111111111,0.0234375,0.03888888888888889
2703-2021_03_20_182752.jpg,bike,15,245,640,15,360,153,4,260,168,LTAdatasets/2703/annotate/2703-2021_03_20_182752.jpg,252.5,160.5,0.39453125,0.44583333333333336,0.0234375,0.041666666666666664
2703-2021_03_20_182752.jpg,car,21,199,640,21,360,154,1,220,175,LTAdatasets/2703/annotate/2703-2021_03_20_182752.jpg,209.5,164.5,0.32734375,0.45694444444444443,0.0328125,0.058333333333333334
2703-2021_03_20_182752.jpg,car,72,1,640,43,360,289,1,73,332,LTAdatasets/2703/annotate/2703-2021_03_20_182752.jpg,37.0,310.5,0.0578125,0.8625,0.1125,0.11944444444444445
2703-2021_03_20_182752.jpg,lorry_truck,20,246,640,24,360,126,2,266,150,LTAdatasets/2703/annotate/2703-2021_03_20_182752.jpg,256.0,138.0,0.4,0.38333333333333336,0.03125,0.06666666666666667
2703-2021_03_20_183412.jpg,car,57,136,640,41,360,232,1,193,273,LTAdatasets/2703/annotate/2703-2021_03_20_183412.jpg,164.5,252.5,0.25703125,0.7013888888888888,0.0890625,0.11388888888888889
2703-2021_03_20_183412.jpg,car,25,435,640,21,360,151,1,460,172,LTAdatasets/2703/annotate/2703-2021_03_20_183412.jpg,447.5,161.5,0.69921875,0.4486111111111111,0.0390625,0.058333333333333334
2703-2021_03_20_183412.jpg,car,31,480,640,25,360,163,1,511,188,LTAdatasets/2703/annotate/2703-2021_03_20_183412.jpg,495.5,175.5,0.77421875,0.4875,0.0484375,0.06944444444444445
2703-2021_03_20_183412.jpg,car,26,447,640,19,360,130,1,473,149,LTAdatasets/2703/annotate/2703-2021_03_20_183412.jpg,460.0,139.5,0.71875,0.3875,0.040625,0.05277777777777778
2703-2021_03_20_183412.jpg,car,29,208,640,20,360,171,1,237,191,LTAdatasets/2703/annotate/2703-2021_03_20_183412.jpg,222.5,181.0,0.34765625,0.5027777777777778,0.0453125,0.05555555555555555
2703-2021_03_20_183412.jpg,lorry_truck,22,482,640,19,360,129,2,504,148,LTAdatasets/2703/annotate/2703-2021_03_20_183412.jpg,493.0,138.5,0.7703125,0.38472222222222224,0.034375,0.05277777777777778
2703-2021_03_20_183412.jpg,car,40,327,640,61,360,242,1,367,303,LTAdatasets/2703/annotate/2703-2021_03_20_183412.jpg,347.0,272.5,0.5421875,0.7569444444444444,0.0625,0.16944444444444445
2703-2021_03_20_183412.jpg,car,62,563,640,56,360,250,1,625,306,LTAdatasets/2703/annotate/2703-2021_03_20_183412.jpg,594.0,278.0,0.928125,0.7722222222222223,0.096875,0.15555555555555556
2703-2021_03_20_183412.jpg,bus,57,141,640,30,360,130,5,198,160,LTAdatasets/2703/annotate/2703-2021_03_20_183412.jpg,169.5,145.0,0.26484375,0.4027777777777778,0.0890625,0.08333333333333333
2703-2021_03_20_183412.jpg,lorry_truck,48,25,640,32,360,181,2,73,213,LTAdatasets/2703/annotate/2703-2021_03_20_183412.jpg,49.0,197.0,0.0765625,0.5472222222222223,0.075,0.08888888888888889
2703-2021_03_20_091002.jpg,car,28,504,640,28,360,178,1,532,206,LTAdatasets/2703/annotate/2703-2021_03_20_091002.jpg,518.0,192.0,0.809375,0.5333333333333333,0.04375,0.07777777777777778
2703-2021_03_20_091002.jpg,lorry_truck,21,372,640,19,360,129,2,393,148,LTAdatasets/2703/annotate/2703-2021_03_20_091002.jpg,382.5,138.5,0.59765625,0.38472222222222224,0.0328125,0.05277777777777778
2703-2021_03_20_091002.jpg,lorry_truck,34,191,640,25,360,151,2,225,176,LTAdatasets/2703/annotate/2703-2021_03_20_091002.jpg,208.0,163.5,0.325,0.45416666666666666,0.053125,0.06944444444444445
2703-2021_03_20_091002.jpg,lorry_truck,21,255,640,14,360,126,2,276,140,LTAdatasets/2703/annotate/2703-2021_03_20_091002.jpg,265.5,133.0,0.41484375,0.36944444444444446,0.0328125,0.03888888888888889
2703-2021_03_20_091002.jpg,lorry_truck,18,374,640,16,360,107,2,392,123,LTAdatasets/2703/annotate/2703-2021_03_20_091002.jpg,383.0,115.0,0.5984375,0.3194444444444444,0.028125,0.044444444444444446
2703-2021_03_20_091002.jpg,lorry_truck,12,350,640,20,360,105,2,362,125,LTAdatasets/2703/annotate/2703-2021_03_20_091002.jpg,356.0,115.0,0.55625,0.3194444444444444,0.01875,0.05555555555555555
2703-2021_03_20_200416.jpg,car,26,263,640,14,360,133,1,289,147,LTAdatasets/2703/annotate/2703-2021_03_20_200416.jpg,276.0,140.0,0.43125,0.3888888888888889,0.040625,0.03888888888888889
2703-2021_03_20_200416.jpg,car,22,343,640,22,360,135,1,365,157,LTAdatasets/2703/annotate/2703-2021_03_20_200416.jpg,354.0,146.0,0.553125,0.40555555555555556,0.034375,0.06111111111111111
2703-2021_03_20_200416.jpg,car,28,488,640,24,360,164,1,516,188,LTAdatasets/2703/annotate/2703-2021_03_20_200416.jpg,502.0,176.0,0.784375,0.4888888888888889,0.04375,0.06666666666666667
2703-2021_03_20_200416.jpg,car,27,256,640,18,360,157,1,283,175,LTAdatasets/2703/annotate/2703-2021_03_20_200416.jpg,269.5,166.0,0.42109375,0.46111111111111114,0.0421875,0.05
2703-2021_03_20_200416.jpg,lorry_truck,36,170,640,25,360,165,2,206,190,LTAdatasets/2703/annotate/2703-2021_03_20_200416.jpg,188.0,177.5,0.29375,0.4930555555555556,0.05625,0.06944444444444445
2703-2021_03_20_080939.jpg,car,77,510,640,79,360,251,1,587,330,LTAdatasets/2703/annotate/2703-2021_03_20_080939.jpg,548.5,290.5,0.85703125,0.8069444444444445,0.1203125,0.21944444444444444
2703-2021_03_20_080939.jpg,car,37,512,640,31,360,191,1,549,222,LTAdatasets/2703/annotate/2703-2021_03_20_080939.jpg,530.5,206.5,0.82890625,0.5736111111111111,0.0578125,0.08611111111111111
2703-2021_03_20_080939.jpg,car,30,437,640,24,360,158,1,467,182,LTAdatasets/2703/annotate/2703-2021_03_20_080939.jpg,452.0,170.0,0.70625,0.4722222222222222,0.046875,0.06666666666666667
2703-2021_03_20_080939.jpg,car,19,458,640,14,360,145,1,477,159,LTAdatasets/2703/annotate/2703-2021_03_20_080939.jpg,467.5,152.0,0.73046875,0.4222222222222222,0.0296875,0.03888888888888889
2703-2021_03_20_080939.jpg,car,49,129,640,30,360,245,1,178,275,LTAdatasets/2703/annotate/2703-2021_03_20_080939.jpg,153.5,260.0,0.23984375,0.7222222222222222,0.0765625,0.08333333333333333
2703-2021_03_20_080939.jpg,car,24,215,640,12,360,152,1,239,164,LTAdatasets/2703/annotate/2703-2021_03_20_080939.jpg,227.0,158.0,0.3546875,0.4388888888888889,0.0375,0.03333333333333333
2703-2021_03_20_080939.jpg,van,20,438,640,13,360,120,3,458,133,LTAdatasets/2703/annotate/2703-2021_03_20_080939.jpg,448.0,126.5,0.7,0.35138888888888886,0.03125,0.03611111111111111
2703-2021_03_20_080939.jpg,lorry_truck,20,466,640,20,360,115,2,486,135,LTAdatasets/2703/annotate/2703-2021_03_20_080939.jpg,476.0,125.0,0.74375,0.3472222222222222,0.03125,0.05555555555555555
2703-2021_03_20_093103.jpg,car,18,460,640,15,360,137,1,478,152,LTAdatasets/2703/annotate/2703-2021_03_20_093103.jpg,469.0,144.5,0.7328125,0.4013888888888889,0.028125,0.041666666666666664
2703-2021_03_20_093103.jpg,car,23,502,640,19,360,147,1,525,166,LTAdatasets/2703/annotate/2703-2021_03_20_093103.jpg,513.5,156.5,0.80234375,0.43472222222222223,0.0359375,0.05277777777777778
2703-2021_03_20_093103.jpg,car,48,542,640,54,360,218,1,590,272,LTAdatasets/2703/annotate/2703-2021_03_20_093103.jpg,566.0,245.0,0.884375,0.6805555555555556,0.075,0.15
2703-2021_03_20_093103.jpg,car,33,131,640,24,360,190,1,164,214,LTAdatasets/2703/annotate/2703-2021_03_20_093103.jpg,147.5,202.0,0.23046875,0.5611111111111111,0.0515625,0.06666666666666667
2703-2021_03_20_093103.jpg,car,18,407,640,17,360,109,1,425,126,LTAdatasets/2703/annotate/2703-2021_03_20_093103.jpg,416.0,117.5,0.65,0.3263888888888889,0.028125,0.04722222222222222
2703-2021_03_20_184613.jpg,car,63,113,640,49,360,255,1,176,304,LTAdatasets/2703/annotate/2703-2021_03_20_184613.jpg,144.5,279.5,0.22578125,0.7763888888888889,0.0984375,0.1361111111111111
2703-2021_03_20_184613.jpg,car,47,63,640,36,360,250,1,110,286,LTAdatasets/2703/annotate/2703-2021_03_20_184613.jpg,86.5,268.0,0.13515625,0.7444444444444445,0.0734375,0.1
2703-2021_03_20_184613.jpg,car,27,317,640,25,360,164,1,344,189,LTAdatasets/2703/annotate/2703-2021_03_20_184613.jpg,330.5,176.5,0.51640625,0.49027777777777776,0.0421875,0.06944444444444445
2703-2021_03_20_184613.jpg,car,32,232,640,25,360,165,1,264,190,LTAdatasets/2703/annotate/2703-2021_03_20_184613.jpg,248.0,177.5,0.3875,0.4930555555555556,0.05,0.06944444444444445
2703-2021_03_20_184613.jpg,bike,12,363,640,16,360,144,4,375,160,LTAdatasets/2703/annotate/2703-2021_03_20_184613.jpg,369.0,152.0,0.5765625,0.4222222222222222,0.01875,0.044444444444444446
2703-2021_03_20_184613.jpg,lorry_truck,25,478,640,19,360,128,2,503,147,LTAdatasets/2703/annotate/2703-2021_03_20_184613.jpg,490.5,137.5,0.76640625,0.3819444444444444,0.0390625,0.05277777777777778
2703-2021_03_20_184613.jpg,car,20,258,640,16,360,135,1,278,151,LTAdatasets/2703/annotate/2703-2021_03_20_184613.jpg,268.0,143.0,0.41875,0.3972222222222222,0.03125,0.044444444444444446
2703-2021_03_20_193935.jpg,car,38,522,640,43,360,190,1,560,233,LTAdatasets/2703/annotate/2703-2021_03_20_193935.jpg,541.0,211.5,0.8453125,0.5875,0.059375,0.11944444444444445
2703-2021_03_20_193935.jpg,car,56,32,640,37,360,275,1,88,312,LTAdatasets/2703/annotate/2703-2021_03_20_193935.jpg,60.0,293.5,0.09375,0.8152777777777778,0.0875,0.10277777777777777
2703-2021_03_20_193935.jpg,car,62,41,640,45,360,312,1,103,357,LTAdatasets/2703/annotate/2703-2021_03_20_193935.jpg,72.0,334.5,0.1125,0.9291666666666667,0.096875,0.125
2703-2021_03_20_193935.jpg,car,24,218,640,19,360,185,1,242,204,LTAdatasets/2703/annotate/2703-2021_03_20_193935.jpg,230.0,194.5,0.359375,0.5402777777777777,0.0375,0.05277777777777778
2703-2021_03_20_193935.jpg,car,14,250,640,11,360,133,1,264,144,LTAdatasets/2703/annotate/2703-2021_03_20_193935.jpg,257.0,138.5,0.4015625,0.38472222222222224,0.021875,0.030555555555555555
2703-2021_03_20_193935.jpg,bike,14,266,640,17,360,142,4,280,159,LTAdatasets/2703/annotate/2703-2021_03_20_193935.jpg,273.0,150.5,0.4265625,0.41805555555555557,0.021875,0.04722222222222222
2703-2021_03_20_193935.jpg,car,28,483,640,17,360,137,1,511,154,LTAdatasets/2703/annotate/2703-2021_03_20_193935.jpg,497.0,145.5,0.7765625,0.4041666666666667,0.04375,0.04722222222222222
2703-2021_03_20_072817.jpg,lorry_truck,45,486,640,41,360,161,2,531,202,LTAdatasets/2703/annotate/2703-2021_03_20_072817.jpg,508.5,181.5,0.79453125,0.5041666666666667,0.0703125,0.11388888888888889
2703-2021_03_20_072817.jpg,bike,9,421,640,20,360,125,4,430,145,LTAdatasets/2703/annotate/2703-2021_03_20_072817.jpg,425.5,135.0,0.66484375,0.375,0.0140625,0.05555555555555555
2703-2021_03_20_072817.jpg,bike,11,445,640,15,360,110,4,456,125,LTAdatasets/2703/annotate/2703-2021_03_20_072817.jpg,450.5,117.5,0.70390625,0.3263888888888889,0.0171875,0.041666666666666664
2703-2021_03_20_072817.jpg,bike,11,408,640,15,360,114,4,419,129,LTAdatasets/2703/annotate/2703-2021_03_20_072817.jpg,413.5,121.5,0.64609375,0.3375,0.0171875,0.041666666666666664
2703-2021_03_20_072817.jpg,car,19,355,640,17,360,113,1,374,130,LTAdatasets/2703/annotate/2703-2021_03_20_072817.jpg,364.5,121.5,0.56953125,0.3375,0.0296875,0.04722222222222222
2703-2021_03_20_072817.jpg,car,25,615,640,58,360,256,1,640,314,LTAdatasets/2703/annotate/2703-2021_03_20_072817.jpg,627.5,285.0,0.98046875,0.7916666666666666,0.0390625,0.16111111111111112
2703-2021_03_20_085822.jpg,car,40,176,640,33,360,201,1,216,234,LTAdatasets/2703/annotate/2703-2021_03_20_085822.jpg,196.0,217.5,0.30625,0.6041666666666666,0.0625,0.09166666666666666
2703-2021_03_20_085822.jpg,bike,17,342,640,34,360,224,4,359,258,LTAdatasets/2703/annotate/2703-2021_03_20_085822.jpg,350.5,241.0,0.54765625,0.6694444444444444,0.0265625,0.09444444444444444
2703-2021_03_20_085822.jpg,car,31,463,640,42,360,179,1,494,221,LTAdatasets/2703/annotate/2703-2021_03_20_085822.jpg,478.5,200.0,0.74765625,0.5555555555555556,0.0484375,0.11666666666666667
2703-2021_03_20_085822.jpg,car,26,505,640,39,360,173,1,531,212,LTAdatasets/2703/annotate/2703-2021_03_20_085822.jpg,518.0,192.5,0.809375,0.5347222222222222,0.040625,0.10833333333333334
2703-2021_03_20_085822.jpg,car,38,571,640,37,360,195,1,609,232,LTAdatasets/2703/annotate/2703-2021_03_20_085822.jpg,590.0,213.5,0.921875,0.5930555555555556,0.059375,0.10277777777777777
2703-2021_03_20_085822.jpg,car,20,411,640,12,360,122,1,431,134,LTAdatasets/2703/annotate/2703-2021_03_20_085822.jpg,421.0,128.0,0.6578125,0.35555555555555557,0.03125,0.03333333333333333
2703-2021_03_20_085822.jpg,car,19,438,640,13,360,120,1,457,133,LTAdatasets/2703/annotate/2703-2021_03_20_085822.jpg,447.5,126.5,0.69921875,0.35138888888888886,0.0296875,0.03611111111111111
2703-2021_03_20_191914.jpg,bus,32,438,640,25,360,93,5,470,118,LTAdatasets/2703/annotate/2703-2021_03_20_191914.jpg,454.0,105.5,0.709375,0.29305555555555557,0.05,0.06944444444444445
2703-2021_03_20_191914.jpg,bike,19,336,640,33,360,196,4,355,229,LTAdatasets/2703/annotate/2703-2021_03_20_191914.jpg,345.5,212.5,0.53984375,0.5902777777777778,0.0296875,0.09166666666666666
2703-2021_03_20_191914.jpg,bike,20,607,640,35,360,224,4,627,259,LTAdatasets/2703/annotate/2703-2021_03_20_191914.jpg,617.0,241.5,0.9640625,0.6708333333333333,0.03125,0.09722222222222222
2703-2021_03_20_191914.jpg,car,15,405,640,11,360,111,1,420,122,LTAdatasets/2703/annotate/2703-2021_03_20_191914.jpg,412.5,116.5,0.64453125,0.3236111111111111,0.0234375,0.030555555555555555
2703-2021_03_20_191914.jpg,bus,18,415,640,18,360,81,5,433,99,LTAdatasets/2703/annotate/2703-2021_03_20_191914.jpg,424.0,90.0,0.6625,0.25,0.028125,0.05
2703-2021_03_20_191914.jpg,bike,11,237,640,15,360,120,4,248,135,LTAdatasets/2703/annotate/2703-2021_03_20_191914.jpg,242.5,127.5,0.37890625,0.3541666666666667,0.0171875,0.041666666666666664
2703-2021_03_20_075518.jpg,car,25,450,640,18,360,132,1,475,150,LTAdatasets/2703/annotate/2703-2021_03_20_075518.jpg,462.5,141.0,0.72265625,0.39166666666666666,0.0390625,0.05
2703-2021_03_20_075518.jpg,van,31,362,640,34,360,162,3,393,196,LTAdatasets/2703/annotate/2703-2021_03_20_075518.jpg,377.5,179.0,0.58984375,0.49722222222222223,0.0484375,0.09444444444444444
2703-2021_03_20_075518.jpg,lorry_truck,30,461,640,25,360,109,2,491,134,LTAdatasets/2703/annotate/2703-2021_03_20_075518.jpg,476.0,121.5,0.74375,0.3375,0.046875,0.06944444444444445
2703-2021_03_20_075518.jpg,car,45,272,640,45,360,226,1,317,271,LTAdatasets/2703/annotate/2703-2021_03_20_075518.jpg,294.5,248.5,0.46015625,0.6902777777777778,0.0703125,0.125
2703-2021_03_20_075518.jpg,car,28,204,640,21,360,171,1,232,192,LTAdatasets/2703/annotate/2703-2021_03_20_075518.jpg,218.0,181.5,0.340625,0.5041666666666667,0.04375,0.058333333333333334
2703-2021_03_20_075518.jpg,car,21,331,640,28,360,155,1,352,183,LTAdatasets/2703/annotate/2703-2021_03_20_075518.jpg,341.5,169.0,0.53359375,0.46944444444444444,0.0328125,0.07777777777777778
2703-2021_03_20_075518.jpg,bike,10,355,640,16,360,129,4,365,145,LTAdatasets/2703/annotate/2703-2021_03_20_075518.jpg,360.0,137.0,0.5625,0.38055555555555554,0.015625,0.044444444444444446
2703-2021_03_20_183112.jpg,car,30,573,640,36,360,193,1,603,229,LTAdatasets/2703/annotate/2703-2021_03_20_183112.jpg,588.0,211.0,0.91875,0.5861111111111111,0.046875,0.1
2703-2021_03_20_183112.jpg,car,24,478,640,32,360,155,1,502,187,LTAdatasets/2703/annotate/2703-2021_03_20_183112.jpg,490.0,171.0,0.765625,0.475,0.0375,0.08888888888888889
2703-2021_03_20_183112.jpg,car,32,514,640,25,360,154,1,546,179,LTAdatasets/2703/annotate/2703-2021_03_20_183112.jpg,530.0,166.5,0.828125,0.4625,0.05,0.06944444444444445
2703-2021_03_20_183112.jpg,car,23,252,640,22,360,157,1,275,179,LTAdatasets/2703/annotate/2703-2021_03_20_183112.jpg,263.5,168.0,0.41171875,0.4666666666666667,0.0359375,0.06111111111111111
2703-2021_03_20_183112.jpg,lorry_truck,61,57,640,39,360,221,2,118,260,LTAdatasets/2703/annotate/2703-2021_03_20_183112.jpg,87.5,240.5,0.13671875,0.6680555555555555,0.0953125,0.10833333333333334
2703-2021_03_20_183112.jpg,car,51,4,640,38,360,303,1,55,341,LTAdatasets/2703/annotate/2703-2021_03_20_183112.jpg,29.5,322.0,0.04609375,0.8944444444444445,0.0796875,0.10555555555555556
2703-2021_03_20_183112.jpg,van,23,266,640,14,360,132,3,289,146,LTAdatasets/2703/annotate/2703-2021_03_20_183112.jpg,277.5,139.0,0.43359375,0.3861111111111111,0.0359375,0.03888888888888889
2703-2021_03_20_183112.jpg,bus,30,237,640,37,360,114,5,267,151,LTAdatasets/2703/annotate/2703-2021_03_20_183112.jpg,252.0,132.5,0.39375,0.3680555555555556,0.046875,0.10277777777777777
2703-2021_03_20_183112.jpg,car,17,294,640,11,360,118,1,311,129,LTAdatasets/2703/annotate/2703-2021_03_20_183112.jpg,302.5,123.5,0.47265625,0.34305555555555556,0.0265625,0.030555555555555555
2703-2021_03_20_183112.jpg,car,15,403,640,12,360,112,1,418,124,LTAdatasets/2703/annotate/2703-2021_03_20_183112.jpg,410.5,118.0,0.64140625,0.3277777777777778,0.0234375,0.03333333333333333
2703-2021_03_20_183112.jpg,car,16,425,640,13,360,112,1,441,125,LTAdatasets/2703/annotate/2703-2021_03_20_183112.jpg,433.0,118.5,0.6765625,0.32916666666666666,0.025,0.03611111111111111
2703-2021_03_20_183112.jpg,car,21,198,640,10,360,135,1,219,145,LTAdatasets/2703/annotate/2703-2021_03_20_183112.jpg,208.5,140.0,0.32578125,0.3888888888888889,0.0328125,0.027777777777777776
2703-2021_03_20_073417.jpg,lorry_truck,25,434,640,25,360,111,2,459,136,LTAdatasets/2703/annotate/2703-2021_03_20_073417.jpg,446.5,123.5,0.69765625,0.34305555555555556,0.0390625,0.06944444444444445
2703-2021_03_20_073417.jpg,car,18,404,640,16,360,112,1,422,128,LTAdatasets/2703/annotate/2703-2021_03_20_073417.jpg,413.0,120.0,0.6453125,0.3333333333333333,0.028125,0.044444444444444446
2703-2021_03_20_073417.jpg,car,19,236,640,15,360,153,1,255,168,LTAdatasets/2703/annotate/2703-2021_03_20_073417.jpg,245.5,160.5,0.38359375,0.44583333333333336,0.0296875,0.041666666666666664
2703-2021_03_20_073417.jpg,car,19,168,640,17,360,141,1,187,158,LTAdatasets/2703/annotate/2703-2021_03_20_073417.jpg,177.5,149.5,0.27734375,0.4152777777777778,0.0296875,0.04722222222222222
2703-2021_03_20_073417.jpg,van,19,238,640,14,360,117,3,257,131,LTAdatasets/2703/annotate/2703-2021_03_20_073417.jpg,247.5,124.0,0.38671875,0.34444444444444444,0.0296875,0.03888888888888889
2703-2021_03_20_183952.jpg,car,35,205,640,32,360,177,1,240,209,LTAdatasets/2703/annotate/2703-2021_03_20_183952.jpg,222.5,193.0,0.34765625,0.5361111111111111,0.0546875,0.08888888888888889
2703-2021_03_20_183952.jpg,car,28,434,640,23,360,152,1,462,175,LTAdatasets/2703/annotate/2703-2021_03_20_183952.jpg,448.0,163.5,0.7,0.45416666666666666,0.04375,0.06388888888888888
2703-2021_03_20_183952.jpg,car,20,234,640,17,360,140,1,254,157,LTAdatasets/2703/annotate/2703-2021_03_20_183952.jpg,244.0,148.5,0.38125,0.4125,0.03125,0.04722222222222222
2703-2021_03_20_183952.jpg,van,22,215,640,14,360,122,3,237,136,LTAdatasets/2703/annotate/2703-2021_03_20_183952.jpg,226.0,129.0,0.353125,0.35833333333333334,0.034375,0.03888888888888889
2703-2021_03_20_183952.jpg,car,26,185,640,11,360,138,1,211,149,LTAdatasets/2703/annotate/2703-2021_03_20_183952.jpg,198.0,143.5,0.309375,0.39861111111111114,0.040625,0.030555555555555555
2703-2021_03_20_183952.jpg,car,15,426,640,11,360,114,1,441,125,LTAdatasets/2703/annotate/2703-2021_03_20_183952.jpg,433.5,119.5,0.67734375,0.33194444444444443,0.0234375,0.030555555555555555
2703-2021_03_20_075138.jpg,car,26,437,640,19,360,157,1,463,176,LTAdatasets/2703/annotate/2703-2021_03_20_075138.jpg,450.0,166.5,0.703125,0.4625,0.040625,0.05277777777777778
2703-2021_03_20_075138.jpg,car,20,441,640,13,360,119,1,461,132,LTAdatasets/2703/annotate/2703-2021_03_20_075138.jpg,451.0,125.5,0.7046875,0.3486111111111111,0.03125,0.03611111111111111
2703-2021_03_20_075138.jpg,car,22,459,640,21,360,132,1,481,153,LTAdatasets/2703/annotate/2703-2021_03_20_075138.jpg,470.0,142.5,0.734375,0.3958333333333333,0.034375,0.058333333333333334
2703-2021_03_20_075138.jpg,car,35,521,640,49,360,190,1,556,239,LTAdatasets/2703/annotate/2703-2021_03_20_075138.jpg,538.5,214.5,0.84140625,0.5958333333333333,0.0546875,0.1361111111111111
2703-2021_03_20_075138.jpg,lorry_truck,17,472,640,25,360,114,2,489,139,LTAdatasets/2703/annotate/2703-2021_03_20_075138.jpg,480.5,126.5,0.75078125,0.35138888888888886,0.0265625,0.06944444444444445
2703-2021_03_20_075138.jpg,car,12,349,640,11,360,125,1,361,136,LTAdatasets/2703/annotate/2703-2021_03_20_075138.jpg,355.0,130.5,0.5546875,0.3625,0.01875,0.030555555555555555
2703-2021_03_20_075138.jpg,bike,17,268,640,15,360,131,4,285,146,LTAdatasets/2703/annotate/2703-2021_03_20_075138.jpg,276.5,138.5,0.43203125,0.38472222222222224,0.0265625,0.041666666666666664
2703-2021_03_20_100105.jpg,car,28,233,640,23,360,169,1,261,192,LTAdatasets/2703/annotate/2703-2021_03_20_100105.jpg,247.0,180.5,0.3859375,0.5013888888888889,0.04375,0.06388888888888888
2703-2021_03_20_100105.jpg,lorry_truck,25,363,640,22,360,140,2,388,162,LTAdatasets/2703/annotate/2703-2021_03_20_100105.jpg,375.5,151.0,0.58671875,0.41944444444444445,0.0390625,0.06111111111111111
2703-2021_03_20_100105.jpg,car,30,478,640,28,360,154,1,508,182,LTAdatasets/2703/annotate/2703-2021_03_20_100105.jpg,493.0,168.0,0.7703125,0.4666666666666667,0.046875,0.07777777777777778
2703-2021_03_20_100105.jpg,car,20,425,640,12,360,116,1,445,128,LTAdatasets/2703/annotate/2703-2021_03_20_100105.jpg,435.0,122.0,0.6796875,0.3388888888888889,0.03125,0.03333333333333333
2703-2021_03_20_100105.jpg,bike,18,232,640,12,360,148,4,250,160,LTAdatasets/2703/annotate/2703-2021_03_20_100105.jpg,241.0,154.0,0.3765625,0.42777777777777776,0.028125,0.03333333333333333
2703-2021_03_20_100105.jpg,car,54,102,640,50,360,259,1,156,309,LTAdatasets/2703/annotate/2703-2021_03_20_100105.jpg,129.0,284.0,0.2015625,0.7888888888888889,0.084375,0.1388888888888889
2703-2021_03_20_100105.jpg,lorry_truck,27,244,640,21,360,121,2,271,142,LTAdatasets/2703/annotate/2703-2021_03_20_100105.jpg,257.5,131.5,0.40234375,0.36527777777777776,0.0421875,0.058333333333333334
2703-2021_03_20_100105.jpg,car,17,285,640,10,360,119,1,302,129,LTAdatasets/2703/annotate/2703-2021_03_20_100105.jpg,293.5,124.0,0.45859375,0.34444444444444444,0.0265625,0.027777777777777776
2703-2021_03_20_091302.jpg,car,36,604,640,55,360,270,1,640,325,LTAdatasets/2703/annotate/2703-2021_03_20_091302.jpg,622.0,297.5,0.971875,0.8263888888888888,0.05625,0.1527777777777778
2703-2021_03_20_091302.jpg,lorry_truck,59,3,640,36,360,182,2,62,218,LTAdatasets/2703/annotate/2703-2021_03_20_091302.jpg,32.5,200.0,0.05078125,0.5555555555555556,0.0921875,0.1
2703-2021_03_20_091302.jpg,car,13,403,640,11,360,106,1,416,117,LTAdatasets/2703/annotate/2703-2021_03_20_091302.jpg,409.5,111.5,0.63984375,0.30972222222222223,0.0203125,0.030555555555555555
2703-2021_03_20_193415.jpg,car,65,90,640,41,360,269,1,155,310,LTAdatasets/2703/annotate/2703-2021_03_20_193415.jpg,122.5,289.5,0.19140625,0.8041666666666667,0.1015625,0.11388888888888889
2703-2021_03_20_193415.jpg,bus,45,491,640,61,360,114,5,536,175,LTAdatasets/2703/annotate/2703-2021_03_20_193415.jpg,513.5,144.5,0.80234375,0.4013888888888889,0.0703125,0.16944444444444445
2703-2021_03_20_193415.jpg,car,26,474,640,26,360,154,1,500,180,LTAdatasets/2703/annotate/2703-2021_03_20_193415.jpg,487.0,167.0,0.7609375,0.4638888888888889,0.040625,0.07222222222222222
2703-2021_03_20_193415.jpg,car,17,440,640,16,360,121,1,457,137,LTAdatasets/2703/annotate/2703-2021_03_20_193415.jpg,448.5,129.0,0.70078125,0.35833333333333334,0.0265625,0.044444444444444446
2703-2021_03_20_193415.jpg,lorry_truck,46,61,640,42,360,206,2,107,248,LTAdatasets/2703/annotate/2703-2021_03_20_193415.jpg,84.0,227.0,0.13125,0.6305555555555555,0.071875,0.11666666666666667
2703-2021_03_20_193415.jpg,car,22,242,640,18,360,152,1,264,170,LTAdatasets/2703/annotate/2703-2021_03_20_193415.jpg,253.0,161.0,0.3953125,0.44722222222222224,0.034375,0.05
2703-2021_03_20_193415.jpg,car,27,43,640,15,360,198,1,70,213,LTAdatasets/2703/annotate/2703-2021_03_20_193415.jpg,56.5,205.5,0.08828125,0.5708333333333333,0.0421875,0.041666666666666664
2703-2021_03_20_193415.jpg,car,19,144,640,12,360,156,1,163,168,LTAdatasets/2703/annotate/2703-2021_03_20_193415.jpg,153.5,162.0,0.23984375,0.45,0.0296875,0.03333333333333333
2703-2021_03_20_203358.jpg,car,28,452,640,20,360,177,1,480,197,LTAdatasets/2703/annotate/2703-2021_03_20_203358.jpg,466.0,187.0,0.728125,0.5194444444444445,0.04375,0.05555555555555555
2703-2021_03_20_203358.jpg,van,26,498,640,25,360,144,3,524,169,LTAdatasets/2703/annotate/2703-2021_03_20_203358.jpg,511.0,156.5,0.7984375,0.43472222222222223,0.040625,0.06944444444444445
2703-2021_03_20_203358.jpg,car,38,173,640,28,360,221,1,211,249,LTAdatasets/2703/annotate/2703-2021_03_20_203358.jpg,192.0,235.0,0.3,0.6527777777777778,0.059375,0.07777777777777778
2703-2021_03_20_203358.jpg,van,44,124,640,39,360,200,3,168,239,LTAdatasets/2703/annotate/2703-2021_03_20_203358.jpg,146.0,219.5,0.228125,0.6097222222222223,0.06875,0.10833333333333334
2703-2021_03_20_203358.jpg,car,23,275,640,19,360,146,1,298,165,LTAdatasets/2703/annotate/2703-2021_03_20_203358.jpg,286.5,155.5,0.44765625,0.43194444444444446,0.0359375,0.05277777777777778
2703-2021_03_20_203358.jpg,car,20,247,640,17,360,145,1,267,162,LTAdatasets/2703/annotate/2703-2021_03_20_203358.jpg,257.0,153.5,0.4015625,0.4263888888888889,0.03125,0.04722222222222222
2703-2021_03_20_203358.jpg,van,27,163,640,13,360,143,3,190,156,LTAdatasets/2703/annotate/2703-2021_03_20_203358.jpg,176.5,149.5,0.27578125,0.4152777777777778,0.0421875,0.03611111111111111
2703-2021_03_20_203358.jpg,bike,18,75,640,19,360,184,4,93,203,LTAdatasets/2703/annotate/2703-2021_03_20_203358.jpg,84.0,193.5,0.13125,0.5375,0.028125,0.05277777777777778
2703-2021_03_20_203358.jpg,car,54,559,640,38,360,322,1,613,360,LTAdatasets/2703/annotate/2703-2021_03_20_203358.jpg,586.0,341.0,0.915625,0.9472222222222222,0.084375,0.10555555555555556
2703-2021_03_20_085501.jpg,lorry_truck,37,506,640,32,360,132,2,543,164,LTAdatasets/2703/annotate/2703-2021_03_20_085501.jpg,524.5,148.0,0.81953125,0.4111111111111111,0.0578125,0.08888888888888889
2703-2021_03_20_085501.jpg,car,39,574,640,37,360,187,1,613,224,LTAdatasets/2703/annotate/2703-2021_03_20_085501.jpg,593.5,205.5,0.92734375,0.5708333333333333,0.0609375,0.10277777777777777
2703-2021_03_20_085501.jpg,car,34,497,640,31,360,173,1,531,204,LTAdatasets/2703/annotate/2703-2021_03_20_085501.jpg,514.0,188.5,0.803125,0.5236111111111111,0.053125,0.08611111111111111
2703-2021_03_20_085501.jpg,bike,23,473,640,22,360,171,4,496,193,LTAdatasets/2703/annotate/2703-2021_03_20_085501.jpg,484.5,182.0,0.75703125,0.5055555555555555,0.0359375,0.06111111111111111
2703-2021_03_20_085501.jpg,car,76,564,640,47,360,313,1,640,360,LTAdatasets/2703/annotate/2703-2021_03_20_085501.jpg,602.0,336.5,0.940625,0.9347222222222222,0.11875,0.13055555555555556
2703-2021_03_20_085501.jpg,lorry_truck,20,372,640,38,360,97,2,392,135,LTAdatasets/2703/annotate/2703-2021_03_20_085501.jpg,382.0,116.0,0.596875,0.32222222222222224,0.03125,0.10555555555555556
2703-2021_03_20_085501.jpg,bike,20,83,640,24,360,219,4,103,243,LTAdatasets/2703/annotate/2703-2021_03_20_085501.jpg,93.0,231.0,0.1453125,0.6416666666666667,0.03125,0.06666666666666667
2703-2021_03_20_082440.jpg,car,24,450,640,20,360,131,1,474,151,LTAdatasets/2703/annotate/2703-2021_03_20_082440.jpg,462.0,141.0,0.721875,0.39166666666666666,0.0375,0.05555555555555555
2703-2021_03_20_082440.jpg,bike,10,481,640,14,360,145,4,491,159,LTAdatasets/2703/annotate/2703-2021_03_20_082440.jpg,486.0,152.0,0.759375,0.4222222222222222,0.015625,0.03888888888888889
2703-2021_03_20_082440.jpg,bike,11,423,640,16,360,128,4,434,144,LTAdatasets/2703/annotate/2703-2021_03_20_082440.jpg,428.5,136.0,0.66953125,0.37777777777777777,0.0171875,0.044444444444444446
2703-2021_03_20_082440.jpg,bus,43,471,640,48,360,103,5,514,151,LTAdatasets/2703/annotate/2703-2021_03_20_082440.jpg,492.5,127.0,0.76953125,0.3527777777777778,0.0671875,0.13333333333333333
2703-2021_03_20_082440.jpg,car,37,553,640,36,360,223,1,590,259,LTAdatasets/2703/annotate/2703-2021_03_20_082440.jpg,571.5,241.0,0.89296875,0.6694444444444444,0.0578125,0.1
2703-2021_03_20_082440.jpg,lorry_truck,33,561,640,27,360,179,2,594,206,LTAdatasets/2703/annotate/2703-2021_03_20_082440.jpg,577.5,192.5,0.90234375,0.5347222222222222,0.0515625,0.075
2703-2021_03_20_082440.jpg,lorry_truck,20,447,640,19,360,102,2,467,121,LTAdatasets/2703/annotate/2703-2021_03_20_082440.jpg,457.0,111.5,0.7140625,0.30972222222222223,0.03125,0.05277777777777778
2703-2021_03_20_082440.jpg,lorry_truck,43,166,640,28,360,164,2,209,192,LTAdatasets/2703/annotate/2703-2021_03_20_082440.jpg,187.5,178.0,0.29296875,0.49444444444444446,0.0671875,0.07777777777777778
2703-2021_03_20_082440.jpg,car,20,264,640,14,360,133,1,284,147,LTAdatasets/2703/annotate/2703-2021_03_20_082440.jpg,274.0,140.0,0.428125,0.3888888888888889,0.03125,0.03888888888888889
2703-2021_03_20_082440.jpg,car,50,48,640,54,360,305,1,98,359,LTAdatasets/2703/annotate/2703-2021_03_20_082440.jpg,73.0,332.0,0.1140625,0.9222222222222223,0.078125,0.15
2703-2021_03_20_190113.jpg,car,58,52,640,35,360,238,1,110,273,LTAdatasets/2703/annotate/2703-2021_03_20_190113.jpg,81.0,255.5,0.1265625,0.7097222222222223,0.090625,0.09722222222222222
2703-2021_03_20_190113.jpg,car,34,213,640,25,360,191,1,247,216,LTAdatasets/2703/annotate/2703-2021_03_20_190113.jpg,230.0,203.5,0.359375,0.5652777777777778,0.053125,0.06944444444444445
2703-2021_03_20_190113.jpg,bus,43,463,640,37,360,114,5,506,151,LTAdatasets/2703/annotate/2703-2021_03_20_190113.jpg,484.5,132.5,0.75703125,0.3680555555555556,0.0671875,0.10277777777777777
2703-2021_03_20_190113.jpg,bike,18,185,640,29,360,178,4,203,207,LTAdatasets/2703/annotate/2703-2021_03_20_190113.jpg,194.0,192.5,0.303125,0.5347222222222222,0.028125,0.08055555555555556
2703-2021_03_20_190113.jpg,car,22,279,640,14,360,143,1,301,157,LTAdatasets/2703/annotate/2703-2021_03_20_190113.jpg,290.0,150.0,0.453125,0.4166666666666667,0.034375,0.03888888888888889
2703-2021_03_20_190113.jpg,lorry_truck,24,250,640,20,360,143,2,274,163,LTAdatasets/2703/annotate/2703-2021_03_20_190113.jpg,262.0,153.0,0.409375,0.425,0.0375,0.05555555555555555
2703-2021_03_20_190113.jpg,lorry_truck,28,223,640,41,360,128,2,251,169,LTAdatasets/2703/annotate/2703-2021_03_20_190113.jpg,237.0,148.5,0.3703125,0.4125,0.04375,0.11388888888888889
2703-2021_03_20_190113.jpg,van,30,109,640,18,360,162,3,139,180,LTAdatasets/2703/annotate/2703-2021_03_20_190113.jpg,124.0,171.0,0.19375,0.475,0.046875,0.05
2703-2021_03_20_080719.jpg,lorry_truck,31,367,640,34,360,147,2,398,181,LTAdatasets/2703/annotate/2703-2021_03_20_080719.jpg,382.5,164.0,0.59765625,0.45555555555555555,0.0484375,0.09444444444444444
2703-2021_03_20_080719.jpg,car,20,423,640,19,360,135,1,443,154,LTAdatasets/2703/annotate/2703-2021_03_20_080719.jpg,433.0,144.5,0.6765625,0.4013888888888889,0.03125,0.05277777777777778
2703-2021_03_20_080719.jpg,car,27,408,640,17,360,115,1,435,132,LTAdatasets/2703/annotate/2703-2021_03_20_080719.jpg,421.5,123.5,0.65859375,0.34305555555555556,0.0421875,0.04722222222222222
2703-2021_03_20_080719.jpg,car,19,469,640,21,360,135,1,488,156,LTAdatasets/2703/annotate/2703-2021_03_20_080719.jpg,478.5,145.5,0.74765625,0.4041666666666667,0.0296875,0.058333333333333334
2703-2021_03_20_080719.jpg,lorry_truck,20,442,640,18,360,121,2,462,139,LTAdatasets/2703/annotate/2703-2021_03_20_080719.jpg,452.0,130.0,0.70625,0.3611111111111111,0.03125,0.05
2703-2021_03_20_080719.jpg,lorry_truck,47,307,640,44,360,155,2,354,199,LTAdatasets/2703/annotate/2703-2021_03_20_080719.jpg,330.5,177.0,0.51640625,0.49166666666666664,0.0734375,0.12222222222222222
2703-2021_03_20_080719.jpg,car,19,347,640,16,360,125,1,366,141,LTAdatasets/2703/annotate/2703-2021_03_20_080719.jpg,356.5,133.0,0.55703125,0.36944444444444446,0.0296875,0.044444444444444446
2703-2021_03_20_080719.jpg,car,59,523,640,65,360,267,1,582,332,LTAdatasets/2703/annotate/2703-2021_03_20_080719.jpg,552.5,299.5,0.86328125,0.8319444444444445,0.0921875,0.18055555555555555
2703-2021_03_20_080719.jpg,lorry_truck,14,447,640,13,360,102,2,461,115,LTAdatasets/2703/annotate/2703-2021_03_20_080719.jpg,454.0,108.5,0.709375,0.3013888888888889,0.021875,0.03611111111111111
2703-2021_03_20_201917.jpg,car,19,239,640,13,360,138,1,258,151,LTAdatasets/2703/annotate/2703-2021_03_20_201917.jpg,248.5,144.5,0.38828125,0.4013888888888889,0.0296875,0.03611111111111111
2703-2021_03_20_201917.jpg,car,24,274,640,14,360,143,1,298,157,LTAdatasets/2703/annotate/2703-2021_03_20_201917.jpg,286.0,150.0,0.446875,0.4166666666666667,0.0375,0.03888888888888889
2703-2021_03_20_201917.jpg,car,24,317,640,31,360,164,1,341,195,LTAdatasets/2703/annotate/2703-2021_03_20_201917.jpg,329.0,179.5,0.5140625,0.4986111111111111,0.0375,0.08611111111111111
2703-2021_03_20_201917.jpg,car,32,335,640,39,360,232,1,367,271,LTAdatasets/2703/annotate/2703-2021_03_20_201917.jpg,351.0,251.5,0.5484375,0.6986111111111111,0.05,0.10833333333333334
2703-2021_03_20_201917.jpg,car,29,225,640,24,360,174,1,254,198,LTAdatasets/2703/annotate/2703-2021_03_20_201917.jpg,239.5,186.0,0.37421875,0.5166666666666667,0.0453125,0.06666666666666667
2703-2021_03_20_201917.jpg,car,56,65,640,34,360,242,1,121,276,LTAdatasets/2703/annotate/2703-2021_03_20_201917.jpg,93.0,259.0,0.1453125,0.7194444444444444,0.0875,0.09444444444444444
2703-2021_03_20_084901.jpg,lorry_truck,38,416,640,29,360,127,2,454,156,LTAdatasets/2703/annotate/2703-2021_03_20_084901.jpg,435.0,141.5,0.6796875,0.39305555555555555,0.059375,0.08055555555555556
2703-2021_03_20_084901.jpg,lorry_truck,34,357,640,58,360,153,2,391,211,LTAdatasets/2703/annotate/2703-2021_03_20_084901.jpg,374.0,182.0,0.584375,0.5055555555555555,0.053125,0.16111111111111112
2703-2021_03_20_084901.jpg,lorry_truck,63,83,640,49,360,184,2,146,233,LTAdatasets/2703/annotate/2703-2021_03_20_084901.jpg,114.5,208.5,0.17890625,0.5791666666666667,0.0984375,0.1361111111111111
2703-2021_03_20_084901.jpg,car,38,256,640,39,360,255,1,294,294,LTAdatasets/2703/annotate/2703-2021_03_20_084901.jpg,275.0,274.5,0.4296875,0.7625,0.059375,0.10833333333333334
2703-2021_03_20_084901.jpg,van,33,488,640,29,360,160,3,521,189,LTAdatasets/2703/annotate/2703-2021_03_20_084901.jpg,504.5,174.5,0.78828125,0.4847222222222222,0.0515625,0.08055555555555556
2703-2021_03_20_084901.jpg,car,20,327,640,27,360,158,1,347,185,LTAdatasets/2703/annotate/2703-2021_03_20_084901.jpg,337.0,171.5,0.5265625,0.47638888888888886,0.03125,0.075
2703-2021_03_20_084901.jpg,lorry_truck,16,474,640,16,360,139,2,490,155,LTAdatasets/2703/annotate/2703-2021_03_20_084901.jpg,482.0,147.0,0.753125,0.4083333333333333,0.025,0.044444444444444446
2703-2021_03_20_084901.jpg,car,16,345,640,18,360,128,1,361,146,LTAdatasets/2703/annotate/2703-2021_03_20_084901.jpg,353.0,137.0,0.5515625,0.38055555555555554,0.025,0.05
2703-2021_03_20_084901.jpg,lorry_truck,23,450,640,11,360,112,2,473,123,LTAdatasets/2703/annotate/2703-2021_03_20_084901.jpg,461.5,117.5,0.72109375,0.3263888888888889,0.0359375,0.030555555555555555
2703-2021_03_20_083340.jpg,car,42,137,640,29,360,202,1,179,231,LTAdatasets/2703/annotate/2703-2021_03_20_083340.jpg,158.0,216.5,0.246875,0.6013888888888889,0.065625,0.08055555555555556
2703-2021_03_20_083340.jpg,car,29,264,640,17,360,153,1,293,170,LTAdatasets/2703/annotate/2703-2021_03_20_083340.jpg,278.5,161.5,0.43515625,0.4486111111111111,0.0453125,0.04722222222222222
2703-2021_03_20_083340.jpg,bike,19,212,640,21,360,168,4,231,189,LTAdatasets/2703/annotate/2703-2021_03_20_083340.jpg,221.5,178.5,0.34609375,0.49583333333333335,0.0296875,0.058333333333333334
2703-2021_03_20_083340.jpg,lorry_truck,47,508,640,45,360,181,2,555,226,LTAdatasets/2703/annotate/2703-2021_03_20_083340.jpg,531.5,203.5,0.83046875,0.5652777777777778,0.0734375,0.125
2703-2021_03_20_083340.jpg,lorry_truck,19,365,640,37,360,137,2,384,174,LTAdatasets/2703/annotate/2703-2021_03_20_083340.jpg,374.5,155.5,0.58515625,0.43194444444444446,0.0296875,0.10277777777777777
2703-2021_03_20_083340.jpg,car,16,421,640,17,360,128,1,437,145,LTAdatasets/2703/annotate/2703-2021_03_20_083340.jpg,429.0,136.5,0.6703125,0.37916666666666665,0.025,0.04722222222222222
2703-2021_03_20_083340.jpg,car,21,328,640,22,360,149,1,349,171,LTAdatasets/2703/annotate/2703-2021_03_20_083340.jpg,338.5,160.0,0.52890625,0.4444444444444444,0.0328125,0.06111111111111111
2703-2021_03_20_083340.jpg,bike,16,156,640,20,360,182,4,172,202,LTAdatasets/2703/annotate/2703-2021_03_20_083340.jpg,164.0,192.0,0.25625,0.5333333333333333,0.025,0.05555555555555555
2703-2021_03_20_083340.jpg,bike,10,249,640,15,360,143,4,259,158,LTAdatasets/2703/annotate/2703-2021_03_20_083340.jpg,254.0,150.5,0.396875,0.41805555555555557,0.015625,0.041666666666666664
2703-2021_03_20_180110.jpg,van,38,196,640,31,360,167,3,234,198,LTAdatasets/2703/annotate/2703-2021_03_20_180110.jpg,215.0,182.5,0.3359375,0.5069444444444444,0.059375,0.08611111111111111
2703-2021_03_20_180110.jpg,van,63,37,640,42,360,268,3,100,310,LTAdatasets/2703/annotate/2703-2021_03_20_180110.jpg,68.5,289.0,0.10703125,0.8027777777777778,0.0984375,0.11666666666666667
2703-2021_03_20_180110.jpg,car,72,537,640,53,360,307,1,609,360,LTAdatasets/2703/annotate/2703-2021_03_20_180110.jpg,573.0,333.5,0.8953125,0.9263888888888889,0.1125,0.14722222222222223
2703-2021_03_20_180110.jpg,car,31,420,640,27,360,131,1,451,158,LTAdatasets/2703/annotate/2703-2021_03_20_180110.jpg,435.5,144.5,0.68046875,0.4013888888888889,0.0484375,0.075
2703-2021_03_20_180110.jpg,van,27,362,640,28,360,130,3,389,158,LTAdatasets/2703/annotate/2703-2021_03_20_180110.jpg,375.5,144.0,0.58671875,0.4,0.0421875,0.07777777777777778
2703-2021_03_20_180110.jpg,lorry_truck,28,198,640,18,360,126,2,226,144,LTAdatasets/2703/annotate/2703-2021_03_20_180110.jpg,212.0,135.0,0.33125,0.375,0.04375,0.05
2703-2021_03_20_201617.jpg,car,24,259,640,22,360,150,1,283,172,LTAdatasets/2703/annotate/2703-2021_03_20_201617.jpg,271.0,161.0,0.4234375,0.44722222222222224,0.0375,0.06111111111111111
2703-2021_03_20_201617.jpg,car,33,149,640,25,360,201,1,182,226,LTAdatasets/2703/annotate/2703-2021_03_20_201617.jpg,165.5,213.5,0.25859375,0.5930555555555556,0.0515625,0.06944444444444445
2703-2021_03_20_201617.jpg,car,49,2,640,47,360,296,1,51,343,LTAdatasets/2703/annotate/2703-2021_03_20_201617.jpg,26.5,319.5,0.04140625,0.8875,0.0765625,0.13055555555555556
2703-2021_03_20_201617.jpg,lorry_truck,36,154,640,25,360,136,2,190,161,LTAdatasets/2703/annotate/2703-2021_03_20_201617.jpg,172.0,148.5,0.26875,0.4125,0.05625,0.06944444444444445
2703-2021_03_20_201617.jpg,car,30,35,640,18,360,197,1,65,215,LTAdatasets/2703/annotate/2703-2021_03_20_201617.jpg,50.0,206.0,0.078125,0.5722222222222222,0.046875,0.05
2703-2021_03_20_201617.jpg,car,16,281,640,13,360,124,1,297,137,LTAdatasets/2703/annotate/2703-2021_03_20_201617.jpg,289.0,130.5,0.4515625,0.3625,0.025,0.03611111111111111
2703-2021_03_20_190413.jpg,lorry_truck,29,448,640,29,360,125,2,477,154,LTAdatasets/2703/annotate/2703-2021_03_20_190413.jpg,462.5,139.5,0.72265625,0.3875,0.0453125,0.08055555555555556
2703-2021_03_20_190413.jpg,car,26,354,640,22,360,166,1,380,188,LTAdatasets/2703/annotate/2703-2021_03_20_190413.jpg,367.0,177.0,0.5734375,0.49166666666666664,0.040625,0.06111111111111111
2703-2021_03_20_190413.jpg,car,24,266,640,23,360,125,1,290,148,LTAdatasets/2703/annotate/2703-2021_03_20_190413.jpg,278.0,136.5,0.434375,0.37916666666666665,0.0375,0.06388888888888888
2703-2021_03_20_190413.jpg,car,24,491,640,16,360,140,1,515,156,LTAdatasets/2703/annotate/2703-2021_03_20_190413.jpg,503.0,148.0,0.7859375,0.4111111111111111,0.0375,0.044444444444444446
2703-2021_03_20_190413.jpg,car,19,411,640,14,360,125,1,430,139,LTAdatasets/2703/annotate/2703-2021_03_20_190413.jpg,420.5,132.0,0.65703125,0.36666666666666664,0.0296875,0.03888888888888889
2703-2021_03_20_190413.jpg,lorry_truck,34,228,640,22,360,174,2,262,196,LTAdatasets/2703/annotate/2703-2021_03_20_190413.jpg,245.0,185.0,0.3828125,0.5138888888888888,0.053125,0.06111111111111111
2703-2021_03_20_190413.jpg,lorry_truck,66,74,640,50,360,189,2,140,239,LTAdatasets/2703/annotate/2703-2021_03_20_190413.jpg,107.0,214.0,0.1671875,0.5944444444444444,0.103125,0.1388888888888889
2703-2021_03_20_190413.jpg,car,26,105,640,12,360,170,1,131,182,LTAdatasets/2703/annotate/2703-2021_03_20_190413.jpg,118.0,176.0,0.184375,0.4888888888888889,0.040625,0.03333333333333333
2703-2021_03_20_194916.jpg,bike,19,342,640,34,360,206,4,361,240,LTAdatasets/2703/annotate/2703-2021_03_20_194916.jpg,351.5,223.0,0.54921875,0.6194444444444445,0.0296875,0.09444444444444444
2703-2021_03_20_194916.jpg,bike,22,500,640,28,360,164,4,522,192,LTAdatasets/2703/annotate/2703-2021_03_20_194916.jpg,511.0,178.0,0.7984375,0.49444444444444446,0.034375,0.07777777777777778
2703-2021_03_20_194916.jpg,car,21,319,640,28,360,169,1,340,197,LTAdatasets/2703/annotate/2703-2021_03_20_194916.jpg,329.5,183.0,0.51484375,0.5083333333333333,0.0328125,0.07777777777777778
2703-2021_03_20_194916.jpg,car,34,596,640,42,360,215,1,630,257,LTAdatasets/2703/annotate/2703-2021_03_20_194916.jpg,613.0,236.0,0.9578125,0.6555555555555556,0.053125,0.11666666666666667
2703-2021_03_20_194916.jpg,car,47,129,640,42,360,241,1,176,283,LTAdatasets/2703/annotate/2703-2021_03_20_194916.jpg,152.5,262.0,0.23828125,0.7277777777777777,0.0734375,0.11666666666666667
2703-2021_03_20_194916.jpg,van,64,3,640,56,360,243,3,67,299,LTAdatasets/2703/annotate/2703-2021_03_20_194916.jpg,35.0,271.0,0.0546875,0.7527777777777778,0.1,0.15555555555555556
2703-2021_03_20_194916.jpg,car,18,244,640,14,360,148,1,262,162,LTAdatasets/2703/annotate/2703-2021_03_20_194916.jpg,253.0,155.0,0.3953125,0.4305555555555556,0.028125,0.03888888888888889
2703-2021_03_20_194916.jpg,lorry_truck,21,237,640,18,360,132,2,258,150,LTAdatasets/2703/annotate/2703-2021_03_20_194916.jpg,247.5,141.0,0.38671875,0.39166666666666666,0.0328125,0.05
2703-2021_03_20_094904.jpg,car,26,313,640,34,360,172,1,339,206,LTAdatasets/2703/annotate/2703-2021_03_20_094904.jpg,326.0,189.0,0.509375,0.525,0.040625,0.09444444444444444
2703-2021_03_20_094904.jpg,car,39,544,640,26,360,182,1,583,208,LTAdatasets/2703/annotate/2703-2021_03_20_094904.jpg,563.5,195.0,0.88046875,0.5416666666666666,0.0609375,0.07222222222222222
2703-2021_03_20_094904.jpg,car,19,463,640,22,360,138,1,482,160,LTAdatasets/2703/annotate/2703-2021_03_20_094904.jpg,472.5,149.0,0.73828125,0.41388888888888886,0.0296875,0.06111111111111111
2703-2021_03_20_094904.jpg,lorry_truck,17,370,640,14,360,101,2,387,115,LTAdatasets/2703/annotate/2703-2021_03_20_094904.jpg,378.5,108.0,0.59140625,0.3,0.0265625,0.03888888888888889
2703-2021_03_20_183712.jpg,van,24,445,640,17,360,123,3,469,140,LTAdatasets/2703/annotate/2703-2021_03_20_183712.jpg,457.0,131.5,0.7140625,0.36527777777777776,0.0375,0.04722222222222222
2703-2021_03_20_183712.jpg,car,35,486,640,41,360,213,1,521,254,LTAdatasets/2703/annotate/2703-2021_03_20_183712.jpg,503.5,233.5,0.78671875,0.6486111111111111,0.0546875,0.11388888888888889
2703-2021_03_20_183712.jpg,car,44,516,640,33,360,204,1,560,237,LTAdatasets/2703/annotate/2703-2021_03_20_183712.jpg,538.0,220.5,0.840625,0.6125,0.06875,0.09166666666666666
2703-2021_03_20_183712.jpg,car,53,148,640,39,360,230,1,201,269,LTAdatasets/2703/annotate/2703-2021_03_20_183712.jpg,174.5,249.5,0.27265625,0.6930555555555555,0.0828125,0.10833333333333334
2703-2021_03_20_183712.jpg,lorry_truck,27,191,640,24,360,154,2,218,178,LTAdatasets/2703/annotate/2703-2021_03_20_183712.jpg,204.5,166.0,0.31953125,0.46111111111111114,0.0421875,0.06666666666666667
2703-2021_03_20_183712.jpg,car,11,418,640,11,360,106,1,429,117,LTAdatasets/2703/annotate/2703-2021_03_20_183712.jpg,423.5,111.5,0.66171875,0.30972222222222223,0.0171875,0.030555555555555555
2703-2021_03_20_092143.jpg,car,24,317,640,23,360,181,1,341,204,LTAdatasets/2703/annotate/2703-2021_03_20_092143.jpg,329.0,192.5,0.5140625,0.5347222222222222,0.0375,0.06388888888888888
2703-2021_03_20_092143.jpg,car,15,450,640,12,360,134,1,465,146,LTAdatasets/2703/annotate/2703-2021_03_20_092143.jpg,457.5,140.0,0.71484375,0.3888888888888889,0.0234375,0.03333333333333333
2703-2021_03_20_092143.jpg,car,22,258,640,12,360,137,1,280,149,LTAdatasets/2703/annotate/2703-2021_03_20_092143.jpg,269.0,143.0,0.4203125,0.3972222222222222,0.034375,0.03333333333333333
2703-2021_03_20_092143.jpg,lorry_truck,24,217,640,15,360,121,2,241,136,LTAdatasets/2703/annotate/2703-2021_03_20_092143.jpg,229.0,128.5,0.3578125,0.35694444444444445,0.0375,0.041666666666666664
2703-2021_03_20_092143.jpg,car,27,166,640,12,360,141,1,193,153,LTAdatasets/2703/annotate/2703-2021_03_20_092143.jpg,179.5,147.0,0.28046875,0.4083333333333333,0.0421875,0.03333333333333333
2703-2021_03_20_092143.jpg,car,27,87,640,12,360,175,1,114,187,LTAdatasets/2703/annotate/2703-2021_03_20_092143.jpg,100.5,181.0,0.15703125,0.5027777777777778,0.0421875,0.03333333333333333
2703-2021_03_20_092143.jpg,van,20,464,640,15,360,122,3,484,137,LTAdatasets/2703/annotate/2703-2021_03_20_092143.jpg,474.0,129.5,0.740625,0.3597222222222222,0.03125,0.041666666666666664
2703-2021_03_20_200116.jpg,bike,14,565,640,24,360,178,4,579,202,LTAdatasets/2703/annotate/2703-2021_03_20_200116.jpg,572.0,190.0,0.89375,0.5277777777777778,0.021875,0.06666666666666667
2703-2021_03_20_200116.jpg,car,28,472,640,26,360,149,1,500,175,LTAdatasets/2703/annotate/2703-2021_03_20_200116.jpg,486.0,162.0,0.759375,0.45,0.04375,0.07222222222222222
2703-2021_03_20_200116.jpg,car,68,549,640,58,360,302,1,617,360,LTAdatasets/2703/annotate/2703-2021_03_20_200116.jpg,583.0,331.0,0.9109375,0.9194444444444444,0.10625,0.16111111111111112
2703-2021_03_20_200116.jpg,car,51,96,640,34,360,231,1,147,265,LTAdatasets/2703/annotate/2703-2021_03_20_200116.jpg,121.5,248.0,0.18984375,0.6888888888888889,0.0796875,0.09444444444444444
2703-2021_03_20_200116.jpg,car,28,123,640,21,360,157,1,151,178,LTAdatasets/2703/annotate/2703-2021_03_20_200116.jpg,137.0,167.5,0.2140625,0.4652777777777778,0.04375,0.058333333333333334
2703-2021_03_20_200116.jpg,car,19,371,640,18,360,119,1,390,137,LTAdatasets/2703/annotate/2703-2021_03_20_200116.jpg,380.5,128.0,0.59453125,0.35555555555555557,0.0296875,0.05
2703-2021_03_20_200116.jpg,car,13,407,640,14,360,111,1,420,125,LTAdatasets/2703/annotate/2703-2021_03_20_200116.jpg,413.5,118.0,0.64609375,0.3277777777777778,0.0203125,0.03888888888888889
2703-2021_03_20_200116.jpg,car,12,244,640,13,360,116,1,256,129,LTAdatasets/2703/annotate/2703-2021_03_20_200116.jpg,250.0,122.5,0.390625,0.3402777777777778,0.01875,0.03611111111111111
2703-2021_03_20_200116.jpg,bike,11,212,640,9,360,134,4,223,143,LTAdatasets/2703/annotate/2703-2021_03_20_200116.jpg,217.5,138.5,0.33984375,0.38472222222222224,0.0171875,0.025
2703-2021_03_20_204238.jpg,bike,17,511,640,29,360,171,4,528,200,LTAdatasets/2703/annotate/2703-2021_03_20_204238.jpg,519.5,185.5,0.81171875,0.5152777777777777,0.0265625,0.08055555555555556
2703-2021_03_20_204238.jpg,car,25,437,640,12,360,125,1,462,137,LTAdatasets/2703/annotate/2703-2021_03_20_204238.jpg,449.5,131.0,0.70234375,0.3638888888888889,0.0390625,0.03333333333333333
2703-2021_03_20_075818.jpg,car,41,552,640,28,360,187,1,593,215,LTAdatasets/2703/annotate/2703-2021_03_20_075818.jpg,572.5,201.0,0.89453125,0.5583333333333333,0.0640625,0.07777777777777778
2703-2021_03_20_075818.jpg,car,32,291,640,34,360,206,1,323,240,LTAdatasets/2703/annotate/2703-2021_03_20_075818.jpg,307.0,223.0,0.4796875,0.6194444444444445,0.05,0.09444444444444444
2703-2021_03_20_075818.jpg,lorry_truck,30,342,640,64,360,203,2,372,267,LTAdatasets/2703/annotate/2703-2021_03_20_075818.jpg,357.0,235.0,0.5578125,0.6527777777777778,0.046875,0.17777777777777778
2703-2021_03_20_075818.jpg,lorry_truck,21,370,640,29,360,104,2,391,133,LTAdatasets/2703/annotate/2703-2021_03_20_075818.jpg,380.5,118.5,0.59453125,0.32916666666666666,0.0328125,0.08055555555555556
2703-2021_03_20_075818.jpg,car,23,260,640,14,360,138,1,283,152,LTAdatasets/2703/annotate/2703-2021_03_20_075818.jpg,271.5,145.0,0.42421875,0.4027777777777778,0.0359375,0.03888888888888889
2703-2021_03_20_203658.jpg,car,40,344,640,54,360,194,1,384,248,LTAdatasets/2703/annotate/2703-2021_03_20_203658.jpg,364.0,221.0,0.56875,0.6138888888888889,0.0625,0.15
2703-2021_03_20_203658.jpg,car,60,45,640,35,360,268,1,105,303,LTAdatasets/2703/annotate/2703-2021_03_20_203658.jpg,75.0,285.5,0.1171875,0.7930555555555555,0.09375,0.09722222222222222
2703-2021_03_20_203658.jpg,lorry_truck,64,0,640,72,360,219,2,64,291,LTAdatasets/2703/annotate/2703-2021_03_20_203658.jpg,32.0,255.0,0.05,0.7083333333333334,0.1,0.2
2703-2021_03_20_203658.jpg,bike,16,221,640,15,360,152,4,237,167,LTAdatasets/2703/annotate/2703-2021_03_20_203658.jpg,229.0,159.5,0.3578125,0.44305555555555554,0.025,0.041666666666666664
2703-2021_03_20_203658.jpg,car,22,266,640,13,360,135,1,288,148,LTAdatasets/2703/annotate/2703-2021_03_20_203658.jpg,277.0,141.5,0.4328125,0.39305555555555555,0.034375,0.03611111111111111
2703-2021_03_20_181851.jpg,car,25,434,640,23,360,147,1,459,170,LTAdatasets/2703/annotate/2703-2021_03_20_181851.jpg,446.5,158.5,0.69765625,0.44027777777777777,0.0390625,0.06388888888888888
2703-2021_03_20_181851.jpg,car,20,438,640,13,360,119,1,458,132,LTAdatasets/2703/annotate/2703-2021_03_20_181851.jpg,448.0,125.5,0.7,0.3486111111111111,0.03125,0.03611111111111111
2703-2021_03_20_181851.jpg,car,21,468,640,15,360,145,1,489,160,LTAdatasets/2703/annotate/2703-2021_03_20_181851.jpg,478.5,152.5,0.74765625,0.4236111111111111,0.0328125,0.041666666666666664
2703-2021_03_20_181851.jpg,car,50,548,640,48,360,219,1,598,267,LTAdatasets/2703/annotate/2703-2021_03_20_181851.jpg,573.0,243.0,0.8953125,0.675,0.078125,0.13333333333333333
2703-2021_03_20_181851.jpg,car,17,410,640,15,360,117,1,427,132,LTAdatasets/2703/annotate/2703-2021_03_20_181851.jpg,418.5,124.5,0.65390625,0.3458333333333333,0.0265625,0.041666666666666664
2703-2021_03_20_181851.jpg,car,18,470,640,15,360,125,1,488,140,LTAdatasets/2703/annotate/2703-2021_03_20_181851.jpg,479.0,132.5,0.7484375,0.3680555555555556,0.028125,0.041666666666666664
2703-2021_03_20_181851.jpg,car,18,425,640,15,360,135,1,443,150,LTAdatasets/2703/annotate/2703-2021_03_20_181851.jpg,434.0,142.5,0.678125,0.3958333333333333,0.028125,0.041666666666666664
2703-2021_03_20_181851.jpg,car,23,250,640,22,360,161,1,273,183,LTAdatasets/2703/annotate/2703-2021_03_20_181851.jpg,261.5,172.0,0.40859375,0.4777777777777778,0.0359375,0.06111111111111111
2703-2021_03_20_181851.jpg,car,25,205,640,27,360,165,1,230,192,LTAdatasets/2703/annotate/2703-2021_03_20_181851.jpg,217.5,178.5,0.33984375,0.49583333333333335,0.0390625,0.075
2703-2021_03_20_181851.jpg,car,66,28,640,46,360,314,1,94,360,LTAdatasets/2703/annotate/2703-2021_03_20_181851.jpg,61.0,337.0,0.0953125,0.9361111111111111,0.103125,0.12777777777777777
2703-2021_03_20_181851.jpg,car,19,287,640,14,360,135,1,306,149,LTAdatasets/2703/annotate/2703-2021_03_20_181851.jpg,296.5,142.0,0.46328125,0.39444444444444443,0.0296875,0.03888888888888889
2703-2021_03_20_201317.jpg,car,24,237,640,26,360,170,1,261,196,LTAdatasets/2703/annotate/2703-2021_03_20_201317.jpg,249.0,183.0,0.3890625,0.5083333333333333,0.0375,0.07222222222222222
2703-2021_03_20_201317.jpg,car,24,232,640,22,360,150,1,256,172,LTAdatasets/2703/annotate/2703-2021_03_20_201317.jpg,244.0,161.0,0.38125,0.44722222222222224,0.0375,0.06111111111111111
2703-2021_03_20_201317.jpg,car,22,312,640,24,360,185,1,334,209,LTAdatasets/2703/annotate/2703-2021_03_20_201317.jpg,323.0,197.0,0.5046875,0.5472222222222223,0.034375,0.06666666666666667
2703-2021_03_20_201317.jpg,van,28,446,640,29,360,161,3,474,190,LTAdatasets/2703/annotate/2703-2021_03_20_201317.jpg,460.0,175.5,0.71875,0.4875,0.04375,0.08055555555555556
2703-2021_03_20_201317.jpg,car,20,407,640,13,360,121,1,427,134,LTAdatasets/2703/annotate/2703-2021_03_20_201317.jpg,417.0,127.5,0.6515625,0.3541666666666667,0.03125,0.03611111111111111
2703-2021_03_20_201317.jpg,car,14,436,640,10,360,116,1,450,126,LTAdatasets/2703/annotate/2703-2021_03_20_201317.jpg,443.0,121.0,0.6921875,0.33611111111111114,0.021875,0.027777777777777776
2703-2021_03_20_201317.jpg,car,29,46,640,16,360,195,1,75,211,LTAdatasets/2703/annotate/2703-2021_03_20_201317.jpg,60.5,203.0,0.09453125,0.5638888888888889,0.0453125,0.044444444444444446
2703-2021_03_20_201317.jpg,car,39,125,640,12,360,160,1,164,172,LTAdatasets/2703/annotate/2703-2021_03_20_201317.jpg,144.5,166.0,0.22578125,0.46111111111111114,0.0609375,0.03333333333333333
2703-2021_03_20_185153.jpg,car,44,578,640,36,360,203,1,622,239,LTAdatasets/2703/annotate/2703-2021_03_20_185153.jpg,600.0,221.0,0.9375,0.6138888888888889,0.06875,0.1
2703-2021_03_20_185153.jpg,van,46,111,640,30,360,200,3,157,230,LTAdatasets/2703/annotate/2703-2021_03_20_185153.jpg,134.0,215.0,0.209375,0.5972222222222222,0.071875,0.08333333333333333
2703-2021_03_20_185153.jpg,car,52,509,640,50,360,248,1,561,298,LTAdatasets/2703/annotate/2703-2021_03_20_185153.jpg,535.0,273.0,0.8359375,0.7583333333333333,0.08125,0.1388888888888889
2703-2021_03_20_185153.jpg,van,25,223,640,24,360,154,3,248,178,LTAdatasets/2703/annotate/2703-2021_03_20_185153.jpg,235.5,166.0,0.36796875,0.46111111111111114,0.0390625,0.06666666666666667
2703-2021_03_20_185153.jpg,bus,35,355,640,68,360,138,5,390,206,LTAdatasets/2703/annotate/2703-2021_03_20_185153.jpg,372.5,172.0,0.58203125,0.4777777777777778,0.0546875,0.18888888888888888
2703-2021_03_20_185153.jpg,car,15,412,640,15,360,117,1,427,132,LTAdatasets/2703/annotate/2703-2021_03_20_185153.jpg,419.5,124.5,0.65546875,0.3458333333333333,0.0234375,0.041666666666666664
2703-2021_03_20_185153.jpg,bike,13,438,640,12,360,120,4,451,132,LTAdatasets/2703/annotate/2703-2021_03_20_185153.jpg,444.5,126.0,0.69453125,0.35,0.0203125,0.03333333333333333
2703-2021_03_20_185153.jpg,car,16,313,640,16,360,114,1,329,130,LTAdatasets/2703/annotate/2703-2021_03_20_185153.jpg,321.0,122.0,0.5015625,0.3388888888888889,0.025,0.044444444444444446
2703-2021_03_20_185153.jpg,lorry_truck,16,374,640,24,360,106,2,390,130,LTAdatasets/2703/annotate/2703-2021_03_20_185153.jpg,382.0,118.0,0.596875,0.3277777777777778,0.025,0.06666666666666667
2703-2021_03_20_202437.jpg,car,24,246,640,18,360,162,1,270,180,LTAdatasets/2703/annotate/2703-2021_03_20_202437.jpg,258.0,171.0,0.403125,0.475,0.0375,0.05
2703-2021_03_20_202437.jpg,car,14,401,640,12,360,109,1,415,121,LTAdatasets/2703/annotate/2703-2021_03_20_202437.jpg,408.0,115.0,0.6375,0.3194444444444444,0.021875,0.03333333333333333
2703-2021_03_20_202437.jpg,car,15,300,640,14,360,126,1,315,140,LTAdatasets/2703/annotate/2703-2021_03_20_202437.jpg,307.5,133.0,0.48046875,0.36944444444444446,0.0234375,0.03888888888888889
2703-2021_03_20_202437.jpg,car,16,272,640,13,360,134,1,288,147,LTAdatasets/2703/annotate/2703-2021_03_20_202437.jpg,280.0,140.5,0.4375,0.3902777777777778,0.025,0.03611111111111111
2703-2021_03_20_202437.jpg,car,37,520,640,44,360,189,1,557,233,LTAdatasets/2703/annotate/2703-2021_03_20_202437.jpg,538.5,211.0,0.84140625,0.5861111111111111,0.0578125,0.12222222222222222
2703-2021_03_20_202437.jpg,car,25,433,640,23,360,144,1,458,167,LTAdatasets/2703/annotate/2703-2021_03_20_202437.jpg,445.5,155.5,0.69609375,0.43194444444444446,0.0390625,0.06388888888888888
2703-2021_03_20_202437.jpg,car,21,236,640,18,360,152,1,257,170,LTAdatasets/2703/annotate/2703-2021_03_20_202437.jpg,246.5,161.0,0.38515625,0.44722222222222224,0.0328125,0.05
2703-2021_03_20_202437.jpg,car,19,247,640,13,360,129,1,266,142,LTAdatasets/2703/annotate/2703-2021_03_20_202437.jpg,256.5,135.5,0.40078125,0.3763888888888889,0.0296875,0.03611111111111111
2703-2021_03_20_202437.jpg,car,26,190,640,17,360,134,1,216,151,LTAdatasets/2703/annotate/2703-2021_03_20_202437.jpg,203.0,142.5,0.3171875,0.3958333333333333,0.040625,0.04722222222222222
2703-2021_03_20_180710.jpg,van,41,534,640,33,360,166,3,575,199,LTAdatasets/2703/annotate/2703-2021_03_20_180710.jpg,554.5,182.5,0.86640625,0.5069444444444444,0.0640625,0.09166666666666666
2703-2021_03_20_180710.jpg,car,39,461,640,38,360,188,1,500,226,LTAdatasets/2703/annotate/2703-2021_03_20_180710.jpg,480.5,207.0,0.75078125,0.575,0.0609375,0.10555555555555556
2703-2021_03_20_180710.jpg,car,74,539,640,59,360,301,1,613,360,LTAdatasets/2703/annotate/2703-2021_03_20_180710.jpg,576.0,330.5,0.9,0.9180555555555555,0.115625,0.1638888888888889
2703-2021_03_20_180710.jpg,car,44,279,640,47,360,221,1,323,268,LTAdatasets/2703/annotate/2703-2021_03_20_180710.jpg,301.0,244.5,0.4703125,0.6791666666666667,0.06875,0.13055555555555556
2703-2021_03_20_180710.jpg,car,22,441,640,17,360,124,1,463,141,LTAdatasets/2703/annotate/2703-2021_03_20_180710.jpg,452.0,132.5,0.70625,0.3680555555555556,0.034375,0.04722222222222222
2703-2021_03_20_180710.jpg,car,15,477,640,13,360,129,1,492,142,LTAdatasets/2703/annotate/2703-2021_03_20_180710.jpg,484.5,135.5,0.75703125,0.3763888888888889,0.0234375,0.03611111111111111
2703-2021_03_20_180710.jpg,car,22,336,640,23,360,149,1,358,172,LTAdatasets/2703/annotate/2703-2021_03_20_180710.jpg,347.0,160.5,0.5421875,0.44583333333333336,0.034375,0.06388888888888888
2703-2021_03_20_180710.jpg,car,22,258,640,10,360,142,1,280,152,LTAdatasets/2703/annotate/2703-2021_03_20_180710.jpg,269.0,147.0,0.4203125,0.4083333333333333,0.034375,0.027777777777777776
2703-2021_03_20_180710.jpg,van,24,205,640,14,360,131,3,229,145,LTAdatasets/2703/annotate/2703-2021_03_20_180710.jpg,217.0,138.0,0.3390625,0.38333333333333336,0.0375,0.03888888888888889
2703-2021_03_20_180710.jpg,car,29,102,640,16,360,170,1,131,186,LTAdatasets/2703/annotate/2703-2021_03_20_180710.jpg,116.5,178.0,0.18203125,0.49444444444444446,0.0453125,0.044444444444444446
2703-2021_03_20_094605.jpg,car,55,79,640,37,360,238,1,134,275,LTAdatasets/2703/annotate/2703-2021_03_20_094605.jpg,106.5,256.5,0.16640625,0.7125,0.0859375,0.10277777777777777
2703-2021_03_20_094605.jpg,car,18,414,640,19,360,118,1,432,137,LTAdatasets/2703/annotate/2703-2021_03_20_094605.jpg,423.0,127.5,0.6609375,0.3541666666666667,0.028125,0.05277777777777778
2703-2021_03_20_094605.jpg,car,34,524,640,30,360,160,1,558,190,LTAdatasets/2703/annotate/2703-2021_03_20_094605.jpg,541.0,175.0,0.8453125,0.4861111111111111,0.053125,0.08333333333333333
2703-2021_03_20_094605.jpg,bus,51,176,640,45,360,141,5,227,186,LTAdatasets/2703/annotate/2703-2021_03_20_094605.jpg,201.5,163.5,0.31484375,0.45416666666666666,0.0796875,0.125
2703-2021_03_20_094605.jpg,lorry_truck,48,69,640,28,360,161,2,117,189,LTAdatasets/2703/annotate/2703-2021_03_20_094605.jpg,93.0,175.0,0.1453125,0.4861111111111111,0.075,0.07777777777777778
2703-2021_03_20_094605.jpg,car,20,432,640,12,360,111,1,452,123,LTAdatasets/2703/annotate/2703-2021_03_20_094605.jpg,442.0,117.0,0.690625,0.325,0.03125,0.03333333333333333
2703-2021_03_20_200937.jpg,car,23,253,640,14,360,141,1,276,155,LTAdatasets/2703/annotate/2703-2021_03_20_200937.jpg,264.5,148.0,0.41328125,0.4111111111111111,0.0359375,0.03888888888888889
2703-2021_03_20_200937.jpg,car,31,226,640,23,360,176,1,257,199,LTAdatasets/2703/annotate/2703-2021_03_20_200937.jpg,241.5,187.5,0.37734375,0.5208333333333334,0.0484375,0.06388888888888888
2703-2021_03_20_200937.jpg,car,23,368,640,24,360,125,1,391,149,LTAdatasets/2703/annotate/2703-2021_03_20_200937.jpg,379.5,137.0,0.59296875,0.38055555555555554,0.0359375,0.06666666666666667
2703-2021_03_20_200937.jpg,bike,9,426,640,15,360,107,4,435,122,LTAdatasets/2703/annotate/2703-2021_03_20_200937.jpg,430.5,114.5,0.67265625,0.31805555555555554,0.0140625,0.041666666666666664
2703-2021_03_20_200937.jpg,car,18,298,640,12,360,129,1,316,141,LTAdatasets/2703/annotate/2703-2021_03_20_200937.jpg,307.0,135.0,0.4796875,0.375,0.028125,0.03333333333333333
2703-2021_03_20_200937.jpg,lorry_truck,18,443,640,19,360,103,2,461,122,LTAdatasets/2703/annotate/2703-2021_03_20_200937.jpg,452.0,112.5,0.70625,0.3125,0.028125,0.05277777777777778
2703-2021_03_20_200937.jpg,car,18,300,640,10,360,112,1,318,122,LTAdatasets/2703/annotate/2703-2021_03_20_200937.jpg,309.0,117.0,0.4828125,0.325,0.028125,0.027777777777777776
2703-2021_03_20_082740.jpg,car,45,510,640,36,360,199,1,555,235,LTAdatasets/2703/annotate/2703-2021_03_20_082740.jpg,532.5,217.0,0.83203125,0.6027777777777777,0.0703125,0.1
2703-2021_03_20_082740.jpg,lorry_truck,26,495,640,34,360,126,2,521,160,LTAdatasets/2703/annotate/2703-2021_03_20_082740.jpg,508.0,143.0,0.79375,0.3972222222222222,0.040625,0.09444444444444444
2703-2021_03_20_082740.jpg,car,14,419,640,16,360,124,1,433,140,LTAdatasets/2703/annotate/2703-2021_03_20_082740.jpg,426.0,132.0,0.665625,0.36666666666666664,0.021875,0.044444444444444446
2703-2021_03_20_082740.jpg,car,16,302,640,9,360,127,1,318,136,LTAdatasets/2703/annotate/2703-2021_03_20_082740.jpg,310.0,131.5,0.484375,0.36527777777777776,0.025,0.025
2703-2021_03_20_082740.jpg,car,23,240,640,18,360,144,1,263,162,LTAdatasets/2703/annotate/2703-2021_03_20_082740.jpg,251.5,153.0,0.39296875,0.425,0.0359375,0.05
2703-2021_03_20_091903.jpg,bike,16,488,640,20,360,157,4,504,177,LTAdatasets/2703/annotate/2703-2021_03_20_091903.jpg,496.0,167.0,0.775,0.4638888888888889,0.025,0.05555555555555555
2703-2021_03_20_091903.jpg,bike,11,468,640,19,360,149,4,479,168,LTAdatasets/2703/annotate/2703-2021_03_20_091903.jpg,473.5,158.5,0.73984375,0.44027777777777777,0.0171875,0.05277777777777778
2703-2021_03_20_091903.jpg,bike,14,464,640,18,360,132,4,478,150,LTAdatasets/2703/annotate/2703-2021_03_20_091903.jpg,471.0,141.0,0.7359375,0.39166666666666666,0.021875,0.05
2703-2021_03_20_091903.jpg,car,22,422,640,18,360,136,1,444,154,LTAdatasets/2703/annotate/2703-2021_03_20_091903.jpg,433.0,145.0,0.6765625,0.4027777777777778,0.034375,0.05
2703-2021_03_20_091903.jpg,car,30,443,640,29,360,161,1,473,190,LTAdatasets/2703/annotate/2703-2021_03_20_091903.jpg,458.0,175.5,0.715625,0.4875,0.046875,0.08055555555555556
2703-2021_03_20_091903.jpg,car,28,499,640,28,360,138,1,527,166,LTAdatasets/2703/annotate/2703-2021_03_20_091903.jpg,513.0,152.0,0.8015625,0.4222222222222222,0.04375,0.07777777777777778
2703-2021_03_20_091903.jpg,car,24,606,640,24,360,336,1,630,360,LTAdatasets/2703/annotate/2703-2021_03_20_091903.jpg,618.0,348.0,0.965625,0.9666666666666667,0.0375,0.06666666666666667
2703-2021_03_20_091903.jpg,car,27,214,640,20,360,159,1,241,179,LTAdatasets/2703/annotate/2703-2021_03_20_091903.jpg,227.5,169.0,0.35546875,0.46944444444444444,0.0421875,0.05555555555555555
2703-2021_03_20_091903.jpg,lorry_truck,48,148,640,33,360,123,2,196,156,LTAdatasets/2703/annotate/2703-2021_03_20_091903.jpg,172.0,139.5,0.26875,0.3875,0.075,0.09166666666666666
2703-2021_03_20_091903.jpg,car,33,65,640,18,360,182,1,98,200,LTAdatasets/2703/annotate/2703-2021_03_20_091903.jpg,81.5,191.0,0.12734375,0.5305555555555556,0.0515625,0.05
2703-2021_03_20_091903.jpg,car,15,404,640,8,360,110,1,419,118,LTAdatasets/2703/annotate/2703-2021_03_20_091903.jpg,411.5,114.0,0.64296875,0.31666666666666665,0.0234375,0.022222222222222223
2703-2021_03_20_095505.jpg,van,26,272,640,14,360,119,3,298,133,LTAdatasets/2703/annotate/2703-2021_03_20_095505.jpg,285.0,126.0,0.4453125,0.35,0.040625,0.03888888888888889
2703-2021_03_20_095505.jpg,car,18,483,640,22,360,131,1,501,153,LTAdatasets/2703/annotate/2703-2021_03_20_095505.jpg,492.0,142.0,0.76875,0.39444444444444443,0.028125,0.06111111111111111
2703-2021_03_20_095505.jpg,car,48,72,640,33,360,218,1,120,251,LTAdatasets/2703/annotate/2703-2021_03_20_095505.jpg,96.0,234.5,0.15,0.6513888888888889,0.075,0.09166666666666666
2703-2021_03_20_095505.jpg,car,30,447,640,26,360,167,1,477,193,LTAdatasets/2703/annotate/2703-2021_03_20_095505.jpg,462.0,180.0,0.721875,0.5,0.046875,0.07222222222222222
2703-2021_03_20_095505.jpg,car,34,537,640,34,360,175,1,571,209,LTAdatasets/2703/annotate/2703-2021_03_20_095505.jpg,554.0,192.0,0.865625,0.5333333333333333,0.053125,0.09444444444444444
2703-2021_03_20_095505.jpg,car,58,577,640,63,360,257,1,635,320,LTAdatasets/2703/annotate/2703-2021_03_20_095505.jpg,606.0,288.5,0.946875,0.8013888888888889,0.090625,0.175
2703-2021_03_20_095505.jpg,car,19,464,640,15,360,146,1,483,161,LTAdatasets/2703/annotate/2703-2021_03_20_095505.jpg,473.5,153.5,0.73984375,0.4263888888888889,0.0296875,0.041666666666666664
2703-2021_03_20_095505.jpg,car,16,338,640,20,360,138,1,354,158,LTAdatasets/2703/annotate/2703-2021_03_20_095505.jpg,346.0,148.0,0.540625,0.4111111111111111,0.025,0.05555555555555555
2703-2021_03_20_095505.jpg,car,30,212,640,28,360,160,1,242,188,LTAdatasets/2703/annotate/2703-2021_03_20_095505.jpg,227.0,174.0,0.3546875,0.48333333333333334,0.046875,0.07777777777777778
2703-2021_03_20_095505.jpg,car,49,235,640,69,360,261,1,284,330,LTAdatasets/2703/annotate/2703-2021_03_20_095505.jpg,259.5,295.5,0.40546875,0.8208333333333333,0.0765625,0.19166666666666668
2703-2021_03_20_095505.jpg,bike,12,417,640,14,360,119,4,429,133,LTAdatasets/2703/annotate/2703-2021_03_20_095505.jpg,423.0,126.0,0.6609375,0.35,0.01875,0.03888888888888889
2703-2021_03_20_095505.jpg,bike,10,466,640,17,360,129,4,476,146,LTAdatasets/2703/annotate/2703-2021_03_20_095505.jpg,471.0,137.5,0.7359375,0.3819444444444444,0.015625,0.04722222222222222
2703-2021_03_20_095505.jpg,car,17,437,640,17,360,116,1,454,133,LTAdatasets/2703/annotate/2703-2021_03_20_095505.jpg,445.5,124.5,0.69609375,0.3458333333333333,0.0265625,0.04722222222222222
2703-2021_03_20_095505.jpg,car,10,358,640,9,360,110,1,368,119,LTAdatasets/2703/annotate/2703-2021_03_20_095505.jpg,363.0,114.5,0.5671875,0.31805555555555554,0.015625,0.025
2703-2021_03_20_074918.jpg,car,30,442,640,31,360,152,1,472,183,LTAdatasets/2703/annotate/2703-2021_03_20_074918.jpg,457.0,167.5,0.7140625,0.4652777777777778,0.046875,0.08611111111111111
2703-2021_03_20_074918.jpg,lorry_truck,45,146,640,38,360,165,2,191,203,LTAdatasets/2703/annotate/2703-2021_03_20_074918.jpg,168.5,184.0,0.26328125,0.5111111111111111,0.0703125,0.10555555555555556
2703-2021_03_20_074918.jpg,bike,12,361,640,11,360,117,4,373,128,LTAdatasets/2703/annotate/2703-2021_03_20_074918.jpg,367.0,122.5,0.5734375,0.3402777777777778,0.01875,0.030555555555555555
2703-2021_03_20_074918.jpg,lorry_truck,20,252,640,17,360,123,2,272,140,LTAdatasets/2703/annotate/2703-2021_03_20_074918.jpg,262.0,131.5,0.409375,0.36527777777777776,0.03125,0.04722222222222222
2703-2021_03_20_073037.jpg,car,24,468,640,23,360,154,1,492,177,LTAdatasets/2703/annotate/2703-2021_03_20_073037.jpg,480.0,165.5,0.75,0.4597222222222222,0.0375,0.06388888888888888
2703-2021_03_20_073037.jpg,car,20,423,640,22,360,134,1,443,156,LTAdatasets/2703/annotate/2703-2021_03_20_073037.jpg,433.0,145.0,0.6765625,0.4027777777777778,0.03125,0.06111111111111111
2703-2021_03_20_073037.jpg,car,38,501,640,31,360,187,1,539,218,LTAdatasets/2703/annotate/2703-2021_03_20_073037.jpg,520.0,202.5,0.8125,0.5625,0.059375,0.08611111111111111
2703-2021_03_20_073037.jpg,car,26,254,640,15,360,144,1,280,159,LTAdatasets/2703/annotate/2703-2021_03_20_073037.jpg,267.0,151.5,0.4171875,0.42083333333333334,0.040625,0.041666666666666664
2703-2021_03_20_073037.jpg,lorry_truck,31,471,640,41,360,186,2,502,227,LTAdatasets/2703/annotate/2703-2021_03_20_073037.jpg,486.5,206.5,0.76015625,0.5736111111111111,0.0484375,0.11388888888888889
2703-2021_03_20_073037.jpg,lorry_truck,24,449,640,25,360,121,2,473,146,LTAdatasets/2703/annotate/2703-2021_03_20_073037.jpg,461.0,133.5,0.7203125,0.37083333333333335,0.0375,0.06944444444444445
2703-2021_03_20_073037.jpg,lorry_truck,17,433,640,13,360,115,2,450,128,LTAdatasets/2703/annotate/2703-2021_03_20_073037.jpg,441.5,121.5,0.68984375,0.3375,0.0265625,0.03611111111111111
2703-2021_03_20_073037.jpg,lorry_truck,17,371,640,18,360,118,2,388,136,LTAdatasets/2703/annotate/2703-2021_03_20_073037.jpg,379.5,127.0,0.59296875,0.3527777777777778,0.0265625,0.05
2703-2021_03_20_073037.jpg,lorry_truck,26,255,640,21,360,114,2,281,135,LTAdatasets/2703/annotate/2703-2021_03_20_073037.jpg,268.0,124.5,0.41875,0.3458333333333333,0.040625,0.058333333333333334
2703-2021_03_20_073037.jpg,car,48,20,640,33,360,287,1,68,320,LTAdatasets/2703/annotate/2703-2021_03_20_073037.jpg,44.0,303.5,0.06875,0.8430555555555556,0.075,0.09166666666666666
2703-2021_03_20_073037.jpg,bike,13,413,640,16,360,115,4,426,131,LTAdatasets/2703/annotate/2703-2021_03_20_073037.jpg,419.5,123.0,0.65546875,0.3416666666666667,0.0203125,0.044444444444444446
2703-2021_03_20_191234.jpg,car,35,194,640,18,360,180,1,229,198,LTAdatasets/2703/annotate/2703-2021_03_20_191234.jpg,211.5,189.0,0.33046875,0.525,0.0546875,0.05
2703-2021_03_20_191234.jpg,bike,24,46,640,28,360,248,4,70,276,LTAdatasets/2703/annotate/2703-2021_03_20_191234.jpg,58.0,262.0,0.090625,0.7277777777777777,0.0375,0.07777777777777778
2703-2021_03_20_191234.jpg,car,63,31,640,46,360,312,1,94,358,LTAdatasets/2703/annotate/2703-2021_03_20_191234.jpg,62.5,335.0,0.09765625,0.9305555555555556,0.0984375,0.12777777777777777
2703-2021_03_20_191234.jpg,car,18,262,640,18,360,132,1,280,150,LTAdatasets/2703/annotate/2703-2021_03_20_191234.jpg,271.0,141.0,0.4234375,0.39166666666666666,0.028125,0.05
2703-2021_03_20_191234.jpg,car,17,299,640,14,360,132,1,316,146,LTAdatasets/2703/annotate/2703-2021_03_20_191234.jpg,307.5,139.0,0.48046875,0.3861111111111111,0.0265625,0.03888888888888889
2703-2021_03_20_191234.jpg,car,16,372,640,11,360,115,1,388,126,LTAdatasets/2703/annotate/2703-2021_03_20_191234.jpg,380.0,120.5,0.59375,0.3347222222222222,0.025,0.030555555555555555
2703-2021_03_20_191234.jpg,car,17,178,640,13,360,143,1,195,156,LTAdatasets/2703/annotate/2703-2021_03_20_191234.jpg,186.5,149.5,0.29140625,0.4152777777777778,0.0265625,0.03611111111111111
2703-2021_03_20_081319.jpg,car,34,491,640,35,360,170,1,525,205,LTAdatasets/2703/annotate/2703-2021_03_20_081319.jpg,508.0,187.5,0.79375,0.5208333333333334,0.053125,0.09722222222222222
2703-2021_03_20_081319.jpg,car,22,492,640,19,360,140,1,514,159,LTAdatasets/2703/annotate/2703-2021_03_20_081319.jpg,503.0,149.5,0.7859375,0.4152777777777778,0.034375,0.05277777777777778
2703-2021_03_20_081319.jpg,car,19,447,640,23,360,123,1,466,146,LTAdatasets/2703/annotate/2703-2021_03_20_081319.jpg,456.5,134.5,0.71328125,0.3736111111111111,0.0296875,0.06388888888888888
2703-2021_03_20_081319.jpg,car,23,219,640,14,360,151,1,242,165,LTAdatasets/2703/annotate/2703-2021_03_20_081319.jpg,230.5,158.0,0.36015625,0.4388888888888889,0.0359375,0.03888888888888889
2703-2021_03_20_081319.jpg,lorry_truck,71,142,640,49,360,164,2,213,213,LTAdatasets/2703/annotate/2703-2021_03_20_081319.jpg,177.5,188.5,0.27734375,0.5236111111111111,0.1109375,0.1361111111111111
2703-2021_03_20_093724.jpg,van,42,592,640,61,360,197,3,634,258,LTAdatasets/2703/annotate/2703-2021_03_20_093724.jpg,613.0,227.5,0.9578125,0.6319444444444444,0.065625,0.16944444444444445
2703-2021_03_20_093724.jpg,car,70,31,640,37,360,260,1,101,297,LTAdatasets/2703/annotate/2703-2021_03_20_093724.jpg,66.0,278.5,0.103125,0.7736111111111111,0.109375,0.10277777777777777
2703-2021_03_20_093724.jpg,car,27,250,640,14,360,143,1,277,157,LTAdatasets/2703/annotate/2703-2021_03_20_093724.jpg,263.5,150.0,0.41171875,0.4166666666666667,0.0421875,0.03888888888888889
2703-2021_03_20_093724.jpg,bike,16,252,640,11,360,130,4,268,141,LTAdatasets/2703/annotate/2703-2021_03_20_093724.jpg,260.0,135.5,0.40625,0.3763888888888889,0.025,0.030555555555555555
2703-2021_03_20_200637.jpg,car,24,275,640,15,360,128,1,299,143,LTAdatasets/2703/annotate/2703-2021_03_20_200637.jpg,287.0,135.5,0.4484375,0.3763888888888889,0.0375,0.041666666666666664
2703-2021_03_20_200637.jpg,lorry_truck,30,360,640,47,360,155,2,390,202,LTAdatasets/2703/annotate/2703-2021_03_20_200637.jpg,375.0,178.5,0.5859375,0.49583333333333335,0.046875,0.13055555555555556
2703-2021_03_20_200637.jpg,car,36,482,640,35,360,158,1,518,193,LTAdatasets/2703/annotate/2703-2021_03_20_200637.jpg,500.0,175.5,0.78125,0.4875,0.05625,0.09722222222222222
2703-2021_03_20_200637.jpg,lorry_truck,23,617,640,41,360,222,2,640,263,LTAdatasets/2703/annotate/2703-2021_03_20_200637.jpg,628.5,242.5,0.98203125,0.6736111111111112,0.0359375,0.11388888888888889
2703-2021_03_20_200637.jpg,car,56,30,640,41,360,271,1,86,312,LTAdatasets/2703/annotate/2703-2021_03_20_200637.jpg,58.0,291.5,0.090625,0.8097222222222222,0.0875,0.11388888888888889
2703-2021_03_20_200637.jpg,car,19,293,640,14,360,112,1,312,126,LTAdatasets/2703/annotate/2703-2021_03_20_200637.jpg,302.5,119.0,0.47265625,0.33055555555555555,0.0296875,0.03888888888888889
2703-2021_03_20_200637.jpg,car,25,168,640,11,360,146,1,193,157,LTAdatasets/2703/annotate/2703-2021_03_20_200637.jpg,180.5,151.5,0.28203125,0.42083333333333334,0.0390625,0.030555555555555555
2703-2021_03_20_082220.jpg,car,41,278,640,43,360,209,1,319,252,LTAdatasets/2703/annotate/2703-2021_03_20_082220.jpg,298.5,230.5,0.46640625,0.6402777777777777,0.0640625,0.11944444444444445
2703-2021_03_20_082220.jpg,car,26,512,640,44,360,184,1,538,228,LTAdatasets/2703/annotate/2703-2021_03_20_082220.jpg,525.0,206.0,0.8203125,0.5722222222222222,0.040625,0.12222222222222222
2703-2021_03_20_082220.jpg,car,25,497,640,23,360,146,1,522,169,LTAdatasets/2703/annotate/2703-2021_03_20_082220.jpg,509.5,157.5,0.79609375,0.4375,0.0390625,0.06388888888888888
2703-2021_03_20_082220.jpg,car,18,331,640,25,360,159,1,349,184,LTAdatasets/2703/annotate/2703-2021_03_20_082220.jpg,340.0,171.5,0.53125,0.47638888888888886,0.028125,0.06944444444444445
2703-2021_03_20_082220.jpg,car,14,447,640,14,360,129,1,461,143,LTAdatasets/2703/annotate/2703-2021_03_20_082220.jpg,454.0,136.0,0.709375,0.37777777777777777,0.021875,0.03888888888888889
2703-2021_03_20_082220.jpg,car,18,416,640,16,360,123,1,434,139,LTAdatasets/2703/annotate/2703-2021_03_20_082220.jpg,425.0,131.0,0.6640625,0.3638888888888889,0.028125,0.044444444444444446
2703-2021_03_20_082220.jpg,bike,8,238,640,21,360,146,4,246,167,LTAdatasets/2703/annotate/2703-2021_03_20_082220.jpg,242.0,156.5,0.378125,0.43472222222222223,0.0125,0.058333333333333334
2703-2021_03_20_083120.jpg,lorry_truck,28,369,640,24,360,109,2,397,133,LTAdatasets/2703/annotate/2703-2021_03_20_083120.jpg,383.0,121.0,0.5984375,0.33611111111111114,0.04375,0.06666666666666667
2703-2021_03_20_083120.jpg,lorry_truck,32,528,640,33,360,159,2,560,192,LTAdatasets/2703/annotate/2703-2021_03_20_083120.jpg,544.0,175.5,0.85,0.4875,0.05,0.09166666666666666
2703-2021_03_20_083120.jpg,bike,14,352,640,26,360,188,4,366,214,LTAdatasets/2703/annotate/2703-2021_03_20_083120.jpg,359.0,201.0,0.5609375,0.5583333333333333,0.021875,0.07222222222222222
2703-2021_03_20_083120.jpg,lorry_truck,19,444,640,12,360,128,2,463,140,LTAdatasets/2703/annotate/2703-2021_03_20_083120.jpg,453.5,134.0,0.70859375,0.37222222222222223,0.0296875,0.03333333333333333
2703-2021_03_20_083120.jpg,lorry_truck,19,463,640,17,360,114,2,482,131,LTAdatasets/2703/annotate/2703-2021_03_20_083120.jpg,472.5,122.5,0.73828125,0.3402777777777778,0.0296875,0.04722222222222222
2703-2021_03_20_083120.jpg,van,23,244,640,21,360,139,3,267,160,LTAdatasets/2703/annotate/2703-2021_03_20_083120.jpg,255.5,149.5,0.39921875,0.4152777777777778,0.0359375,0.058333333333333334
2703-2021_03_20_083120.jpg,lorry_truck,74,6,640,62,360,224,2,80,286,LTAdatasets/2703/annotate/2703-2021_03_20_083120.jpg,43.0,255.0,0.0671875,0.7083333333333334,0.115625,0.17222222222222222
2703-2021_03_20_083120.jpg,car,54,107,640,37,360,267,1,161,304,LTAdatasets/2703/annotate/2703-2021_03_20_083120.jpg,134.0,285.5,0.209375,0.7930555555555555,0.084375,0.10277777777777777
2703-2021_03_20_083120.jpg,car,24,137,640,15,360,154,1,161,169,LTAdatasets/2703/annotate/2703-2021_03_20_083120.jpg,149.0,161.5,0.2328125,0.4486111111111111,0.0375,0.041666666666666664
2703-2021_03_20_192214.jpg,car,38,188,640,29,360,208,1,226,237,LTAdatasets/2703/annotate/2703-2021_03_20_192214.jpg,207.0,222.5,0.3234375,0.6180555555555556,0.059375,0.08055555555555556
2703-2021_03_20_192214.jpg,car,21,251,640,14,360,142,1,272,156,LTAdatasets/2703/annotate/2703-2021_03_20_192214.jpg,261.5,149.0,0.40859375,0.41388888888888886,0.0328125,0.03888888888888889
2703-2021_03_20_192214.jpg,van,55,86,640,42,360,221,3,141,263,LTAdatasets/2703/annotate/2703-2021_03_20_192214.jpg,113.5,242.0,0.17734375,0.6722222222222223,0.0859375,0.11666666666666667
2703-2021_03_20_192214.jpg,van,25,319,640,32,360,171,3,344,203,LTAdatasets/2703/annotate/2703-2021_03_20_192214.jpg,331.5,187.0,0.51796875,0.5194444444444445,0.0390625,0.08888888888888889
2703-2021_03_20_192214.jpg,car,25,469,640,25,360,150,1,494,175,LTAdatasets/2703/annotate/2703-2021_03_20_192214.jpg,481.5,162.5,0.75234375,0.4513888888888889,0.0390625,0.06944444444444445
2703-2021_03_20_192214.jpg,car,63,33,640,34,360,324,1,96,358,LTAdatasets/2703/annotate/2703-2021_03_20_192214.jpg,64.5,341.0,0.10078125,0.9472222222222222,0.0984375,0.09444444444444444
2703-2021_03_20_192214.jpg,car,22,215,640,13,360,128,1,237,141,LTAdatasets/2703/annotate/2703-2021_03_20_192214.jpg,226.0,134.5,0.353125,0.3736111111111111,0.034375,0.03611111111111111
2703-2021_03_20_192214.jpg,bus,28,364,640,38,360,100,5,392,138,LTAdatasets/2703/annotate/2703-2021_03_20_192214.jpg,378.0,119.0,0.590625,0.33055555555555555,0.04375,0.10555555555555556
2703-2021_03_20_192214.jpg,bike,8,431,640,12,360,116,4,439,128,LTAdatasets/2703/annotate/2703-2021_03_20_192214.jpg,435.0,122.0,0.6796875,0.3388888888888889,0.0125,0.03333333333333333
2703-2021_03_20_192214.jpg,bike,10,442,640,15,360,102,4,452,117,LTAdatasets/2703/annotate/2703-2021_03_20_192214.jpg,447.0,109.5,0.6984375,0.30416666666666664,0.015625,0.041666666666666664
2703-2021_03_20_191014.jpg,car,60,115,640,36,360,218,1,175,254,LTAdatasets/2703/annotate/2703-2021_03_20_191014.jpg,145.0,236.0,0.2265625,0.6555555555555556,0.09375,0.1
2703-2021_03_20_191014.jpg,car,32,237,640,21,360,154,1,269,175,LTAdatasets/2703/annotate/2703-2021_03_20_191014.jpg,253.0,164.5,0.3953125,0.45694444444444443,0.05,0.058333333333333334
2703-2021_03_20_191014.jpg,car,26,498,640,17,360,145,1,524,162,LTAdatasets/2703/annotate/2703-2021_03_20_191014.jpg,511.0,153.5,0.7984375,0.4263888888888889,0.040625,0.04722222222222222
2703-2021_03_20_191014.jpg,car,19,406,640,13,360,112,1,425,125,LTAdatasets/2703/annotate/2703-2021_03_20_191014.jpg,415.5,118.5,0.64921875,0.32916666666666666,0.0296875,0.03611111111111111
2703-2021_03_20_191014.jpg,van,21,370,640,34,360,111,3,391,145,LTAdatasets/2703/annotate/2703-2021_03_20_191014.jpg,380.5,128.0,0.59453125,0.35555555555555557,0.0328125,0.09444444444444444
2703-2021_03_20_191014.jpg,bus,54,176,640,48,360,128,5,230,176,LTAdatasets/2703/annotate/2703-2021_03_20_191014.jpg,203.0,152.0,0.3171875,0.4222222222222222,0.084375,0.13333333333333333
2703-2021_03_20_191014.jpg,car,19,288,640,14,360,129,1,307,143,LTAdatasets/2703/annotate/2703-2021_03_20_191014.jpg,297.5,136.0,0.46484375,0.37777777777777777,0.0296875,0.03888888888888889
2703-2021_03_20_191014.jpg,lorry_truck,20,433,640,15,360,105,2,453,120,LTAdatasets/2703/annotate/2703-2021_03_20_191014.jpg,443.0,112.5,0.6921875,0.3125,0.03125,0.041666666666666664
2703-2021_03_20_194616.jpg,car,26,313,640,32,360,175,1,339,207,LTAdatasets/2703/annotate/2703-2021_03_20_194616.jpg,326.0,191.0,0.509375,0.5305555555555556,0.040625,0.08888888888888889
2703-2021_03_20_194616.jpg,car,36,168,640,26,360,188,1,204,214,LTAdatasets/2703/annotate/2703-2021_03_20_194616.jpg,186.0,201.0,0.290625,0.5583333333333333,0.05625,0.07222222222222222
2703-2021_03_20_194616.jpg,car,49,147,640,34,360,225,1,196,259,LTAdatasets/2703/annotate/2703-2021_03_20_194616.jpg,171.5,242.0,0.26796875,0.6722222222222223,0.0765625,0.09444444444444444
2703-2021_03_20_194616.jpg,car,16,303,640,11,360,125,1,319,136,LTAdatasets/2703/annotate/2703-2021_03_20_194616.jpg,311.0,130.5,0.4859375,0.3625,0.025,0.030555555555555555
2703-2021_03_20_194616.jpg,car,26,90,640,12,360,178,1,116,190,LTAdatasets/2703/annotate/2703-2021_03_20_194616.jpg,103.0,184.0,0.1609375,0.5111111111111111,0.040625,0.03333333333333333
2703-2021_03_20_184913.jpg,car,59,581,640,60,360,261,1,640,321,LTAdatasets/2703/annotate/2703-2021_03_20_184913.jpg,610.5,291.0,0.95390625,0.8083333333333333,0.0921875,0.16666666666666666
2703-2021_03_20_184913.jpg,car,67,22,640,43,360,276,1,89,319,LTAdatasets/2703/annotate/2703-2021_03_20_184913.jpg,55.5,297.5,0.08671875,0.8263888888888888,0.1046875,0.11944444444444445
2703-2021_03_20_184913.jpg,lorry_truck,24,369,640,20,360,120,2,393,140,LTAdatasets/2703/annotate/2703-2021_03_20_184913.jpg,381.0,130.0,0.5953125,0.3611111111111111,0.0375,0.05555555555555555
2703-2021_03_20_184913.jpg,car,26,462,640,22,360,141,1,488,163,LTAdatasets/2703/annotate/2703-2021_03_20_184913.jpg,475.0,152.0,0.7421875,0.4222222222222222,0.040625,0.06111111111111111
2703-2021_03_20_184913.jpg,car,16,275,640,13,360,124,1,291,137,LTAdatasets/2703/annotate/2703-2021_03_20_184913.jpg,283.0,130.5,0.4421875,0.3625,0.025,0.03611111111111111
2703-2021_03_20_184913.jpg,car,31,140,640,12,360,150,1,171,162,LTAdatasets/2703/annotate/2703-2021_03_20_184913.jpg,155.5,156.0,0.24296875,0.43333333333333335,0.0484375,0.03333333333333333
2703-2021_03_20_184913.jpg,car,32,63,640,17,360,186,1,95,203,LTAdatasets/2703/annotate/2703-2021_03_20_184913.jpg,79.0,194.5,0.1234375,0.5402777777777777,0.05,0.04722222222222222
2703-2021_03_20_073937.jpg,lorry_truck,19,444,640,29,360,101,2,463,130,LTAdatasets/2703/annotate/2703-2021_03_20_073937.jpg,453.5,115.5,0.70859375,0.32083333333333336,0.0296875,0.08055555555555556
2703-2021_03_20_073937.jpg,car,17,259,640,9,360,131,1,276,140,LTAdatasets/2703/annotate/2703-2021_03_20_073937.jpg,267.5,135.5,0.41796875,0.3763888888888889,0.0265625,0.025
2703-2021_03_20_092803.jpg,van,24,461,640,18,360,117,3,485,135,LTAdatasets/2703/annotate/2703-2021_03_20_092803.jpg,473.0,126.0,0.7390625,0.35,0.0375,0.05
2703-2021_03_20_092803.jpg,car,21,484,640,13,360,134,1,505,147,LTAdatasets/2703/annotate/2703-2021_03_20_092803.jpg,494.5,140.5,0.77265625,0.3902777777777778,0.0328125,0.03611111111111111
2703-2021_03_20_092803.jpg,lorry_truck,58,75,640,39,360,150,2,133,189,LTAdatasets/2703/annotate/2703-2021_03_20_092803.jpg,104.0,169.5,0.1625,0.4708333333333333,0.090625,0.10833333333333334
2703-2021_03_20_092803.jpg,car,16,462,640,23,360,162,1,478,185,LTAdatasets/2703/annotate/2703-2021_03_20_092803.jpg,470.0,173.5,0.734375,0.48194444444444445,0.025,0.06388888888888888
2703-2021_03_20_092803.jpg,car,24,436,640,16,360,123,1,460,139,LTAdatasets/2703/annotate/2703-2021_03_20_092803.jpg,448.0,131.0,0.7,0.3638888888888889,0.0375,0.044444444444444446
2703-2021_03_20_092803.jpg,car,17,367,640,22,360,146,1,384,168,LTAdatasets/2703/annotate/2703-2021_03_20_092803.jpg,375.5,157.0,0.58671875,0.4361111111111111,0.0265625,0.06111111111111111
2703-2021_03_20_092803.jpg,bike,21,199,640,15,360,162,4,220,177,LTAdatasets/2703/annotate/2703-2021_03_20_092803.jpg,209.5,169.5,0.32734375,0.4708333333333333,0.0328125,0.041666666666666664
2703-2021_03_20_092803.jpg,car,29,611,640,54,360,290,1,640,344,LTAdatasets/2703/annotate/2703-2021_03_20_092803.jpg,625.5,317.0,0.97734375,0.8805555555555555,0.0453125,0.15
2703-2021_03_20_085141.jpg,van,42,566,640,43,360,178,3,608,221,LTAdatasets/2703/annotate/2703-2021_03_20_085141.jpg,587.0,199.5,0.9171875,0.5541666666666667,0.065625,0.11944444444444445
2703-2021_03_20_085141.jpg,car,33,481,640,26,360,156,1,514,182,LTAdatasets/2703/annotate/2703-2021_03_20_085141.jpg,497.5,169.0,0.77734375,0.46944444444444444,0.0515625,0.07222222222222222
2703-2021_03_20_085141.jpg,car,15,458,640,16,360,133,1,473,149,LTAdatasets/2703/annotate/2703-2021_03_20_085141.jpg,465.5,141.0,0.72734375,0.39166666666666666,0.0234375,0.044444444444444446
2703-2021_03_20_085141.jpg,car,42,450,640,25,360,181,1,492,206,LTAdatasets/2703/annotate/2703-2021_03_20_085141.jpg,471.0,193.5,0.7359375,0.5375,0.065625,0.06944444444444445
2703-2021_03_20_085141.jpg,car,12,481,640,10,360,130,1,493,140,LTAdatasets/2703/annotate/2703-2021_03_20_085141.jpg,487.0,135.0,0.7609375,0.375,0.01875,0.027777777777777776
2703-2021_03_20_085141.jpg,car,19,428,640,22,360,133,1,447,155,LTAdatasets/2703/annotate/2703-2021_03_20_085141.jpg,437.5,144.0,0.68359375,0.4,0.0296875,0.06111111111111111
2703-2021_03_20_085141.jpg,bike,15,366,640,22,360,166,4,381,188,LTAdatasets/2703/annotate/2703-2021_03_20_085141.jpg,373.5,177.0,0.58359375,0.49166666666666664,0.0234375,0.06111111111111111
2703-2021_03_20_085141.jpg,car,16,338,640,21,360,142,1,354,163,LTAdatasets/2703/annotate/2703-2021_03_20_085141.jpg,346.0,152.5,0.540625,0.4236111111111111,0.025,0.058333333333333334
2703-2021_03_20_085141.jpg,car,24,170,640,15,360,138,1,194,153,LTAdatasets/2703/annotate/2703-2021_03_20_085141.jpg,182.0,145.5,0.284375,0.4041666666666667,0.0375,0.041666666666666664
2703-2021_03_20_085141.jpg,car,17,406,640,9,360,118,1,423,127,LTAdatasets/2703/annotate/2703-2021_03_20_085141.jpg,414.5,122.5,0.64765625,0.3402777777777778,0.0265625,0.025
2703-2021_03_20_085141.jpg,car,18,432,640,14,360,116,1,450,130,LTAdatasets/2703/annotate/2703-2021_03_20_085141.jpg,441.0,123.0,0.6890625,0.3416666666666667,0.028125,0.03888888888888889
2703-2021_03_20_085141.jpg,van,16,460,640,16,360,111,3,476,127,LTAdatasets/2703/annotate/2703-2021_03_20_085141.jpg,468.0,119.0,0.73125,0.33055555555555555,0.025,0.044444444444444446
2703-2021_03_20_193635.jpg,car,24,449,640,36,360,160,1,473,196,LTAdatasets/2703/annotate/2703-2021_03_20_193635.jpg,461.0,178.0,0.7203125,0.49444444444444446,0.0375,0.1
2703-2021_03_20_193635.jpg,bike,17,504,640,18,360,175,4,521,193,LTAdatasets/2703/annotate/2703-2021_03_20_193635.jpg,512.5,184.0,0.80078125,0.5111111111111111,0.0265625,0.05
2703-2021_03_20_193635.jpg,bike,15,357,640,15,360,141,4,372,156,LTAdatasets/2703/annotate/2703-2021_03_20_193635.jpg,364.5,148.5,0.56953125,0.4125,0.0234375,0.041666666666666664
2703-2021_03_20_193635.jpg,car,20,243,640,22,360,147,1,263,169,LTAdatasets/2703/annotate/2703-2021_03_20_193635.jpg,253.0,158.0,0.3953125,0.4388888888888889,0.03125,0.06111111111111111
2703-2021_03_20_193635.jpg,car,20,288,640,10,360,120,1,308,130,LTAdatasets/2703/annotate/2703-2021_03_20_193635.jpg,298.0,125.0,0.465625,0.3472222222222222,0.03125,0.027777777777777776
2703-2021_03_20_193635.jpg,bike,10,252,640,15,360,128,4,262,143,LTAdatasets/2703/annotate/2703-2021_03_20_193635.jpg,257.0,135.5,0.4015625,0.3763888888888889,0.015625,0.041666666666666664
2703-2021_03_20_193635.jpg,van,20,199,640,16,360,131,3,219,147,LTAdatasets/2703/annotate/2703-2021_03_20_193635.jpg,209.0,139.0,0.3265625,0.3861111111111111,0.03125,0.044444444444444446
2703-2021_03_20_193635.jpg,van,24,152,640,9,360,152,3,176,161,LTAdatasets/2703/annotate/2703-2021_03_20_193635.jpg,164.0,156.5,0.25625,0.43472222222222223,0.0375,0.025
2703-2021_03_20_081539.jpg,car,32,214,640,21,360,189,1,246,210,LTAdatasets/2703/annotate/2703-2021_03_20_081539.jpg,230.0,199.5,0.359375,0.5541666666666667,0.05,0.058333333333333334
2703-2021_03_20_081539.jpg,van,21,446,640,17,360,128,3,467,145,LTAdatasets/2703/annotate/2703-2021_03_20_081539.jpg,456.5,136.5,0.71328125,0.37916666666666665,0.0328125,0.04722222222222222
2703-2021_03_20_081539.jpg,car,16,300,640,17,360,122,1,316,139,LTAdatasets/2703/annotate/2703-2021_03_20_081539.jpg,308.0,130.5,0.48125,0.3625,0.025,0.04722222222222222
2703-2021_03_20_081539.jpg,bus,25,262,640,23,360,111,5,287,134,LTAdatasets/2703/annotate/2703-2021_03_20_081539.jpg,274.5,122.5,0.42890625,0.3402777777777778,0.0390625,0.06388888888888888
2703-2021_03_20_081539.jpg,lorry_truck,24,183,640,20,360,133,2,207,153,LTAdatasets/2703/annotate/2703-2021_03_20_081539.jpg,195.0,143.0,0.3046875,0.3972222222222222,0.0375,0.05555555555555555
2703-2021_03_20_081539.jpg,lorry_truck,17,441,640,16,360,103,2,458,119,LTAdatasets/2703/annotate/2703-2021_03_20_081539.jpg,449.5,111.0,0.70234375,0.30833333333333335,0.0265625,0.044444444444444446
2703-2021_03_20_081539.jpg,car,47,248,640,25,360,335,1,295,360,LTAdatasets/2703/annotate/2703-2021_03_20_081539.jpg,271.5,347.5,0.42421875,0.9652777777777778,0.0734375,0.06944444444444445
1502-2021_03_20_181251.jpg,car,22,149,320,31,240,43,1,171,74,LTAdatasets/1502/annotate/1502-2021_03_20_181251.jpg,160.0,58.5,0.5,0.24375,0.06875,0.12916666666666668
1502-2021_03_20_181251.jpg,car,13,224,320,13,240,38,1,237,51,LTAdatasets/1502/annotate/1502-2021_03_20_181251.jpg,230.5,44.5,0.7203125,0.18541666666666667,0.040625,0.05416666666666667
1502-2021_03_20_181251.jpg,car,14,200,320,15,240,35,1,214,50,LTAdatasets/1502/annotate/1502-2021_03_20_181251.jpg,207.0,42.5,0.646875,0.17708333333333334,0.04375,0.0625
1502-2021_03_20_083640.jpg,car,43,0,320,88,240,129,1,43,217,LTAdatasets/1502/annotate/1502-2021_03_20_083640.jpg,21.5,173.0,0.0671875,0.7208333333333333,0.134375,0.36666666666666664
1502-2021_03_20_192214.jpg,car,12,225,320,8,240,34,1,237,42,LTAdatasets/1502/annotate/1502-2021_03_20_192214.jpg,231.0,38.0,0.721875,0.15833333333333333,0.0375,0.03333333333333333
1502-2021_03_20_211900.jpg,car,140,20,320,101,240,107,1,160,208,LTAdatasets/1502/annotate/1502-2021_03_20_211900.jpg,90.0,157.5,0.28125,0.65625,0.4375,0.42083333333333334
1502-2021_03_20_211900.jpg,car,35,132,320,30,240,45,1,167,75,LTAdatasets/1502/annotate/1502-2021_03_20_211900.jpg,149.5,60.0,0.4671875,0.25,0.109375,0.125
1502-2021_03_20_211900.jpg,car,51,169,320,38,240,66,1,220,104,LTAdatasets/1502/annotate/1502-2021_03_20_211900.jpg,194.5,85.0,0.6078125,0.3541666666666667,0.159375,0.15833333333333333
1502-2021_03_20_214902.jpg,car,16,182,320,12,240,41,1,198,53,LTAdatasets/1502/annotate/1502-2021_03_20_214902.jpg,190.0,47.0,0.59375,0.19583333333333333,0.05,0.05
1502-2021_03_20_182752.jpg,car,28,199,320,28,240,52,1,227,80,LTAdatasets/1502/annotate/1502-2021_03_20_182752.jpg,213.0,66.0,0.665625,0.275,0.0875,0.11666666666666667
1502-2021_03_20_182752.jpg,car,13,219,320,8,240,33,1,232,41,LTAdatasets/1502/annotate/1502-2021_03_20_182752.jpg,225.5,37.0,0.7046875,0.15416666666666667,0.040625,0.03333333333333333
1502-2021_03_20_182752.jpg,car,67,76,320,45,240,62,1,143,107,LTAdatasets/1502/annotate/1502-2021_03_20_182752.jpg,109.5,84.5,0.3421875,0.35208333333333336,0.209375,0.1875
1502-2021_03_20_204919.jpg,car,66,127,320,51,240,75,1,193,126,LTAdatasets/1502/annotate/1502-2021_03_20_204919.jpg,160.0,100.5,0.5,0.41875,0.20625,0.2125
1502-2021_03_20_204919.jpg,car,14,193,320,18,240,36,1,207,54,LTAdatasets/1502/annotate/1502-2021_03_20_204919.jpg,200.0,45.0,0.625,0.1875,0.04375,0.075
1502-2021_03_20_204919.jpg,car,15,228,320,14,240,39,1,243,53,LTAdatasets/1502/annotate/1502-2021_03_20_204919.jpg,235.5,46.0,0.7359375,0.19166666666666668,0.046875,0.058333333333333334
1502-2021_03_20_204919.jpg,car,11,161,320,22,240,45,1,172,67,LTAdatasets/1502/annotate/1502-2021_03_20_204919.jpg,166.5,56.0,0.5203125,0.23333333333333334,0.034375,0.09166666666666666
1502-2021_03_20_191914.jpg,lorry_truck,20,214,320,21,240,35,2,234,56,LTAdatasets/1502/annotate/1502-2021_03_20_191914.jpg,224.0,45.5,0.7,0.18958333333333333,0.0625,0.0875
1502-2021_03_20_200416.jpg,car,109,4,320,69,240,66,1,113,135,LTAdatasets/1502/annotate/1502-2021_03_20_200416.jpg,58.5,100.5,0.1828125,0.41875,0.340625,0.2875
1502-2021_03_20_075138.jpg,lorry_truck,169,0,320,134,240,17,2,169,151,LTAdatasets/1502/annotate/1502-2021_03_20_075138.jpg,84.5,84.0,0.2640625,0.35,0.528125,0.5583333333333333
1502-2021_03_20_210420.jpg,car,81,1,320,104,240,136,1,82,240,LTAdatasets/1502/annotate/1502-2021_03_20_210420.jpg,41.5,188.0,0.1296875,0.7833333333333333,0.253125,0.43333333333333335
1502-2021_03_20_191234.jpg,car,12,222,320,8,240,33,1,234,41,LTAdatasets/1502/annotate/1502-2021_03_20_191234.jpg,228.0,37.0,0.7125,0.15416666666666667,0.0375,0.03333333333333333
1502-2021_03_20_210940.jpg,lorry_truck,91,74,320,101,240,37,2,165,138,LTAdatasets/1502/annotate/1502-2021_03_20_210940.jpg,119.5,87.5,0.3734375,0.3645833333333333,0.284375,0.42083333333333334
1502-2021_03_20_212801.jpg,car,16,201,320,15,240,37,1,217,52,LTAdatasets/1502/annotate/1502-2021_03_20_212801.jpg,209.0,44.5,0.653125,0.18541666666666667,0.05,0.0625
1502-2021_03_20_212801.jpg,car,19,235,320,15,240,32,1,254,47,LTAdatasets/1502/annotate/1502-2021_03_20_212801.jpg,244.5,39.5,0.7640625,0.16458333333333333,0.059375,0.0625
1502-2021_03_20_201917.jpg,car,19,153,320,24,240,44,1,172,68,LTAdatasets/1502/annotate/1502-2021_03_20_201917.jpg,162.5,56.0,0.5078125,0.23333333333333334,0.059375,0.1
1502-2021_03_20_201917.jpg,car,15,205,320,11,240,33,1,220,44,LTAdatasets/1502/annotate/1502-2021_03_20_201917.jpg,212.5,38.5,0.6640625,0.16041666666666668,0.046875,0.04583333333333333
1502-2021_03_20_193415.jpg,car,61,78,320,45,240,59,1,139,104,LTAdatasets/1502/annotate/1502-2021_03_20_193415.jpg,108.5,81.5,0.3390625,0.33958333333333335,0.190625,0.1875
1502-2021_03_20_193415.jpg,car,23,183,320,13,240,42,1,206,55,LTAdatasets/1502/annotate/1502-2021_03_20_193415.jpg,194.5,48.5,0.6078125,0.20208333333333334,0.071875,0.05416666666666667
1502-2021_03_20_193415.jpg,car,18,228,320,14,240,37,1,246,51,LTAdatasets/1502/annotate/1502-2021_03_20_193415.jpg,237.0,44.0,0.740625,0.18333333333333332,0.05625,0.058333333333333334
1502-2021_03_20_193415.jpg,car,12,218,320,11,240,34,1,230,45,LTAdatasets/1502/annotate/1502-2021_03_20_193415.jpg,224.0,39.5,0.7,0.16458333333333333,0.0375,0.04583333333333333
1502-2021_03_20_094024.jpg,van,16,222,320,13,240,34,3,238,47,LTAdatasets/1502/annotate/1502-2021_03_20_094024.jpg,230.0,40.5,0.71875,0.16875,0.05,0.05416666666666667
1502-2021_03_20_184613.jpg,car,79,4,320,108,240,132,1,83,240,LTAdatasets/1502/annotate/1502-2021_03_20_184613.jpg,43.5,186.0,0.1359375,0.775,0.246875,0.45
1502-2021_03_20_184613.jpg,car,18,216,320,14,240,44,1,234,58,LTAdatasets/1502/annotate/1502-2021_03_20_184613.jpg,225.0,51.0,0.703125,0.2125,0.05625,0.058333333333333334
1502-2021_03_20_184613.jpg,car,16,156,320,27,240,38,1,172,65,LTAdatasets/1502/annotate/1502-2021_03_20_184613.jpg,164.0,51.5,0.5125,0.21458333333333332,0.05,0.1125
1502-2021_03_20_184613.jpg,car,14,199,320,14,240,34,1,213,48,LTAdatasets/1502/annotate/1502-2021_03_20_184613.jpg,206.0,41.0,0.64375,0.17083333333333334,0.04375,0.058333333333333334
1502-2021_03_20_193635.jpg,car,11,233,320,9,240,33,1,244,42,LTAdatasets/1502/annotate/1502-2021_03_20_193635.jpg,238.5,37.5,0.7453125,0.15625,0.034375,0.0375
1502-2021_03_20_085141.jpg,car,10,233,320,9,240,33,1,243,42,LTAdatasets/1502/annotate/1502-2021_03_20_085141.jpg,238.0,37.5,0.74375,0.15625,0.03125,0.0375
1502-2021_03_20_092803.jpg,lorry_truck,67,78,320,43,240,51,2,145,94,LTAdatasets/1502/annotate/1502-2021_03_20_092803.jpg,111.5,72.5,0.3484375,0.3020833333333333,0.209375,0.17916666666666667
1502-2021_03_20_092803.jpg,van,14,211,320,11,240,32,3,225,43,LTAdatasets/1502/annotate/1502-2021_03_20_092803.jpg,218.0,37.5,0.68125,0.15625,0.04375,0.04583333333333333
1502-2021_03_20_194315.jpg,car,19,225,320,15,240,33,1,244,48,LTAdatasets/1502/annotate/1502-2021_03_20_194315.jpg,234.5,40.5,0.7328125,0.16875,0.059375,0.0625
1502-2021_03_20_184913.jpg,car,9,222,320,8,240,33,1,231,41,LTAdatasets/1502/annotate/1502-2021_03_20_184913.jpg,226.5,37.0,0.7078125,0.15416666666666667,0.028125,0.03333333333333333
1502-2021_03_20_094305.jpg,lorry_truck,17,228,320,10,240,34,2,245,44,LTAdatasets/1502/annotate/1502-2021_03_20_094305.jpg,236.5,39.0,0.7390625,0.1625,0.053125,0.041666666666666664
1502-2021_03_20_220403.jpg,lorry_truck,38,190,320,43,240,34,2,228,77,LTAdatasets/1502/annotate/1502-2021_03_20_220403.jpg,209.0,55.5,0.653125,0.23125,0.11875,0.17916666666666667
1502-2021_03_20_195736.jpg,car,59,91,320,41,240,51,1,150,92,LTAdatasets/1502/annotate/1502-2021_03_20_195736.jpg,120.5,71.5,0.3765625,0.29791666666666666,0.184375,0.17083333333333334
1502-2021_03_20_195736.jpg,car,19,213,320,12,240,38,1,232,50,LTAdatasets/1502/annotate/1502-2021_03_20_195736.jpg,222.5,44.0,0.6953125,0.18333333333333332,0.059375,0.05
1502-2021_03_20_194916.jpg,car,65,125,320,58,240,70,1,190,128,LTAdatasets/1502/annotate/1502-2021_03_20_194916.jpg,157.5,99.0,0.4921875,0.4125,0.203125,0.24166666666666667
1502-2021_03_20_194916.jpg,car,21,203,320,17,240,42,1,224,59,LTAdatasets/1502/annotate/1502-2021_03_20_194916.jpg,213.5,50.5,0.6671875,0.21041666666666667,0.065625,0.07083333333333333
1502-2021_03_20_202758.jpg,car,18,197,320,27,240,49,1,215,76,LTAdatasets/1502/annotate/1502-2021_03_20_202758.jpg,206.0,62.5,0.64375,0.2604166666666667,0.05625,0.1125
1005-2021_03_20_204238.jpg,car,19,179,320,15,240,107,1,198,122,LTAdatasets/1005/annotate/1005-2021_03_20_204238.jpg,188.5,114.5,0.5890625,0.47708333333333336,0.059375,0.0625
1005-2021_03_20_204238.jpg,car,26,25,320,13,240,108,1,51,121,LTAdatasets/1005/annotate/1005-2021_03_20_204238.jpg,38.0,114.5,0.11875,0.47708333333333336,0.08125,0.05416666666666667
1005-2021_03_20_204238.jpg,car,14,138,320,7,240,77,1,152,84,LTAdatasets/1005/annotate/1005-2021_03_20_204238.jpg,145.0,80.5,0.453125,0.33541666666666664,0.04375,0.029166666666666667
1005-2021_03_20_204238.jpg,car,10,202,320,11,240,77,1,212,88,LTAdatasets/1005/annotate/1005-2021_03_20_204238.jpg,207.0,82.5,0.646875,0.34375,0.03125,0.04583333333333333
1005-2021_03_20_204238.jpg,car,11,220,320,9,240,80,1,231,89,LTAdatasets/1005/annotate/1005-2021_03_20_204238.jpg,225.5,84.5,0.7046875,0.35208333333333336,0.034375,0.0375
1005-2021_03_20_204238.jpg,car,10,197,320,5,240,72,1,207,77,LTAdatasets/1005/annotate/1005-2021_03_20_204238.jpg,202.0,74.5,0.63125,0.3104166666666667,0.03125,0.020833333333333332
1005-2021_03_20_214902.jpg,car,36,124,320,32,240,155,1,160,187,LTAdatasets/1005/annotate/1005-2021_03_20_214902.jpg,142.0,171.0,0.44375,0.7125,0.1125,0.13333333333333333
1005-2021_03_20_214902.jpg,car,30,103,320,23,240,129,1,133,152,LTAdatasets/1005/annotate/1005-2021_03_20_214902.jpg,118.0,140.5,0.36875,0.5854166666666667,0.09375,0.09583333333333334
1005-2021_03_20_214902.jpg,car,14,213,320,19,240,98,1,227,117,LTAdatasets/1005/annotate/1005-2021_03_20_214902.jpg,220.0,107.5,0.6875,0.4479166666666667,0.04375,0.07916666666666666
1005-2021_03_20_081920.jpg,bike,15,110,320,23,240,188,4,125,211,LTAdatasets/1005/annotate/1005-2021_03_20_081920.jpg,117.5,199.5,0.3671875,0.83125,0.046875,0.09583333333333334
1005-2021_03_20_081920.jpg,car,22,91,320,8,240,104,1,113,112,LTAdatasets/1005/annotate/1005-2021_03_20_081920.jpg,102.0,108.0,0.31875,0.45,0.06875,0.03333333333333333
1005-2021_03_20_190413.jpg,car,34,2,320,18,240,140,1,36,158,LTAdatasets/1005/annotate/1005-2021_03_20_190413.jpg,19.0,149.0,0.059375,0.6208333333333333,0.10625,0.075
1005-2021_03_20_190413.jpg,car,26,0,320,14,240,126,1,26,140,LTAdatasets/1005/annotate/1005-2021_03_20_190413.jpg,13.0,133.0,0.040625,0.5541666666666667,0.08125,0.058333333333333334
1005-2021_03_20_190413.jpg,van,19,204,320,28,240,108,3,223,136,LTAdatasets/1005/annotate/1005-2021_03_20_190413.jpg,213.5,122.0,0.6671875,0.5083333333333333,0.059375,0.11666666666666667
1005-2021_03_20_190413.jpg,car,13,186,320,16,240,99,1,199,115,LTAdatasets/1005/annotate/1005-2021_03_20_190413.jpg,192.5,107.0,0.6015625,0.44583333333333336,0.040625,0.06666666666666667
1005-2021_03_20_190413.jpg,car,9,222,320,11,240,85,1,231,96,LTAdatasets/1005/annotate/1005-2021_03_20_190413.jpg,226.5,90.5,0.7078125,0.3770833333333333,0.028125,0.04583333333333333
1005-2021_03_20_190413.jpg,car,9,225,320,6,240,74,1,234,80,LTAdatasets/1005/annotate/1005-2021_03_20_190413.jpg,229.5,77.0,0.7171875,0.32083333333333336,0.028125,0.025
1005-2021_03_20_190413.jpg,bike,9,206,320,10,240,86,4,215,96,LTAdatasets/1005/annotate/1005-2021_03_20_190413.jpg,210.5,91.0,0.6578125,0.37916666666666665,0.028125,0.041666666666666664
1005-2021_03_20_190413.jpg,van,8,210,320,10,240,74,3,218,84,LTAdatasets/1005/annotate/1005-2021_03_20_190413.jpg,214.0,79.0,0.66875,0.32916666666666666,0.025,0.041666666666666664
1005-2021_03_20_084301.jpg,van,17,205,320,22,240,103,3,222,125,LTAdatasets/1005/annotate/1005-2021_03_20_084301.jpg,213.5,114.0,0.6671875,0.475,0.053125,0.09166666666666666
1005-2021_03_20_084301.jpg,car,32,59,320,15,240,115,1,91,130,LTAdatasets/1005/annotate/1005-2021_03_20_084301.jpg,75.0,122.5,0.234375,0.5104166666666666,0.1,0.0625
1005-2021_03_20_084301.jpg,car,22,47,320,13,240,109,1,69,122,LTAdatasets/1005/annotate/1005-2021_03_20_084301.jpg,58.0,115.5,0.18125,0.48125,0.06875,0.05416666666666667
1005-2021_03_20_084301.jpg,car,18,3,320,17,240,149,1,21,166,LTAdatasets/1005/annotate/1005-2021_03_20_084301.jpg,12.0,157.5,0.0375,0.65625,0.05625,0.07083333333333333
1005-2021_03_20_192735.jpg,car,31,114,320,25,240,128,1,145,153,LTAdatasets/1005/annotate/1005-2021_03_20_192735.jpg,129.5,140.5,0.4046875,0.5854166666666667,0.096875,0.10416666666666667
1005-2021_03_20_192735.jpg,van,12,221,320,14,240,84,3,233,98,LTAdatasets/1005/annotate/1005-2021_03_20_192735.jpg,227.0,91.0,0.709375,0.37916666666666665,0.0375,0.058333333333333334
1005-2021_03_20_192735.jpg,car,21,107,320,10,240,95,1,128,105,LTAdatasets/1005/annotate/1005-2021_03_20_192735.jpg,117.5,100.0,0.3671875,0.4166666666666667,0.065625,0.041666666666666664
1005-2021_03_20_192735.jpg,car,22,27,320,11,240,108,1,49,119,LTAdatasets/1005/annotate/1005-2021_03_20_192735.jpg,38.0,113.5,0.11875,0.47291666666666665,0.06875,0.04583333333333333
1005-2021_03_20_192735.jpg,bike,6,182,320,9,240,83,4,188,92,LTAdatasets/1005/annotate/1005-2021_03_20_192735.jpg,185.0,87.5,0.578125,0.3645833333333333,0.01875,0.0375
1005-2021_03_20_212140.jpg,bus,32,192,320,52,240,97,5,224,149,LTAdatasets/1005/annotate/1005-2021_03_20_212140.jpg,208.0,123.0,0.65,0.5125,0.1,0.21666666666666667
1005-2021_03_20_212140.jpg,car,19,164,320,21,240,113,1,183,134,LTAdatasets/1005/annotate/1005-2021_03_20_212140.jpg,173.5,123.5,0.5421875,0.5145833333333333,0.059375,0.0875
1005-2021_03_20_212140.jpg,car,24,119,320,31,240,166,1,143,197,LTAdatasets/1005/annotate/1005-2021_03_20_212140.jpg,131.0,181.5,0.409375,0.75625,0.075,0.12916666666666668
1005-2021_03_20_212140.jpg,car,32,29,320,15,240,128,1,61,143,LTAdatasets/1005/annotate/1005-2021_03_20_212140.jpg,45.0,135.5,0.140625,0.5645833333333333,0.1,0.0625
1005-2021_03_20_212140.jpg,car,13,114,320,12,240,83,1,127,95,LTAdatasets/1005/annotate/1005-2021_03_20_212140.jpg,120.5,89.0,0.3765625,0.37083333333333335,0.040625,0.05
1005-2021_03_20_212140.jpg,car,18,78,320,11,240,90,1,96,101,LTAdatasets/1005/annotate/1005-2021_03_20_212140.jpg,87.0,95.5,0.271875,0.39791666666666664,0.05625,0.04583333333333333
1005-2021_03_20_212140.jpg,car,13,177,320,15,240,82,1,190,97,LTAdatasets/1005/annotate/1005-2021_03_20_212140.jpg,183.5,89.5,0.5734375,0.3729166666666667,0.040625,0.0625
1005-2021_03_20_213701.jpg,car,23,155,320,25,240,127,1,178,152,LTAdatasets/1005/annotate/1005-2021_03_20_213701.jpg,166.5,139.5,0.5203125,0.58125,0.071875,0.10416666666666667
1005-2021_03_20_213701.jpg,car,52,39,320,28,240,177,1,91,205,LTAdatasets/1005/annotate/1005-2021_03_20_213701.jpg,65.0,191.0,0.203125,0.7958333333333333,0.1625,0.11666666666666667
1005-2021_03_20_213701.jpg,car,33,1,320,20,240,139,1,34,159,LTAdatasets/1005/annotate/1005-2021_03_20_213701.jpg,17.5,149.0,0.0546875,0.6208333333333333,0.103125,0.08333333333333333
1005-2021_03_20_213701.jpg,car,12,180,320,10,240,83,1,192,93,LTAdatasets/1005/annotate/1005-2021_03_20_213701.jpg,186.0,88.0,0.58125,0.36666666666666664,0.0375,0.041666666666666664
1005-2021_03_20_211300.jpg,car,23,178,320,21,240,167,1,201,188,LTAdatasets/1005/annotate/1005-2021_03_20_211300.jpg,189.5,177.5,0.5921875,0.7395833333333334,0.071875,0.0875
1005-2021_03_20_211300.jpg,car,17,199,320,17,240,105,1,216,122,LTAdatasets/1005/annotate/1005-2021_03_20_211300.jpg,207.5,113.5,0.6484375,0.47291666666666665,0.053125,0.07083333333333333
1005-2021_03_20_211300.jpg,car,19,142,320,18,240,108,1,161,126,LTAdatasets/1005/annotate/1005-2021_03_20_211300.jpg,151.5,117.0,0.4734375,0.4875,0.059375,0.075
1005-2021_03_20_070716.jpg,car,27,21,320,11,240,119,1,48,130,LTAdatasets/1005/annotate/1005-2021_03_20_070716.jpg,34.5,124.5,0.1078125,0.51875,0.084375,0.04583333333333333
1005-2021_03_20_070716.jpg,bus,47,38,320,24,240,89,5,85,113,LTAdatasets/1005/annotate/1005-2021_03_20_070716.jpg,61.5,101.0,0.1921875,0.42083333333333334,0.146875,0.1
1005-2021_03_20_064855.jpg,lorry_truck,26,40,320,12,240,100,2,66,112,LTAdatasets/1005/annotate/1005-2021_03_20_064855.jpg,53.0,106.0,0.165625,0.44166666666666665,0.08125,0.05
1005-2021_03_20_064855.jpg,car,16,129,320,9,240,79,1,145,88,LTAdatasets/1005/annotate/1005-2021_03_20_064855.jpg,137.0,83.5,0.428125,0.34791666666666665,0.05,0.0375
1005-2021_03_20_193635.jpg,van,23,140,320,22,240,100,3,163,122,LTAdatasets/1005/annotate/1005-2021_03_20_193635.jpg,151.5,111.0,0.4734375,0.4625,0.071875,0.09166666666666666
1005-2021_03_20_193635.jpg,car,11,211,320,16,240,91,1,222,107,LTAdatasets/1005/annotate/1005-2021_03_20_193635.jpg,216.5,99.0,0.6765625,0.4125,0.034375,0.06666666666666667
1005-2021_03_20_193635.jpg,car,28,48,320,14,240,120,1,76,134,LTAdatasets/1005/annotate/1005-2021_03_20_193635.jpg,62.0,127.0,0.19375,0.5291666666666667,0.0875,0.058333333333333334
1005-2021_03_20_193635.jpg,car,15,109,320,10,240,87,1,124,97,LTAdatasets/1005/annotate/1005-2021_03_20_193635.jpg,116.5,92.0,0.3640625,0.38333333333333336,0.046875,0.041666666666666664
1005-2021_03_20_190634.jpg,lorry_truck,21,203,320,38,240,95,2,224,133,LTAdatasets/1005/annotate/1005-2021_03_20_190634.jpg,213.5,114.0,0.6671875,0.475,0.065625,0.15833333333333333
1005-2021_03_20_190634.jpg,car,12,203,320,12,240,81,1,215,93,LTAdatasets/1005/annotate/1005-2021_03_20_190634.jpg,209.0,87.0,0.653125,0.3625,0.0375,0.05
1005-2021_03_20_190634.jpg,car,27,138,320,29,240,143,1,165,172,LTAdatasets/1005/annotate/1005-2021_03_20_190634.jpg,151.5,157.5,0.4734375,0.65625,0.084375,0.12083333333333333
1005-2021_03_20_190634.jpg,bike,7,228,320,6,240,81,4,235,87,LTAdatasets/1005/annotate/1005-2021_03_20_190634.jpg,231.5,84.0,0.7234375,0.35,0.021875,0.025
1005-2021_03_20_190634.jpg,lorry_truck,19,140,320,12,240,64,2,159,76,LTAdatasets/1005/annotate/1005-2021_03_20_190634.jpg,149.5,70.0,0.4671875,0.2916666666666667,0.059375,0.05
1005-2021_03_20_063354.jpg,car,16,205,320,23,240,98,1,221,121,LTAdatasets/1005/annotate/1005-2021_03_20_063354.jpg,213.0,109.5,0.665625,0.45625,0.05,0.09583333333333334
1005-2021_03_20_063354.jpg,lorry_truck,33,3,320,24,240,105,2,36,129,LTAdatasets/1005/annotate/1005-2021_03_20_063354.jpg,19.5,117.0,0.0609375,0.4875,0.103125,0.1
1005-2021_03_20_063354.jpg,car,20,115,320,8,240,85,1,135,93,LTAdatasets/1005/annotate/1005-2021_03_20_063354.jpg,125.0,89.0,0.390625,0.37083333333333335,0.0625,0.03333333333333333
1005-2021_03_20_094305.jpg,car,28,9,320,15,240,141,1,37,156,LTAdatasets/1005/annotate/1005-2021_03_20_094305.jpg,23.0,148.5,0.071875,0.61875,0.0875,0.0625
1005-2021_03_20_094305.jpg,car,11,205,320,9,240,80,1,216,89,LTAdatasets/1005/annotate/1005-2021_03_20_094305.jpg,210.5,84.5,0.6578125,0.35208333333333336,0.034375,0.0375
1005-2021_03_20_094305.jpg,car,12,82,320,10,240,90,1,94,100,LTAdatasets/1005/annotate/1005-2021_03_20_094305.jpg,88.0,95.0,0.275,0.3958333333333333,0.0375,0.041666666666666664
1005-2021_03_20_094305.jpg,car,9,132,320,9,240,80,1,141,89,LTAdatasets/1005/annotate/1005-2021_03_20_094305.jpg,136.5,84.5,0.4265625,0.35208333333333336,0.028125,0.0375
1005-2021_03_20_193415.jpg,car,37,124,320,28,240,158,1,161,186,LTAdatasets/1005/annotate/1005-2021_03_20_193415.jpg,142.5,172.0,0.4453125,0.7166666666666667,0.115625,0.11666666666666667
1005-2021_03_20_193415.jpg,car,13,195,320,13,240,86,1,208,99,LTAdatasets/1005/annotate/1005-2021_03_20_193415.jpg,201.5,92.5,0.6296875,0.3854166666666667,0.040625,0.05416666666666667
1005-2021_03_20_193415.jpg,car,8,223,320,8,240,76,1,231,84,LTAdatasets/1005/annotate/1005-2021_03_20_193415.jpg,227.0,80.0,0.709375,0.3333333333333333,0.025,0.03333333333333333
1005-2021_03_20_193415.jpg,car,10,162,320,6,240,72,1,172,78,LTAdatasets/1005/annotate/1005-2021_03_20_193415.jpg,167.0,75.0,0.521875,0.3125,0.03125,0.025
1005-2021_03_20_220643.jpg,car,10,196,320,11,240,71,1,206,82,LTAdatasets/1005/annotate/1005-2021_03_20_220643.jpg,201.0,76.5,0.628125,0.31875,0.03125,0.04583333333333333
1005-2021_03_20_220643.jpg,car,11,212,320,10,240,74,1,223,84,LTAdatasets/1005/annotate/1005-2021_03_20_220643.jpg,217.5,79.0,0.6796875,0.32916666666666666,0.034375,0.041666666666666664
1005-2021_03_20_191234.jpg,car,13,223,320,6,240,78,1,236,84,LTAdatasets/1005/annotate/1005-2021_03_20_191234.jpg,229.5,81.0,0.7171875,0.3375,0.040625,0.025
1005-2021_03_20_191234.jpg,car,10,130,320,10,240,77,1,140,87,LTAdatasets/1005/annotate/1005-2021_03_20_191234.jpg,135.0,82.0,0.421875,0.3416666666666667,0.03125,0.041666666666666664
1005-2021_03_20_191234.jpg,car,11,156,320,9,240,74,1,167,83,LTAdatasets/1005/annotate/1005-2021_03_20_191234.jpg,161.5,78.5,0.5046875,0.32708333333333334,0.034375,0.0375
1005-2021_03_20_090702.jpg,lorry_truck,32,168,320,51,240,133,2,200,184,LTAdatasets/1005/annotate/1005-2021_03_20_090702.jpg,184.0,158.5,0.575,0.6604166666666667,0.1,0.2125
1005-2021_03_20_090702.jpg,van,23,69,320,14,240,96,3,92,110,LTAdatasets/1005/annotate/1005-2021_03_20_090702.jpg,80.5,103.0,0.2515625,0.42916666666666664,0.071875,0.058333333333333334
1005-2021_03_20_090702.jpg,car,18,116,320,7,240,93,1,134,100,LTAdatasets/1005/annotate/1005-2021_03_20_090702.jpg,125.0,96.5,0.390625,0.40208333333333335,0.05625,0.029166666666666667
1005-2021_03_20_090702.jpg,bike,8,224,320,7,240,71,4,232,78,LTAdatasets/1005/annotate/1005-2021_03_20_090702.jpg,228.0,74.5,0.7125,0.3104166666666667,0.025,0.029166666666666667
1005-2021_03_20_090702.jpg,car,11,201,320,9,240,79,1,212,88,LTAdatasets/1005/annotate/1005-2021_03_20_090702.jpg,206.5,83.5,0.6453125,0.34791666666666665,0.034375,0.0375
1005-2021_03_20_195136.jpg,car,7,210,320,8,240,76,1,217,84,LTAdatasets/1005/annotate/1005-2021_03_20_195136.jpg,213.5,80.0,0.6671875,0.3333333333333333,0.021875,0.03333333333333333
1005-2021_03_20_215222.jpg,car,33,136,320,31,240,138,1,169,169,LTAdatasets/1005/annotate/1005-2021_03_20_215222.jpg,152.5,153.5,0.4765625,0.6395833333333333,0.103125,0.12916666666666668
1005-2021_03_20_215222.jpg,car,47,35,320,29,240,179,1,82,208,LTAdatasets/1005/annotate/1005-2021_03_20_215222.jpg,58.5,193.5,0.1828125,0.80625,0.146875,0.12083333333333333
1005-2021_03_20_215222.jpg,car,10,223,320,11,240,81,1,233,92,LTAdatasets/1005/annotate/1005-2021_03_20_215222.jpg,228.0,86.5,0.7125,0.36041666666666666,0.03125,0.04583333333333333
1005-2021_03_20_215222.jpg,car,15,114,320,11,240,84,1,129,95,LTAdatasets/1005/annotate/1005-2021_03_20_215222.jpg,121.5,89.5,0.3796875,0.3729166666666667,0.046875,0.04583333333333333
1005-2021_03_20_182752.jpg,car,26,39,320,12,240,113,1,65,125,LTAdatasets/1005/annotate/1005-2021_03_20_182752.jpg,52.0,119.0,0.1625,0.49583333333333335,0.08125,0.05
1005-2021_03_20_182752.jpg,car,11,141,320,9,240,82,1,152,91,LTAdatasets/1005/annotate/1005-2021_03_20_182752.jpg,146.5,86.5,0.4578125,0.36041666666666666,0.034375,0.0375
1005-2021_03_20_182752.jpg,car,8,223,320,13,240,78,1,231,91,LTAdatasets/1005/annotate/1005-2021_03_20_182752.jpg,227.0,84.5,0.709375,0.35208333333333336,0.025,0.05416666666666667
1005-2021_03_20_182752.jpg,car,9,207,320,9,240,74,1,216,83,LTAdatasets/1005/annotate/1005-2021_03_20_182752.jpg,211.5,78.5,0.6609375,0.32708333333333334,0.028125,0.0375
1005-2021_03_20_182752.jpg,lorry_truck,42,20,320,13,240,97,2,62,110,LTAdatasets/1005/annotate/1005-2021_03_20_182752.jpg,41.0,103.5,0.128125,0.43125,0.13125,0.05416666666666667
1005-2021_03_20_182752.jpg,car,9,133,320,8,240,77,1,142,85,LTAdatasets/1005/annotate/1005-2021_03_20_182752.jpg,137.5,81.0,0.4296875,0.3375,0.028125,0.03333333333333333
1005-2021_03_20_211900.jpg,car,18,191,320,26,240,134,1,209,160,LTAdatasets/1005/annotate/1005-2021_03_20_211900.jpg,200.0,147.0,0.625,0.6125,0.05625,0.10833333333333334
1005-2021_03_20_211900.jpg,van,22,167,320,20,240,113,3,189,133,LTAdatasets/1005/annotate/1005-2021_03_20_211900.jpg,178.0,123.0,0.55625,0.5125,0.06875,0.08333333333333333
1005-2021_03_20_211900.jpg,van,15,186,320,20,240,93,3,201,113,LTAdatasets/1005/annotate/1005-2021_03_20_211900.jpg,193.5,103.0,0.6046875,0.42916666666666664,0.046875,0.08333333333333333
1005-2021_03_20_211900.jpg,car,18,155,320,15,240,97,1,173,112,LTAdatasets/1005/annotate/1005-2021_03_20_211900.jpg,164.0,104.5,0.5125,0.4354166666666667,0.05625,0.0625
1005-2021_03_20_211900.jpg,car,13,214,320,13,240,99,1,227,112,LTAdatasets/1005/annotate/1005-2021_03_20_211900.jpg,220.5,105.5,0.6890625,0.4395833333333333,0.040625,0.05416666666666667
1005-2021_03_20_211900.jpg,bike,5,182,320,8,240,86,4,187,94,LTAdatasets/1005/annotate/1005-2021_03_20_211900.jpg,184.5,90.0,0.5765625,0.375,0.015625,0.03333333333333333
1005-2021_03_20_185753.jpg,car,14,166,320,15,240,93,1,180,108,LTAdatasets/1005/annotate/1005-2021_03_20_185753.jpg,173.0,100.5,0.540625,0.41875,0.04375,0.0625
1005-2021_03_20_185753.jpg,car,27,37,320,11,240,115,1,64,126,LTAdatasets/1005/annotate/1005-2021_03_20_185753.jpg,50.5,120.5,0.1578125,0.5020833333333333,0.084375,0.04583333333333333
1005-2021_03_20_203358.jpg,car,17,199,320,20,240,118,1,216,138,LTAdatasets/1005/annotate/1005-2021_03_20_203358.jpg,207.5,128.0,0.6484375,0.5333333333333333,0.053125,0.08333333333333333
1005-2021_03_20_203358.jpg,car,24,77,320,12,240,111,1,101,123,LTAdatasets/1005/annotate/1005-2021_03_20_203358.jpg,89.0,117.0,0.278125,0.4875,0.075,0.05
1005-2021_03_20_203358.jpg,car,20,82,320,16,240,93,1,102,109,LTAdatasets/1005/annotate/1005-2021_03_20_203358.jpg,92.0,101.0,0.2875,0.42083333333333334,0.0625,0.06666666666666667
1005-2021_03_20_203358.jpg,car,14,171,320,14,240,84,1,185,98,LTAdatasets/1005/annotate/1005-2021_03_20_203358.jpg,178.0,91.0,0.55625,0.37916666666666665,0.04375,0.058333333333333334
1005-2021_03_20_185153.jpg,car,14,213,320,17,240,101,1,227,118,LTAdatasets/1005/annotate/1005-2021_03_20_185153.jpg,220.0,109.5,0.6875,0.45625,0.04375,0.07083333333333333
1005-2021_03_20_185153.jpg,car,32,109,320,22,240,127,1,141,149,LTAdatasets/1005/annotate/1005-2021_03_20_185153.jpg,125.0,138.0,0.390625,0.575,0.1,0.09166666666666666
1005-2021_03_20_185153.jpg,car,48,65,320,28,240,212,1,113,240,LTAdatasets/1005/annotate/1005-2021_03_20_185153.jpg,89.0,226.0,0.278125,0.9416666666666667,0.15,0.11666666666666667
1005-2021_03_20_185153.jpg,bike,7,180,320,13,240,92,4,187,105,LTAdatasets/1005/annotate/1005-2021_03_20_185153.jpg,183.5,98.5,0.5734375,0.41041666666666665,0.021875,0.05416666666666667
1005-2021_03_20_185153.jpg,bike,8,196,320,14,240,93,4,204,107,LTAdatasets/1005/annotate/1005-2021_03_20_185153.jpg,200.0,100.0,0.625,0.4166666666666667,0.025,0.058333333333333334
1005-2021_03_20_185153.jpg,van,16,129,320,9,240,76,3,145,85,LTAdatasets/1005/annotate/1005-2021_03_20_185153.jpg,137.0,80.5,0.428125,0.33541666666666664,0.05,0.0375
1005-2021_03_20_185153.jpg,car,15,202,320,9,240,81,1,217,90,LTAdatasets/1005/annotate/1005-2021_03_20_185153.jpg,209.5,85.5,0.6546875,0.35625,0.046875,0.0375
1005-2021_03_20_100405.jpg,bike,8,195,320,20,240,104,4,203,124,LTAdatasets/1005/annotate/1005-2021_03_20_100405.jpg,199.0,114.0,0.621875,0.475,0.025,0.08333333333333333
1005-2021_03_20_100405.jpg,car,12,220,320,8,240,76,1,232,84,LTAdatasets/1005/annotate/1005-2021_03_20_100405.jpg,226.0,80.0,0.70625,0.3333333333333333,0.0375,0.03333333333333333
1005-2021_03_20_100405.jpg,car,16,112,320,13,240,93,1,128,106,LTAdatasets/1005/annotate/1005-2021_03_20_100405.jpg,120.0,99.5,0.375,0.41458333333333336,0.05,0.05416666666666667
1005-2021_03_20_100405.jpg,car,13,146,320,9,240,78,1,159,87,LTAdatasets/1005/annotate/1005-2021_03_20_100405.jpg,152.5,82.5,0.4765625,0.34375,0.040625,0.0375
1005-2021_03_20_100405.jpg,car,26,31,320,13,240,104,1,57,117,LTAdatasets/1005/annotate/1005-2021_03_20_100405.jpg,44.0,110.5,0.1375,0.46041666666666664,0.08125,0.05416666666666667
1005-2021_03_20_100405.jpg,car,19,82,320,14,240,94,1,101,108,LTAdatasets/1005/annotate/1005-2021_03_20_100405.jpg,91.5,101.0,0.2859375,0.42083333333333334,0.059375,0.058333333333333334
1005-2021_03_20_100405.jpg,car,11,143,320,6,240,73,1,154,79,LTAdatasets/1005/annotate/1005-2021_03_20_100405.jpg,148.5,76.0,0.4640625,0.31666666666666665,0.034375,0.025
1005-2021_03_20_093724.jpg,lorry_truck,23,196,320,44,240,104,2,219,148,LTAdatasets/1005/annotate/1005-2021_03_20_093724.jpg,207.5,126.0,0.6484375,0.525,0.071875,0.18333333333333332
1005-2021_03_20_093724.jpg,car,31,17,320,18,240,134,1,48,152,LTAdatasets/1005/annotate/1005-2021_03_20_093724.jpg,32.5,143.0,0.1015625,0.5958333333333333,0.096875,0.075
1005-2021_03_20_093724.jpg,car,32,5,320,15,240,123,1,37,138,LTAdatasets/1005/annotate/1005-2021_03_20_093724.jpg,21.0,130.5,0.065625,0.54375,0.1,0.0625
1005-2021_03_20_093724.jpg,car,17,119,320,9,240,89,1,136,98,LTAdatasets/1005/annotate/1005-2021_03_20_093724.jpg,127.5,93.5,0.3984375,0.38958333333333334,0.053125,0.0375
1005-2021_03_20_093724.jpg,car,11,139,320,9,240,76,1,150,85,LTAdatasets/1005/annotate/1005-2021_03_20_093724.jpg,144.5,80.5,0.4515625,0.33541666666666664,0.034375,0.0375
1005-2021_03_20_201317.jpg,car,35,109,320,29,240,175,1,144,204,LTAdatasets/1005/annotate/1005-2021_03_20_201317.jpg,126.5,189.5,0.3953125,0.7895833333333333,0.109375,0.12083333333333333
1005-2021_03_20_201317.jpg,car,50,2,320,39,240,198,1,52,237,LTAdatasets/1005/annotate/1005-2021_03_20_201317.jpg,27.0,217.5,0.084375,0.90625,0.15625,0.1625
1005-2021_03_20_201317.jpg,car,18,185,320,19,240,87,1,203,106,LTAdatasets/1005/annotate/1005-2021_03_20_201317.jpg,194.0,96.5,0.60625,0.40208333333333335,0.05625,0.07916666666666666
1005-2021_03_20_201317.jpg,lorry_truck,18,122,320,13,240,70,2,140,83,LTAdatasets/1005/annotate/1005-2021_03_20_201317.jpg,131.0,76.5,0.409375,0.31875,0.05625,0.05416666666666667
1005-2021_03_20_205139.jpg,car,21,192,320,29,240,137,1,213,166,LTAdatasets/1005/annotate/1005-2021_03_20_205139.jpg,202.5,151.5,0.6328125,0.63125,0.065625,0.12083333333333333
1005-2021_03_20_205139.jpg,car,14,152,320,9,240,68,1,166,77,LTAdatasets/1005/annotate/1005-2021_03_20_205139.jpg,159.0,72.5,0.496875,0.3020833333333333,0.04375,0.0375
1005-2021_03_20_204018.jpg,car,30,105,320,21,240,127,1,135,148,LTAdatasets/1005/annotate/1005-2021_03_20_204018.jpg,120.0,137.5,0.375,0.5729166666666666,0.09375,0.0875
1005-2021_03_20_204018.jpg,car,27,10,320,12,240,124,1,37,136,LTAdatasets/1005/annotate/1005-2021_03_20_204018.jpg,23.5,130.0,0.0734375,0.5416666666666666,0.084375,0.05
1005-2021_03_20_204018.jpg,car,26,7,320,16,240,138,1,33,154,LTAdatasets/1005/annotate/1005-2021_03_20_204018.jpg,20.0,146.0,0.0625,0.6083333333333333,0.08125,0.06666666666666667
1005-2021_03_20_204018.jpg,car,24,190,320,32,240,127,1,214,159,LTAdatasets/1005/annotate/1005-2021_03_20_204018.jpg,202.0,143.0,0.63125,0.5958333333333333,0.075,0.13333333333333333
1005-2021_03_20_204018.jpg,van,19,170,320,24,240,108,3,189,132,LTAdatasets/1005/annotate/1005-2021_03_20_204018.jpg,179.5,120.0,0.5609375,0.5,0.059375,0.1
1005-2021_03_20_204018.jpg,bike,16,92,320,19,240,168,4,108,187,LTAdatasets/1005/annotate/1005-2021_03_20_204018.jpg,100.0,177.5,0.3125,0.7395833333333334,0.05,0.07916666666666666
1005-2021_03_20_204018.jpg,car,40,108,320,32,240,166,1,148,198,LTAdatasets/1005/annotate/1005-2021_03_20_204018.jpg,128.0,182.0,0.4,0.7583333333333333,0.125,0.13333333333333333
1005-2021_03_20_204018.jpg,car,12,218,320,11,240,87,1,230,98,LTAdatasets/1005/annotate/1005-2021_03_20_204018.jpg,224.0,92.5,0.7,0.3854166666666667,0.0375,0.04583333333333333
1005-2021_03_20_073417.jpg,car,9,206,320,12,240,77,1,215,89,LTAdatasets/1005/annotate/1005-2021_03_20_073417.jpg,210.5,83.0,0.6578125,0.3458333333333333,0.028125,0.05
1005-2021_03_20_073417.jpg,car,14,104,320,11,240,98,1,118,109,LTAdatasets/1005/annotate/1005-2021_03_20_073417.jpg,111.0,103.5,0.346875,0.43125,0.04375,0.04583333333333333
1005-2021_03_20_094904.jpg,car,23,26,320,11,240,117,1,49,128,LTAdatasets/1005/annotate/1005-2021_03_20_094904.jpg,37.5,122.5,0.1171875,0.5104166666666666,0.071875,0.04583333333333333
1005-2021_03_20_094904.jpg,car,24,35,320,15,240,130,1,59,145,LTAdatasets/1005/annotate/1005-2021_03_20_094904.jpg,47.0,137.5,0.146875,0.5729166666666666,0.075,0.0625
1005-2021_03_20_094904.jpg,bike,10,20,320,13,240,128,4,30,141,LTAdatasets/1005/annotate/1005-2021_03_20_094904.jpg,25.0,134.5,0.078125,0.5604166666666667,0.03125,0.05416666666666667
1005-2021_03_20_094904.jpg,car,51,52,320,37,240,203,1,103,240,LTAdatasets/1005/annotate/1005-2021_03_20_094904.jpg,77.5,221.5,0.2421875,0.9229166666666667,0.159375,0.15416666666666667
1005-2021_03_20_094904.jpg,lorry_truck,18,201,320,18,240,71,2,219,89,LTAdatasets/1005/annotate/1005-2021_03_20_094904.jpg,210.0,80.0,0.65625,0.3333333333333333,0.05625,0.075
1005-2021_03_20_094904.jpg,car,18,110,320,12,240,92,1,128,104,LTAdatasets/1005/annotate/1005-2021_03_20_094904.jpg,119.0,98.0,0.371875,0.4083333333333333,0.05625,0.05
1005-2021_03_20_094904.jpg,car,14,141,320,8,240,80,1,155,88,LTAdatasets/1005/annotate/1005-2021_03_20_094904.jpg,148.0,84.0,0.4625,0.35,0.04375,0.03333333333333333
1005-2021_03_20_093424.jpg,bike,8,222,320,11,240,77,4,230,88,LTAdatasets/1005/annotate/1005-2021_03_20_093424.jpg,226.0,82.5,0.70625,0.34375,0.025,0.04583333333333333
1005-2021_03_20_093424.jpg,car,28,31,320,13,240,114,1,59,127,LTAdatasets/1005/annotate/1005-2021_03_20_093424.jpg,45.0,120.5,0.140625,0.5020833333333333,0.0875,0.05416666666666667
1005-2021_03_20_093424.jpg,lorry_truck,20,66,320,12,240,90,2,86,102,LTAdatasets/1005/annotate/1005-2021_03_20_093424.jpg,76.0,96.0,0.2375,0.4,0.0625,0.05
1005-2021_03_20_093424.jpg,bike,6,79,320,10,240,100,4,85,110,LTAdatasets/1005/annotate/1005-2021_03_20_093424.jpg,82.0,105.0,0.25625,0.4375,0.01875,0.041666666666666664
1005-2021_03_20_093424.jpg,lorry_truck,15,122,320,11,240,72,2,137,83,LTAdatasets/1005/annotate/1005-2021_03_20_093424.jpg,129.5,77.5,0.4046875,0.3229166666666667,0.046875,0.04583333333333333
1005-2021_03_20_205739.jpg,car,37,60,320,34,240,157,1,97,191,LTAdatasets/1005/annotate/1005-2021_03_20_205739.jpg,78.5,174.0,0.2453125,0.725,0.115625,0.14166666666666666
1005-2021_03_20_205739.jpg,car,37,114,320,35,240,163,1,151,198,LTAdatasets/1005/annotate/1005-2021_03_20_205739.jpg,132.5,180.5,0.4140625,0.7520833333333333,0.115625,0.14583333333333334
1005-2021_03_20_205739.jpg,car,26,141,320,19,240,110,1,167,129,LTAdatasets/1005/annotate/1005-2021_03_20_205739.jpg,154.0,119.5,0.48125,0.4979166666666667,0.08125,0.07916666666666666
1005-2021_03_20_205739.jpg,car,20,193,320,24,240,133,1,213,157,LTAdatasets/1005/annotate/1005-2021_03_20_205739.jpg,203.0,145.0,0.634375,0.6041666666666666,0.0625,0.1
1005-2021_03_20_205739.jpg,car,15,181,320,16,240,106,1,196,122,LTAdatasets/1005/annotate/1005-2021_03_20_205739.jpg,188.5,114.0,0.5890625,0.475,0.046875,0.06666666666666667
1005-2021_03_20_205739.jpg,car,14,211,320,15,240,94,1,225,109,LTAdatasets/1005/annotate/1005-2021_03_20_205739.jpg,218.0,101.5,0.68125,0.42291666666666666,0.04375,0.0625
1005-2021_03_20_205739.jpg,car,11,205,320,8,240,79,1,216,87,LTAdatasets/1005/annotate/1005-2021_03_20_205739.jpg,210.5,83.0,0.6578125,0.3458333333333333,0.034375,0.03333333333333333
1005-2021_03_20_084901.jpg,car,23,65,320,10,240,116,1,88,126,LTAdatasets/1005/annotate/1005-2021_03_20_084901.jpg,76.5,121.0,0.2390625,0.5041666666666667,0.071875,0.041666666666666664
1005-2021_03_20_084901.jpg,car,11,90,320,10,240,96,1,101,106,LTAdatasets/1005/annotate/1005-2021_03_20_084901.jpg,95.5,101.0,0.2984375,0.42083333333333334,0.034375,0.041666666666666664
1005-2021_03_20_084901.jpg,car,13,142,320,6,240,80,1,155,86,LTAdatasets/1005/annotate/1005-2021_03_20_084901.jpg,148.5,83.0,0.4640625,0.3458333333333333,0.040625,0.025
1005-2021_03_20_084901.jpg,lorry_truck,18,1,320,15,240,117,2,19,132,LTAdatasets/1005/annotate/1005-2021_03_20_084901.jpg,10.0,124.5,0.03125,0.51875,0.05625,0.0625
1005-2021_03_20_082220.jpg,car,30,107,320,39,240,175,1,137,214,LTAdatasets/1005/annotate/1005-2021_03_20_082220.jpg,122.0,194.5,0.38125,0.8104166666666667,0.09375,0.1625
1005-2021_03_20_082220.jpg,car,17,185,320,15,240,91,1,202,106,LTAdatasets/1005/annotate/1005-2021_03_20_082220.jpg,193.5,98.5,0.6046875,0.41041666666666665,0.053125,0.0625
1005-2021_03_20_082220.jpg,car,8,222,320,13,240,84,1,230,97,LTAdatasets/1005/annotate/1005-2021_03_20_082220.jpg,226.0,90.5,0.70625,0.3770833333333333,0.025,0.05416666666666667
1005-2021_03_20_082220.jpg,car,19,76,320,10,240,97,1,95,107,LTAdatasets/1005/annotate/1005-2021_03_20_082220.jpg,85.5,102.0,0.2671875,0.425,0.059375,0.041666666666666664
1005-2021_03_20_082220.jpg,car,12,90,320,9,240,105,1,102,114,LTAdatasets/1005/annotate/1005-2021_03_20_082220.jpg,96.0,109.5,0.3,0.45625,0.0375,0.0375
1005-2021_03_20_082220.jpg,car,11,142,320,11,240,79,1,153,90,LTAdatasets/1005/annotate/1005-2021_03_20_082220.jpg,147.5,84.5,0.4609375,0.35208333333333336,0.034375,0.04583333333333333
1005-2021_03_20_091903.jpg,lorry_truck,16,211,320,17,240,102,2,227,119,LTAdatasets/1005/annotate/1005-2021_03_20_091903.jpg,219.0,110.5,0.684375,0.46041666666666664,0.05,0.07083333333333333
1005-2021_03_20_091903.jpg,car,25,27,320,12,240,120,1,52,132,LTAdatasets/1005/annotate/1005-2021_03_20_091903.jpg,39.5,126.0,0.1234375,0.525,0.078125,0.05
1005-2021_03_20_091903.jpg,car,14,125,320,6,240,80,1,139,86,LTAdatasets/1005/annotate/1005-2021_03_20_091903.jpg,132.0,83.0,0.4125,0.3458333333333333,0.04375,0.025
1005-2021_03_20_063654.jpg,car,13,213,320,16,240,100,1,226,116,LTAdatasets/1005/annotate/1005-2021_03_20_063654.jpg,219.5,108.0,0.6859375,0.45,0.040625,0.06666666666666667
1005-2021_03_20_183712.jpg,car,26,40,320,10,240,127,1,66,137,LTAdatasets/1005/annotate/1005-2021_03_20_183712.jpg,53.0,132.0,0.165625,0.55,0.08125,0.041666666666666664
1005-2021_03_20_183712.jpg,car,12,176,320,10,240,89,1,188,99,LTAdatasets/1005/annotate/1005-2021_03_20_183712.jpg,182.0,94.0,0.56875,0.39166666666666666,0.0375,0.041666666666666664
1005-2021_03_20_183712.jpg,car,10,223,320,9,240,79,1,233,88,LTAdatasets/1005/annotate/1005-2021_03_20_183712.jpg,228.0,83.5,0.7125,0.34791666666666665,0.03125,0.0375
1005-2021_03_20_183712.jpg,car,15,117,320,8,240,76,1,132,84,LTAdatasets/1005/annotate/1005-2021_03_20_183712.jpg,124.5,80.0,0.3890625,0.3333333333333333,0.046875,0.03333333333333333
1005-2021_03_20_183712.jpg,car,14,3,320,11,240,131,1,17,142,LTAdatasets/1005/annotate/1005-2021_03_20_183712.jpg,10.0,136.5,0.03125,0.56875,0.04375,0.04583333333333333
1005-2021_03_20_062153.jpg,car,18,187,320,11,240,89,1,205,100,LTAdatasets/1005/annotate/1005-2021_03_20_062153.jpg,196.0,94.5,0.6125,0.39375,0.05625,0.04583333333333333
1005-2021_03_20_200416.jpg,car,30,176,320,37,240,148,1,206,185,LTAdatasets/1005/annotate/1005-2021_03_20_200416.jpg,191.0,166.5,0.596875,0.69375,0.09375,0.15416666666666667
1005-2021_03_20_200416.jpg,car,33,89,320,28,240,137,1,122,165,LTAdatasets/1005/annotate/1005-2021_03_20_200416.jpg,105.5,151.0,0.3296875,0.6291666666666667,0.103125,0.11666666666666667
1005-2021_03_20_200416.jpg,car,26,21,320,14,240,121,1,47,135,LTAdatasets/1005/annotate/1005-2021_03_20_200416.jpg,34.0,128.0,0.10625,0.5333333333333333,0.08125,0.058333333333333334
1005-2021_03_20_200416.jpg,car,11,180,320,15,240,79,1,191,94,LTAdatasets/1005/annotate/1005-2021_03_20_200416.jpg,185.5,86.5,0.5796875,0.36041666666666666,0.034375,0.0625
1005-2021_03_20_200416.jpg,car,13,185,320,20,240,97,1,198,117,LTAdatasets/1005/annotate/1005-2021_03_20_200416.jpg,191.5,107.0,0.5984375,0.44583333333333336,0.040625,0.08333333333333333
1005-2021_03_20_200416.jpg,lorry_truck,33,39,320,23,240,90,2,72,113,LTAdatasets/1005/annotate/1005-2021_03_20_200416.jpg,55.5,101.5,0.1734375,0.42291666666666666,0.103125,0.09583333333333334
1005-2021_03_20_200416.jpg,car,14,136,320,8,240,76,1,150,84,LTAdatasets/1005/annotate/1005-2021_03_20_200416.jpg,143.0,80.0,0.446875,0.3333333333333333,0.04375,0.03333333333333333
1005-2021_03_20_200416.jpg,bike,7,112,320,11,240,85,4,119,96,LTAdatasets/1005/annotate/1005-2021_03_20_200416.jpg,115.5,90.5,0.3609375,0.3770833333333333,0.021875,0.04583333333333333
1005-2021_03_20_100705.jpg,car,24,72,320,11,240,110,1,96,121,LTAdatasets/1005/annotate/1005-2021_03_20_100705.jpg,84.0,115.5,0.2625,0.48125,0.075,0.04583333333333333
1005-2021_03_20_100705.jpg,car,22,21,320,13,240,122,1,43,135,LTAdatasets/1005/annotate/1005-2021_03_20_100705.jpg,32.0,128.5,0.1,0.5354166666666667,0.06875,0.05416666666666667
1005-2021_03_20_100705.jpg,car,19,66,320,9,240,94,1,85,103,LTAdatasets/1005/annotate/1005-2021_03_20_100705.jpg,75.5,98.5,0.2359375,0.41041666666666665,0.059375,0.0375
1005-2021_03_20_100705.jpg,car,16,133,320,8,240,83,1,149,91,LTAdatasets/1005/annotate/1005-2021_03_20_100705.jpg,141.0,87.0,0.440625,0.3625,0.05,0.03333333333333333
1005-2021_03_20_100705.jpg,van,12,112,320,11,240,80,3,124,91,LTAdatasets/1005/annotate/1005-2021_03_20_100705.jpg,118.0,85.5,0.36875,0.35625,0.0375,0.04583333333333333
1005-2021_03_20_100705.jpg,lorry_truck,64,144,320,42,240,148,2,208,190,LTAdatasets/1005/annotate/1005-2021_03_20_100705.jpg,176.0,169.0,0.55,0.7041666666666667,0.2,0.175
1005-2021_03_20_195736.jpg,lorry_truck,20,195,320,28,240,126,2,215,154,LTAdatasets/1005/annotate/1005-2021_03_20_195736.jpg,205.0,140.0,0.640625,0.5833333333333334,0.0625,0.11666666666666667
1005-2021_03_20_195736.jpg,car,33,60,320,13,240,112,1,93,125,LTAdatasets/1005/annotate/1005-2021_03_20_195736.jpg,76.5,118.5,0.2390625,0.49375,0.103125,0.05416666666666667
1005-2021_03_20_195736.jpg,car,16,82,320,11,240,96,1,98,107,LTAdatasets/1005/annotate/1005-2021_03_20_195736.jpg,90.0,101.5,0.28125,0.42291666666666666,0.05,0.04583333333333333
1005-2021_03_20_195736.jpg,car,10,195,320,15,240,83,1,205,98,LTAdatasets/1005/annotate/1005-2021_03_20_195736.jpg,200.0,90.5,0.625,0.3770833333333333,0.03125,0.0625
1005-2021_03_20_195736.jpg,car,12,179,320,13,240,82,1,191,95,LTAdatasets/1005/annotate/1005-2021_03_20_195736.jpg,185.0,88.5,0.578125,0.36875,0.0375,0.05416666666666667
1005-2021_03_20_210420.jpg,car,42,76,320,44,240,186,1,118,230,LTAdatasets/1005/annotate/1005-2021_03_20_210420.jpg,97.0,208.0,0.303125,0.8666666666666667,0.13125,0.18333333333333332
1005-2021_03_20_210420.jpg,car,27,78,320,18,240,104,1,105,122,LTAdatasets/1005/annotate/1005-2021_03_20_210420.jpg,91.5,113.0,0.2859375,0.4708333333333333,0.084375,0.075
1005-2021_03_20_210420.jpg,car,34,21,320,14,240,133,1,55,147,LTAdatasets/1005/annotate/1005-2021_03_20_210420.jpg,38.0,140.0,0.11875,0.5833333333333334,0.10625,0.058333333333333334
1005-2021_03_20_210420.jpg,car,20,1,320,18,240,130,1,21,148,LTAdatasets/1005/annotate/1005-2021_03_20_210420.jpg,11.0,139.0,0.034375,0.5791666666666667,0.0625,0.075
1005-2021_03_20_210420.jpg,car,8,204,320,11,240,78,1,212,89,LTAdatasets/1005/annotate/1005-2021_03_20_210420.jpg,208.0,83.5,0.65,0.34791666666666665,0.025,0.04583333333333333
1005-2021_03_20_075818.jpg,car,30,4,320,18,240,142,1,34,160,LTAdatasets/1005/annotate/1005-2021_03_20_075818.jpg,19.0,151.0,0.059375,0.6291666666666667,0.09375,0.075
1005-2021_03_20_075818.jpg,bike,15,31,320,18,240,121,4,46,139,LTAdatasets/1005/annotate/1005-2021_03_20_075818.jpg,38.5,130.0,0.1203125,0.5416666666666666,0.046875,0.075
1005-2021_03_20_075818.jpg,car,16,217,320,11,240,80,1,233,91,LTAdatasets/1005/annotate/1005-2021_03_20_075818.jpg,225.0,85.5,0.703125,0.35625,0.05,0.04583333333333333
1005-2021_03_20_075818.jpg,bike,6,96,320,11,240,92,4,102,103,LTAdatasets/1005/annotate/1005-2021_03_20_075818.jpg,99.0,97.5,0.309375,0.40625,0.01875,0.04583333333333333
1005-2021_03_20_075818.jpg,lorry_truck,18,118,320,13,240,69,2,136,82,LTAdatasets/1005/annotate/1005-2021_03_20_075818.jpg,127.0,75.5,0.396875,0.3145833333333333,0.05625,0.05416666666666667
1005-2021_03_20_194315.jpg,bike,9,198,320,16,240,113,4,207,129,LTAdatasets/1005/annotate/1005-2021_03_20_194315.jpg,202.5,121.0,0.6328125,0.5041666666666667,0.028125,0.06666666666666667
1005-2021_03_20_194315.jpg,car,13,165,320,14,240,94,1,178,108,LTAdatasets/1005/annotate/1005-2021_03_20_194315.jpg,171.5,101.0,0.5359375,0.42083333333333334,0.040625,0.058333333333333334
1005-2021_03_20_194315.jpg,car,8,204,320,11,240,81,1,212,92,LTAdatasets/1005/annotate/1005-2021_03_20_194315.jpg,208.0,86.5,0.65,0.36041666666666666,0.025,0.04583333333333333
1005-2021_03_20_194315.jpg,car,9,154,320,8,240,74,1,163,82,LTAdatasets/1005/annotate/1005-2021_03_20_194315.jpg,158.5,78.0,0.4953125,0.325,0.028125,0.03333333333333333
1005-2021_03_20_194315.jpg,car,12,140,320,8,240,75,1,152,83,LTAdatasets/1005/annotate/1005-2021_03_20_194315.jpg,146.0,79.0,0.45625,0.32916666666666666,0.0375,0.03333333333333333
1005-2021_03_20_083640.jpg,car,7,227,320,6,240,73,1,234,79,LTAdatasets/1005/annotate/1005-2021_03_20_083640.jpg,230.5,76.0,0.7203125,0.31666666666666665,0.021875,0.025
1005-2021_03_20_085822.jpg,car,28,22,320,20,240,126,1,50,146,LTAdatasets/1005/annotate/1005-2021_03_20_085822.jpg,36.0,136.0,0.1125,0.5666666666666667,0.0875,0.08333333333333333
1005-2021_03_20_085822.jpg,car,20,51,320,18,240,106,1,71,124,LTAdatasets/1005/annotate/1005-2021_03_20_085822.jpg,61.0,115.0,0.190625,0.4791666666666667,0.0625,0.075
1005-2021_03_20_085822.jpg,car,12,91,320,13,240,101,1,103,114,LTAdatasets/1005/annotate/1005-2021_03_20_085822.jpg,97.0,107.5,0.303125,0.4479166666666667,0.0375,0.05416666666666667
1005-2021_03_20_085822.jpg,car,7,209,320,7,240,74,1,216,81,LTAdatasets/1005/annotate/1005-2021_03_20_085822.jpg,212.5,77.5,0.6640625,0.3229166666666667,0.021875,0.029166666666666667
1005-2021_03_20_085822.jpg,bus,13,220,320,18,240,74,5,233,92,LTAdatasets/1005/annotate/1005-2021_03_20_085822.jpg,226.5,83.0,0.7078125,0.3458333333333333,0.040625,0.075
1005-2021_03_20_183412.jpg,van,30,175,320,32,240,150,3,205,182,LTAdatasets/1005/annotate/1005-2021_03_20_183412.jpg,190.0,166.0,0.59375,0.6916666666666667,0.09375,0.13333333333333333
1005-2021_03_20_183412.jpg,car,12,90,320,8,240,105,1,102,113,LTAdatasets/1005/annotate/1005-2021_03_20_183412.jpg,96.0,109.0,0.3,0.45416666666666666,0.0375,0.03333333333333333
1005-2021_03_20_183412.jpg,car,11,148,320,7,240,78,1,159,85,LTAdatasets/1005/annotate/1005-2021_03_20_183412.jpg,153.5,81.5,0.4796875,0.33958333333333335,0.034375,0.029166666666666667
1005-2021_03_20_183412.jpg,car,9,204,320,9,240,82,1,213,91,LTAdatasets/1005/annotate/1005-2021_03_20_183412.jpg,208.5,86.5,0.6515625,0.36041666666666666,0.028125,0.0375
1005-2021_03_20_183412.jpg,car,12,130,320,7,240,77,1,142,84,LTAdatasets/1005/annotate/1005-2021_03_20_183412.jpg,136.0,80.5,0.425,0.33541666666666664,0.0375,0.029166666666666667
1005-2021_03_20_183412.jpg,car,9,221,320,7,240,75,1,230,82,LTAdatasets/1005/annotate/1005-2021_03_20_183412.jpg,225.5,78.5,0.7046875,0.32708333333333334,0.028125,0.029166666666666667
1005-2021_03_20_212801.jpg,car,36,110,320,23,240,134,1,146,157,LTAdatasets/1005/annotate/1005-2021_03_20_212801.jpg,128.0,145.5,0.4,0.60625,0.1125,0.09583333333333334
1005-2021_03_20_212801.jpg,car,16,211,320,14,240,98,1,227,112,LTAdatasets/1005/annotate/1005-2021_03_20_212801.jpg,219.0,105.0,0.684375,0.4375,0.05,0.058333333333333334
1005-2021_03_20_212801.jpg,bike,12,177,320,10,240,91,4,189,101,LTAdatasets/1005/annotate/1005-2021_03_20_212801.jpg,183.0,96.0,0.571875,0.4,0.0375,0.041666666666666664
1005-2021_03_20_212801.jpg,car,20,70,320,13,240,108,1,90,121,LTAdatasets/1005/annotate/1005-2021_03_20_212801.jpg,80.0,114.5,0.25,0.47708333333333336,0.0625,0.05416666666666667
1005-2021_03_20_212801.jpg,car,13,143,320,8,240,74,1,156,82,LTAdatasets/1005/annotate/1005-2021_03_20_212801.jpg,149.5,78.0,0.4671875,0.325,0.040625,0.03333333333333333
1005-2021_03_20_092143.jpg,car,18,189,320,20,240,108,1,207,128,LTAdatasets/1005/annotate/1005-2021_03_20_092143.jpg,198.0,118.0,0.61875,0.49166666666666664,0.05625,0.08333333333333333
1005-2021_03_20_092143.jpg,car,12,201,320,11,240,92,1,213,103,LTAdatasets/1005/annotate/1005-2021_03_20_092143.jpg,207.0,97.5,0.646875,0.40625,0.0375,0.04583333333333333
1005-2021_03_20_092143.jpg,car,24,20,320,13,240,119,1,44,132,LTAdatasets/1005/annotate/1005-2021_03_20_092143.jpg,32.0,125.5,0.1,0.5229166666666667,0.075,0.05416666666666667
1005-2021_03_20_092143.jpg,car,15,145,320,8,240,78,1,160,86,LTAdatasets/1005/annotate/1005-2021_03_20_092143.jpg,152.5,82.0,0.4765625,0.3416666666666667,0.046875,0.03333333333333333
1005-2021_03_20_092143.jpg,car,13,106,320,7,240,98,1,119,105,LTAdatasets/1005/annotate/1005-2021_03_20_092143.jpg,112.5,101.5,0.3515625,0.42291666666666666,0.040625,0.029166666666666667
1005-2021_03_20_092143.jpg,lorry_truck,12,220,320,16,240,76,2,232,92,LTAdatasets/1005/annotate/1005-2021_03_20_092143.jpg,226.0,84.0,0.70625,0.35,0.0375,0.06666666666666667
1005-2021_03_20_092143.jpg,van,7,212,320,8,240,75,3,219,83,LTAdatasets/1005/annotate/1005-2021_03_20_092143.jpg,215.5,79.0,0.6734375,0.32916666666666666,0.021875,0.03333333333333333
1005-2021_03_20_100105.jpg,car,15,212,320,17,240,100,1,227,117,LTAdatasets/1005/annotate/1005-2021_03_20_100105.jpg,219.5,108.5,0.6859375,0.45208333333333334,0.046875,0.07083333333333333
1005-2021_03_20_100105.jpg,car,18,110,320,12,240,90,1,128,102,LTAdatasets/1005/annotate/1005-2021_03_20_100105.jpg,119.0,96.0,0.371875,0.4,0.05625,0.05
1005-2021_03_20_100105.jpg,car,22,60,320,11,240,96,1,82,107,LTAdatasets/1005/annotate/1005-2021_03_20_100105.jpg,71.0,101.5,0.221875,0.42291666666666666,0.06875,0.04583333333333333
1005-2021_03_20_100105.jpg,car,24,2,320,13,240,132,1,26,145,LTAdatasets/1005/annotate/1005-2021_03_20_100105.jpg,14.0,138.5,0.04375,0.5770833333333333,0.075,0.05416666666666667
1005-2021_03_20_100105.jpg,van,22,2,320,13,240,119,3,24,132,LTAdatasets/1005/annotate/1005-2021_03_20_100105.jpg,13.0,125.5,0.040625,0.5229166666666667,0.06875,0.05416666666666667
1005-2021_03_20_100105.jpg,van,30,154,320,30,240,210,3,184,240,LTAdatasets/1005/annotate/1005-2021_03_20_100105.jpg,169.0,225.0,0.528125,0.9375,0.09375,0.125
1005-2021_03_20_065155.jpg,car,10,93,320,13,240,92,1,103,105,LTAdatasets/1005/annotate/1005-2021_03_20_065155.jpg,98.0,98.5,0.30625,0.41041666666666665,0.03125,0.05416666666666667
1005-2021_03_20_202217.jpg,car,20,193,320,26,240,132,1,213,158,LTAdatasets/1005/annotate/1005-2021_03_20_202217.jpg,203.0,145.0,0.634375,0.6041666666666666,0.0625,0.10833333333333334
1005-2021_03_20_202217.jpg,car,24,140,320,24,240,144,1,164,168,LTAdatasets/1005/annotate/1005-2021_03_20_202217.jpg,152.0,156.0,0.475,0.65,0.075,0.1
1005-2021_03_20_202217.jpg,car,15,110,320,7,240,86,1,125,93,LTAdatasets/1005/annotate/1005-2021_03_20_202217.jpg,117.5,89.5,0.3671875,0.3729166666666667,0.046875,0.029166666666666667
1005-2021_03_20_202217.jpg,car,14,185,320,15,240,97,1,199,112,LTAdatasets/1005/annotate/1005-2021_03_20_202217.jpg,192.0,104.5,0.6,0.4354166666666667,0.04375,0.0625
1005-2021_03_20_202217.jpg,lorry_truck,16,208,320,17,240,96,2,224,113,LTAdatasets/1005/annotate/1005-2021_03_20_202217.jpg,216.0,104.5,0.675,0.4354166666666667,0.05,0.07083333333333333
1005-2021_03_20_202217.jpg,car,11,189,320,8,240,77,1,200,85,LTAdatasets/1005/annotate/1005-2021_03_20_202217.jpg,194.5,81.0,0.6078125,0.3375,0.034375,0.03333333333333333
1005-2021_03_20_202217.jpg,car,8,206,320,10,240,77,1,214,87,LTAdatasets/1005/annotate/1005-2021_03_20_202217.jpg,210.0,82.0,0.65625,0.3416666666666667,0.025,0.041666666666666664
1005-2021_03_20_201917.jpg,van,20,177,320,35,240,151,3,197,186,LTAdatasets/1005/annotate/1005-2021_03_20_201917.jpg,187.0,168.5,0.584375,0.7020833333333333,0.0625,0.14583333333333334
1005-2021_03_20_201917.jpg,car,20,156,320,18,240,117,1,176,135,LTAdatasets/1005/annotate/1005-2021_03_20_201917.jpg,166.0,126.0,0.51875,0.525,0.0625,0.075
1005-2021_03_20_201917.jpg,van,13,211,320,21,240,93,3,224,114,LTAdatasets/1005/annotate/1005-2021_03_20_201917.jpg,217.5,103.5,0.6796875,0.43125,0.040625,0.0875
1005-2021_03_20_201917.jpg,car,25,65,320,11,240,112,1,90,123,LTAdatasets/1005/annotate/1005-2021_03_20_201917.jpg,77.5,117.5,0.2421875,0.4895833333333333,0.078125,0.04583333333333333
1005-2021_03_20_201917.jpg,car,19,60,320,8,240,105,1,79,113,LTAdatasets/1005/annotate/1005-2021_03_20_201917.jpg,69.5,109.0,0.2171875,0.45416666666666666,0.059375,0.03333333333333333
1005-2021_03_20_184613.jpg,car,42,61,320,35,240,154,1,103,189,LTAdatasets/1005/annotate/1005-2021_03_20_184613.jpg,82.0,171.5,0.25625,0.7145833333333333,0.13125,0.14583333333333334
1005-2021_03_20_184613.jpg,car,24,49,320,7,240,112,1,73,119,LTAdatasets/1005/annotate/1005-2021_03_20_184613.jpg,61.0,115.5,0.190625,0.48125,0.075,0.029166666666666667
1005-2021_03_20_184613.jpg,car,16,172,320,19,240,105,1,188,124,LTAdatasets/1005/annotate/1005-2021_03_20_184613.jpg,180.0,114.5,0.5625,0.47708333333333336,0.05,0.07916666666666666
1005-2021_03_20_184613.jpg,car,11,213,320,17,240,94,1,224,111,LTAdatasets/1005/annotate/1005-2021_03_20_184613.jpg,218.5,102.5,0.6828125,0.4270833333333333,0.034375,0.07083333333333333
1005-2021_03_20_184613.jpg,car,20,107,320,9,240,96,1,127,105,LTAdatasets/1005/annotate/1005-2021_03_20_184613.jpg,117.0,100.5,0.365625,0.41875,0.0625,0.0375
1005-2021_03_20_184613.jpg,car,9,201,320,11,240,88,1,210,99,LTAdatasets/1005/annotate/1005-2021_03_20_184613.jpg,205.5,93.5,0.6421875,0.38958333333333334,0.028125,0.04583333333333333
1005-2021_03_20_184613.jpg,car,18,3,320,16,240,142,1,21,158,LTAdatasets/1005/annotate/1005-2021_03_20_184613.jpg,12.0,150.0,0.0375,0.625,0.05625,0.06666666666666667
1005-2021_03_20_181251.jpg,car,25,119,320,30,240,166,1,144,196,LTAdatasets/1005/annotate/1005-2021_03_20_181251.jpg,131.5,181.0,0.4109375,0.7541666666666667,0.078125,0.125
1005-2021_03_20_181251.jpg,lorry_truck,27,3,320,22,240,108,2,30,130,LTAdatasets/1005/annotate/1005-2021_03_20_181251.jpg,16.5,119.0,0.0515625,0.49583333333333335,0.084375,0.09166666666666666
1005-2021_03_20_181251.jpg,car,12,186,320,17,240,100,1,198,117,LTAdatasets/1005/annotate/1005-2021_03_20_181251.jpg,192.0,108.5,0.6,0.45208333333333334,0.0375,0.07083333333333333
1005-2021_03_20_181251.jpg,car,19,208,320,14,240,96,1,227,110,LTAdatasets/1005/annotate/1005-2021_03_20_181251.jpg,217.5,103.0,0.6796875,0.42916666666666664,0.059375,0.058333333333333334
1005-2021_03_20_181251.jpg,car,13,195,320,13,240,87,1,208,100,LTAdatasets/1005/annotate/1005-2021_03_20_181251.jpg,201.5,93.5,0.6296875,0.38958333333333334,0.040625,0.05416666666666667
1005-2021_03_20_181251.jpg,car,24,67,320,9,240,102,1,91,111,LTAdatasets/1005/annotate/1005-2021_03_20_181251.jpg,79.0,106.5,0.246875,0.44375,0.075,0.0375
1005-2021_03_20_181251.jpg,bike,8,84,320,10,240,88,4,92,98,LTAdatasets/1005/annotate/1005-2021_03_20_181251.jpg,88.0,93.0,0.275,0.3875,0.025,0.041666666666666664
1005-2021_03_20_180410.jpg,car,19,158,320,22,240,126,1,177,148,LTAdatasets/1005/annotate/1005-2021_03_20_180410.jpg,167.5,137.0,0.5234375,0.5708333333333333,0.059375,0.09166666666666666
1005-2021_03_20_180410.jpg,car,14,191,320,11,240,93,1,205,104,LTAdatasets/1005/annotate/1005-2021_03_20_180410.jpg,198.0,98.5,0.61875,0.41041666666666665,0.04375,0.04583333333333333
1005-2021_03_20_180410.jpg,car,11,221,320,11,240,91,1,232,102,LTAdatasets/1005/annotate/1005-2021_03_20_180410.jpg,226.5,96.5,0.7078125,0.40208333333333335,0.034375,0.04583333333333333
1005-2021_03_20_180410.jpg,car,28,51,320,10,240,113,1,79,123,LTAdatasets/1005/annotate/1005-2021_03_20_180410.jpg,65.0,118.0,0.203125,0.49166666666666664,0.0875,0.041666666666666664
1005-2021_03_20_180410.jpg,car,40,0,320,40,240,200,1,40,240,LTAdatasets/1005/annotate/1005-2021_03_20_180410.jpg,20.0,220.0,0.0625,0.9166666666666666,0.125,0.16666666666666666
1005-2021_03_20_082740.jpg,van,19,179,320,22,240,103,3,198,125,LTAdatasets/1005/annotate/1005-2021_03_20_082740.jpg,188.5,114.0,0.5890625,0.475,0.059375,0.09166666666666666
1005-2021_03_20_082740.jpg,car,19,153,320,23,240,98,1,172,121,LTAdatasets/1005/annotate/1005-2021_03_20_082740.jpg,162.5,109.5,0.5078125,0.45625,0.059375,0.09583333333333334
1005-2021_03_20_092803.jpg,car,27,155,320,26,240,120,1,182,146,LTAdatasets/1005/annotate/1005-2021_03_20_092803.jpg,168.5,133.0,0.5265625,0.5541666666666667,0.084375,0.10833333333333334
1005-2021_03_20_092803.jpg,bike,13,63,320,12,240,110,4,76,122,LTAdatasets/1005/annotate/1005-2021_03_20_092803.jpg,69.5,116.0,0.2171875,0.48333333333333334,0.040625,0.05
1005-2021_03_20_092803.jpg,car,8,93,320,11,240,101,1,101,112,LTAdatasets/1005/annotate/1005-2021_03_20_092803.jpg,97.0,106.5,0.303125,0.44375,0.025,0.04583333333333333
1005-2021_03_20_194916.jpg,van,20,66,320,8,240,94,3,86,102,LTAdatasets/1005/annotate/1005-2021_03_20_194916.jpg,76.0,98.0,0.2375,0.4083333333333333,0.0625,0.03333333333333333
1005-2021_03_20_194916.jpg,car,16,183,320,20,240,97,1,199,117,LTAdatasets/1005/annotate/1005-2021_03_20_194916.jpg,191.0,107.0,0.596875,0.44583333333333336,0.05,0.08333333333333333
1005-2021_03_20_194916.jpg,bike,17,156,320,15,240,127,4,173,142,LTAdatasets/1005/annotate/1005-2021_03_20_194916.jpg,164.5,134.5,0.5140625,0.5604166666666667,0.053125,0.0625
1005-2021_03_20_194916.jpg,car,18,151,320,12,240,100,1,169,112,LTAdatasets/1005/annotate/1005-2021_03_20_194916.jpg,160.0,106.0,0.5,0.44166666666666665,0.05625,0.05
1005-2021_03_20_194916.jpg,car,13,218,320,11,240,88,1,231,99,LTAdatasets/1005/annotate/1005-2021_03_20_194916.jpg,224.5,93.5,0.7015625,0.38958333333333334,0.040625,0.04583333333333333
1005-2021_03_20_192214.jpg,van,16,207,320,19,240,99,3,223,118,LTAdatasets/1005/annotate/1005-2021_03_20_192214.jpg,215.0,108.5,0.671875,0.45208333333333334,0.05,0.07916666666666666
1005-2021_03_20_192214.jpg,car,10,204,320,7,240,80,1,214,87,LTAdatasets/1005/annotate/1005-2021_03_20_192214.jpg,209.0,83.5,0.653125,0.34791666666666665,0.03125,0.029166666666666667
1005-2021_03_20_192214.jpg,car,12,141,320,8,240,75,1,153,83,LTAdatasets/1005/annotate/1005-2021_03_20_192214.jpg,147.0,79.0,0.459375,0.32916666666666666,0.0375,0.03333333333333333
1005-2021_03_20_071236.jpg,lorry_truck,13,221,320,15,240,66,2,234,81,LTAdatasets/1005/annotate/1005-2021_03_20_071236.jpg,227.5,73.5,0.7109375,0.30625,0.040625,0.0625
1005-2021_03_20_074918.jpg,car,18,180,320,17,240,106,1,198,123,LTAdatasets/1005/annotate/1005-2021_03_20_074918.jpg,189.0,114.5,0.590625,0.47708333333333336,0.05625,0.07083333333333333
1005-2021_03_20_074918.jpg,car,31,2,320,20,240,136,1,33,156,LTAdatasets/1005/annotate/1005-2021_03_20_074918.jpg,17.5,146.0,0.0546875,0.6083333333333333,0.096875,0.08333333333333333
1005-2021_03_20_213341.jpg,car,30,128,320,30,240,155,1,158,185,LTAdatasets/1005/annotate/1005-2021_03_20_213341.jpg,143.0,170.0,0.446875,0.7083333333333334,0.09375,0.125
1005-2021_03_20_213341.jpg,car,31,101,320,23,240,135,1,132,158,LTAdatasets/1005/annotate/1005-2021_03_20_213341.jpg,116.5,146.5,0.3640625,0.6104166666666667,0.096875,0.09583333333333334
1005-2021_03_20_213341.jpg,van,20,204,320,26,240,105,3,224,131,LTAdatasets/1005/annotate/1005-2021_03_20_213341.jpg,214.0,118.0,0.66875,0.49166666666666664,0.0625,0.10833333333333334
1005-2021_03_20_213341.jpg,car,22,87,320,12,240,103,1,109,115,LTAdatasets/1005/annotate/1005-2021_03_20_213341.jpg,98.0,109.0,0.30625,0.45416666666666666,0.06875,0.05
1005-2021_03_20_072817.jpg,car,20,175,320,16,240,101,1,195,117,LTAdatasets/1005/annotate/1005-2021_03_20_072817.jpg,185.0,109.0,0.578125,0.45416666666666666,0.0625,0.06666666666666667
1005-2021_03_20_072817.jpg,car,15,125,320,11,240,80,1,140,91,LTAdatasets/1005/annotate/1005-2021_03_20_072817.jpg,132.5,85.5,0.4140625,0.35625,0.046875,0.04583333333333333
1005-2021_03_20_072817.jpg,van,8,213,320,8,240,71,3,221,79,LTAdatasets/1005/annotate/1005-2021_03_20_072817.jpg,217.0,75.0,0.678125,0.3125,0.025,0.03333333333333333
1005-2021_03_20_072817.jpg,car,12,91,320,11,240,101,1,103,112,LTAdatasets/1005/annotate/1005-2021_03_20_072817.jpg,97.0,106.5,0.303125,0.44375,0.0375,0.04583333333333333
1005-2021_03_20_072817.jpg,car,6,228,320,7,240,72,1,234,79,LTAdatasets/1005/annotate/1005-2021_03_20_072817.jpg,231.0,75.5,0.721875,0.3145833333333333,0.01875,0.029166666666666667
1005-2021_03_20_214302.jpg,car,15,206,320,20,240,104,1,221,124,LTAdatasets/1005/annotate/1005-2021_03_20_214302.jpg,213.5,114.0,0.6671875,0.475,0.046875,0.08333333333333333
1005-2021_03_20_184913.jpg,bike,8,196,320,22,240,158,4,204,180,LTAdatasets/1005/annotate/1005-2021_03_20_184913.jpg,200.0,169.0,0.625,0.7041666666666667,0.025,0.09166666666666666
1005-2021_03_20_184913.jpg,car,18,177,320,17,240,101,1,195,118,LTAdatasets/1005/annotate/1005-2021_03_20_184913.jpg,186.0,109.5,0.58125,0.45625,0.05625,0.07083333333333333
1005-2021_03_20_184913.jpg,car,15,111,320,10,240,96,1,126,106,LTAdatasets/1005/annotate/1005-2021_03_20_184913.jpg,118.5,101.0,0.3703125,0.42083333333333334,0.046875,0.041666666666666664
1005-2021_03_20_184913.jpg,car,26,42,320,11,240,112,1,68,123,LTAdatasets/1005/annotate/1005-2021_03_20_184913.jpg,55.0,117.5,0.171875,0.4895833333333333,0.08125,0.04583333333333333
1005-2021_03_20_184913.jpg,car,13,128,320,6,240,80,1,141,86,LTAdatasets/1005/annotate/1005-2021_03_20_184913.jpg,134.5,83.0,0.4203125,0.3458333333333333,0.040625,0.025
1005-2021_03_20_184913.jpg,car,12,143,320,7,240,82,1,155,89,LTAdatasets/1005/annotate/1005-2021_03_20_184913.jpg,149.0,85.5,0.465625,0.35625,0.0375,0.029166666666666667
1005-2021_03_20_184913.jpg,bus,8,210,320,10,240,76,5,218,86,LTAdatasets/1005/annotate/1005-2021_03_20_184913.jpg,214.0,81.0,0.66875,0.3375,0.025,0.041666666666666664
1005-2021_03_20_075138.jpg,lorry_truck,17,212,320,24,240,83,2,229,107,LTAdatasets/1005/annotate/1005-2021_03_20_075138.jpg,220.5,95.0,0.6890625,0.3958333333333333,0.053125,0.1
1005-2021_03_20_075138.jpg,car,11,190,320,12,240,90,1,201,102,LTAdatasets/1005/annotate/1005-2021_03_20_075138.jpg,195.5,96.0,0.6109375,0.4,0.034375,0.05
1005-2021_03_20_075138.jpg,car,28,25,320,16,240,107,1,53,123,LTAdatasets/1005/annotate/1005-2021_03_20_075138.jpg,39.0,115.0,0.121875,0.4791666666666667,0.0875,0.06666666666666667
1005-2021_03_20_085141.jpg,car,57,60,320,30,240,210,1,117,240,LTAdatasets/1005/annotate/1005-2021_03_20_085141.jpg,88.5,225.0,0.2765625,0.9375,0.178125,0.125
1005-2021_03_20_085141.jpg,car,12,200,320,30,240,137,1,212,167,LTAdatasets/1005/annotate/1005-2021_03_20_085141.jpg,206.0,152.0,0.64375,0.6333333333333333,0.0375,0.125
1005-2021_03_20_085141.jpg,van,19,182,320,19,240,96,3,201,115,LTAdatasets/1005/annotate/1005-2021_03_20_085141.jpg,191.5,105.5,0.5984375,0.4395833333333333,0.059375,0.07916666666666666
1005-2021_03_20_085141.jpg,van,15,186,320,11,240,80,3,201,91,LTAdatasets/1005/annotate/1005-2021_03_20_085141.jpg,193.5,85.5,0.6046875,0.35625,0.046875,0.04583333333333333
1005-2021_03_20_085141.jpg,car,33,54,320,11,240,120,1,87,131,LTAdatasets/1005/annotate/1005-2021_03_20_085141.jpg,70.5,125.5,0.2203125,0.5229166666666667,0.103125,0.04583333333333333
1005-2021_03_20_085141.jpg,car,25,30,320,12,240,119,1,55,131,LTAdatasets/1005/annotate/1005-2021_03_20_085141.jpg,42.5,125.0,0.1328125,0.5208333333333334,0.078125,0.05
1005-2021_03_20_085141.jpg,car,17,85,320,13,240,93,1,102,106,LTAdatasets/1005/annotate/1005-2021_03_20_085141.jpg,93.5,99.5,0.2921875,0.41458333333333336,0.053125,0.05416666666666667
1005-2021_03_20_085141.jpg,car,11,149,320,9,240,76,1,160,85,LTAdatasets/1005/annotate/1005-2021_03_20_085141.jpg,154.5,80.5,0.4828125,0.33541666666666664,0.034375,0.0375
1005-2021_03_20_083340.jpg,car,28,138,320,36,240,146,1,166,182,LTAdatasets/1005/annotate/1005-2021_03_20_083340.jpg,152.0,164.0,0.475,0.6833333333333333,0.0875,0.15
1005-2021_03_20_083340.jpg,lorry_truck,17,212,320,20,240,83,2,229,103,LTAdatasets/1005/annotate/1005-2021_03_20_083340.jpg,220.5,93.0,0.6890625,0.3875,0.053125,0.08333333333333333
1005-2021_03_20_083340.jpg,car,19,114,320,10,240,90,1,133,100,LTAdatasets/1005/annotate/1005-2021_03_20_083340.jpg,123.5,95.0,0.3859375,0.3958333333333333,0.059375,0.041666666666666664
1005-2021_03_20_083340.jpg,car,12,194,320,9,240,74,1,206,83,LTAdatasets/1005/annotate/1005-2021_03_20_083340.jpg,200.0,78.5,0.625,0.32708333333333334,0.0375,0.0375
1005-2021_03_20_074318.jpg,van,27,20,320,21,240,111,3,47,132,LTAdatasets/1005/annotate/1005-2021_03_20_074318.jpg,33.5,121.5,0.1046875,0.50625,0.084375,0.0875
1005-2021_03_20_074318.jpg,car,21,79,320,13,240,94,1,100,107,LTAdatasets/1005/annotate/1005-2021_03_20_074318.jpg,89.5,100.5,0.2796875,0.41875,0.065625,0.05416666666666667
1005-2021_03_20_080719.jpg,car,11,186,320,14,240,99,1,197,113,LTAdatasets/1005/annotate/1005-2021_03_20_080719.jpg,191.5,106.0,0.5984375,0.44166666666666665,0.034375,0.058333333333333334
1005-2021_03_20_080719.jpg,car,12,203,320,11,240,86,1,215,97,LTAdatasets/1005/annotate/1005-2021_03_20_080719.jpg,209.0,91.5,0.653125,0.38125,0.0375,0.04583333333333333
1005-2021_03_20_080719.jpg,car,27,21,320,11,240,123,1,48,134,LTAdatasets/1005/annotate/1005-2021_03_20_080719.jpg,34.5,128.5,0.1078125,0.5354166666666667,0.084375,0.04583333333333333
1005-2021_03_20_080719.jpg,car,15,80,320,8,240,108,1,95,116,LTAdatasets/1005/annotate/1005-2021_03_20_080719.jpg,87.5,112.0,0.2734375,0.4666666666666667,0.046875,0.03333333333333333
1005-2021_03_20_080719.jpg,bike,8,79,320,9,240,101,4,87,110,LTAdatasets/1005/annotate/1005-2021_03_20_080719.jpg,83.0,105.5,0.259375,0.4395833333333333,0.025,0.0375
1005-2021_03_20_220403.jpg,car,29,135,320,28,240,140,1,164,168,LTAdatasets/1005/annotate/1005-2021_03_20_220403.jpg,149.5,154.0,0.4671875,0.6416666666666667,0.090625,0.11666666666666667
1005-2021_03_20_220403.jpg,car,25,187,320,35,240,128,1,212,163,LTAdatasets/1005/annotate/1005-2021_03_20_220403.jpg,199.5,145.5,0.6234375,0.60625,0.078125,0.14583333333333334
1005-2021_03_20_220403.jpg,car,15,185,320,16,240,98,1,200,114,LTAdatasets/1005/annotate/1005-2021_03_20_220403.jpg,192.5,106.0,0.6015625,0.44166666666666665,0.046875,0.06666666666666667
1005-2021_03_20_204919.jpg,car,45,83,320,47,240,193,1,128,240,LTAdatasets/1005/annotate/1005-2021_03_20_204919.jpg,105.5,216.5,0.3296875,0.9020833333333333,0.140625,0.19583333333333333
1005-2021_03_20_204919.jpg,car,19,152,320,19,240,98,1,171,117,LTAdatasets/1005/annotate/1005-2021_03_20_204919.jpg,161.5,107.5,0.5046875,0.4479166666666667,0.059375,0.07916666666666666
1005-2021_03_20_204919.jpg,lorry_truck,17,212,320,26,240,88,2,229,114,LTAdatasets/1005/annotate/1005-2021_03_20_204919.jpg,220.5,101.0,0.6890625,0.42083333333333334,0.053125,0.10833333333333334
1005-2021_03_20_210720.jpg,car,47,77,320,54,240,185,1,124,239,LTAdatasets/1005/annotate/1005-2021_03_20_210720.jpg,100.5,212.0,0.3140625,0.8833333333333333,0.146875,0.225
1005-2021_03_20_210720.jpg,car,12,197,320,15,240,90,1,209,105,LTAdatasets/1005/annotate/1005-2021_03_20_210720.jpg,203.0,97.5,0.634375,0.40625,0.0375,0.0625
1005-2021_03_20_210720.jpg,car,11,179,320,9,240,84,1,190,93,LTAdatasets/1005/annotate/1005-2021_03_20_210720.jpg,184.5,88.5,0.5765625,0.36875,0.034375,0.0375
1005-2021_03_20_090402.jpg,car,26,119,320,19,240,121,1,145,140,LTAdatasets/1005/annotate/1005-2021_03_20_090402.jpg,132.0,130.5,0.4125,0.54375,0.08125,0.07916666666666666
1005-2021_03_20_090402.jpg,car,9,218,320,9,240,86,1,227,95,LTAdatasets/1005/annotate/1005-2021_03_20_090402.jpg,222.5,90.5,0.6953125,0.3770833333333333,0.028125,0.0375
1005-2021_03_20_090402.jpg,bike,12,79,320,13,240,89,4,91,102,LTAdatasets/1005/annotate/1005-2021_03_20_090402.jpg,85.0,95.5,0.265625,0.39791666666666664,0.0375,0.05416666666666667
1005-2021_03_20_202758.jpg,car,31,95,320,24,240,138,1,126,162,LTAdatasets/1005/annotate/1005-2021_03_20_202758.jpg,110.5,150.0,0.3453125,0.625,0.096875,0.1
1005-2021_03_20_202758.jpg,car,19,202,320,21,240,112,1,221,133,LTAdatasets/1005/annotate/1005-2021_03_20_202758.jpg,211.5,122.5,0.6609375,0.5104166666666666,0.059375,0.0875
1005-2021_03_20_202758.jpg,van,18,180,320,23,240,95,3,198,118,LTAdatasets/1005/annotate/1005-2021_03_20_202758.jpg,189.0,106.5,0.590625,0.44375,0.05625,0.09583333333333334
1005-2021_03_20_064254.jpg,car,28,23,320,18,240,115,1,51,133,LTAdatasets/1005/annotate/1005-2021_03_20_064254.jpg,37.0,124.0,0.115625,0.5166666666666667,0.0875,0.075
1005-2021_03_20_064254.jpg,car,19,73,320,13,240,88,1,92,101,LTAdatasets/1005/annotate/1005-2021_03_20_064254.jpg,82.5,94.5,0.2578125,0.39375,0.059375,0.05416666666666667
1005-2021_03_20_182151.jpg,car,18,174,320,19,240,113,1,192,132,LTAdatasets/1005/annotate/1005-2021_03_20_182151.jpg,183.0,122.5,0.571875,0.5104166666666666,0.05625,0.07916666666666666
1005-2021_03_20_182151.jpg,car,26,60,320,12,240,102,1,86,114,LTAdatasets/1005/annotate/1005-2021_03_20_182151.jpg,73.0,108.0,0.228125,0.45,0.08125,0.05
1005-2021_03_20_182151.jpg,car,25,37,320,15,240,124,1,62,139,LTAdatasets/1005/annotate/1005-2021_03_20_182151.jpg,49.5,131.5,0.1546875,0.5479166666666667,0.078125,0.0625
1005-2021_03_20_182151.jpg,car,17,106,320,9,240,98,1,123,107,LTAdatasets/1005/annotate/1005-2021_03_20_182151.jpg,114.5,102.5,0.3578125,0.4270833333333333,0.053125,0.0375
1005-2021_03_20_182151.jpg,car,9,191,320,15,240,94,1,200,109,LTAdatasets/1005/annotate/1005-2021_03_20_182151.jpg,195.5,101.5,0.6109375,0.42291666666666666,0.028125,0.0625
1005-2021_03_20_182151.jpg,car,12,134,320,8,240,83,1,146,91,LTAdatasets/1005/annotate/1005-2021_03_20_182151.jpg,140.0,87.0,0.4375,0.3625,0.0375,0.03333333333333333
1005-2021_03_20_182151.jpg,lorry_truck,19,75,320,13,240,86,2,94,99,LTAdatasets/1005/annotate/1005-2021_03_20_182151.jpg,84.5,92.5,0.2640625,0.3854166666666667,0.059375,0.05416666666666667
1005-2021_03_20_182151.jpg,car,8,204,320,10,240,82,1,212,92,LTAdatasets/1005/annotate/1005-2021_03_20_182151.jpg,208.0,87.0,0.65,0.3625,0.025,0.041666666666666664
1005-2021_03_20_182151.jpg,car,10,190,320,9,240,77,1,200,86,LTAdatasets/1005/annotate/1005-2021_03_20_182151.jpg,195.0,81.5,0.609375,0.33958333333333335,0.03125,0.0375
1005-2021_03_20_081319.jpg,van,27,29,320,18,240,116,3,56,134,LTAdatasets/1005/annotate/1005-2021_03_20_081319.jpg,42.5,125.0,0.1328125,0.5208333333333334,0.084375,0.075
1005-2021_03_20_081319.jpg,car,14,200,320,24,240,113,1,214,137,LTAdatasets/1005/annotate/1005-2021_03_20_081319.jpg,207.0,125.0,0.646875,0.5208333333333334,0.04375,0.1
1005-2021_03_20_081319.jpg,lorry_truck,25,66,320,13,240,91,2,91,104,LTAdatasets/1005/annotate/1005-2021_03_20_081319.jpg,78.5,97.5,0.2453125,0.40625,0.078125,0.05416666666666667
1005-2021_03_20_081319.jpg,car,14,107,320,11,240,95,1,121,106,LTAdatasets/1005/annotate/1005-2021_03_20_081319.jpg,114.0,100.5,0.35625,0.41875,0.04375,0.04583333333333333
1005-2021_03_20_095505.jpg,van,29,162,320,35,240,138,3,191,173,LTAdatasets/1005/annotate/1005-2021_03_20_095505.jpg,176.5,155.5,0.5515625,0.6479166666666667,0.090625,0.14583333333333334
1005-2021_03_20_095505.jpg,lorry_truck,12,217,320,15,240,80,2,229,95,LTAdatasets/1005/annotate/1005-2021_03_20_095505.jpg,223.0,87.5,0.696875,0.3645833333333333,0.0375,0.0625
1005-2021_03_20_095505.jpg,car,16,118,320,10,240,81,1,134,91,LTAdatasets/1005/annotate/1005-2021_03_20_095505.jpg,126.0,86.0,0.39375,0.35833333333333334,0.05,0.041666666666666664
1005-2021_03_20_095505.jpg,car,8,207,320,7,240,77,1,215,84,LTAdatasets/1005/annotate/1005-2021_03_20_095505.jpg,211.0,80.5,0.659375,0.33541666666666664,0.025,0.029166666666666667
1005-2021_03_20_061853.jpg,car,11,149,320,10,240,70,1,160,80,LTAdatasets/1005/annotate/1005-2021_03_20_061853.jpg,154.5,75.0,0.4828125,0.3125,0.034375,0.041666666666666664
1005-2021_03_20_180710.jpg,car,29,20,320,15,240,116,1,49,131,LTAdatasets/1005/annotate/1005-2021_03_20_180710.jpg,34.5,123.5,0.1078125,0.5145833333333333,0.090625,0.0625
1005-2021_03_20_180710.jpg,car,8,181,320,13,240,78,1,189,91,LTAdatasets/1005/annotate/1005-2021_03_20_180710.jpg,185.0,84.5,0.578125,0.35208333333333336,0.025,0.05416666666666667
1005-2021_03_20_180710.jpg,car,12,142,320,9,240,79,1,154,88,LTAdatasets/1005/annotate/1005-2021_03_20_180710.jpg,148.0,83.5,0.4625,0.34791666666666665,0.0375,0.0375
1005-2021_03_20_180710.jpg,car,10,150,320,7,240,71,1,160,78,LTAdatasets/1005/annotate/1005-2021_03_20_180710.jpg,155.0,74.5,0.484375,0.3104166666666667,0.03125,0.029166666666666667
1005-2021_03_20_180710.jpg,lorry_truck,12,222,320,13,240,75,2,234,88,LTAdatasets/1005/annotate/1005-2021_03_20_180710.jpg,228.0,81.5,0.7125,0.33958333333333335,0.0375,0.05416666666666667
1005-2021_03_20_191914.jpg,car,11,219,320,9,240,89,1,230,98,LTAdatasets/1005/annotate/1005-2021_03_20_191914.jpg,224.5,93.5,0.7015625,0.38958333333333334,0.034375,0.0375
1005-2021_03_20_191914.jpg,car,12,198,320,9,240,89,1,210,98,LTAdatasets/1005/annotate/1005-2021_03_20_191914.jpg,204.0,93.5,0.6375,0.38958333333333334,0.0375,0.0375
1005-2021_03_20_191914.jpg,car,12,106,320,10,240,95,1,118,105,LTAdatasets/1005/annotate/1005-2021_03_20_191914.jpg,112.0,100.0,0.35,0.4166666666666667,0.0375,0.041666666666666664
1005-2021_03_20_191914.jpg,car,15,116,320,7,240,85,1,131,92,LTAdatasets/1005/annotate/1005-2021_03_20_191914.jpg,123.5,88.5,0.3859375,0.36875,0.046875,0.029166666666666667
1005-2021_03_20_191914.jpg,car,11,118,320,6,240,78,1,129,84,LTAdatasets/1005/annotate/1005-2021_03_20_191914.jpg,123.5,81.0,0.3859375,0.3375,0.034375,0.025
1005-2021_03_20_200637.jpg,car,20,206,320,21,240,110,1,226,131,LTAdatasets/1005/annotate/1005-2021_03_20_200637.jpg,216.0,120.5,0.675,0.5020833333333333,0.0625,0.0875
1005-2021_03_20_200637.jpg,car,47,65,320,27,240,149,1,112,176,LTAdatasets/1005/annotate/1005-2021_03_20_200637.jpg,88.5,162.5,0.2765625,0.6770833333333334,0.146875,0.1125
1005-2021_03_20_200637.jpg,lorry_truck,46,154,320,37,240,153,2,200,190,LTAdatasets/1005/annotate/1005-2021_03_20_200637.jpg,177.0,171.5,0.553125,0.7145833333333333,0.14375,0.15416666666666667
1005-2021_03_20_073717.jpg,car,23,57,320,16,240,103,1,80,119,LTAdatasets/1005/annotate/1005-2021_03_20_073717.jpg,68.5,111.0,0.2140625,0.4625,0.071875,0.06666666666666667
1005-2021_03_20_071836.jpg,car,22,149,320,16,240,105,1,171,121,LTAdatasets/1005/annotate/1005-2021_03_20_071836.jpg,160.0,113.0,0.5,0.4708333333333333,0.06875,0.06666666666666667
1005-2021_03_20_071836.jpg,car,19,81,320,12,240,105,1,100,117,LTAdatasets/1005/annotate/1005-2021_03_20_071836.jpg,90.5,111.0,0.2828125,0.4625,0.059375,0.05
1005-2021_03_20_181851.jpg,van,22,198,320,23,240,116,3,220,139,LTAdatasets/1005/annotate/1005-2021_03_20_181851.jpg,209.0,127.5,0.653125,0.53125,0.06875,0.09583333333333334
1005-2021_03_20_181851.jpg,car,20,155,320,13,240,100,1,175,113,LTAdatasets/1005/annotate/1005-2021_03_20_181851.jpg,165.0,106.5,0.515625,0.44375,0.0625,0.05416666666666667
1005-2021_03_20_181851.jpg,car,30,7,320,13,240,115,1,37,128,LTAdatasets/1005/annotate/1005-2021_03_20_181851.jpg,22.0,121.5,0.06875,0.50625,0.09375,0.05416666666666667
1005-2021_03_20_181851.jpg,car,13,197,320,9,240,87,1,210,96,LTAdatasets/1005/annotate/1005-2021_03_20_181851.jpg,203.5,91.5,0.6359375,0.38125,0.040625,0.0375
1005-2021_03_20_181851.jpg,car,13,192,320,6,240,76,1,205,82,LTAdatasets/1005/annotate/1005-2021_03_20_181851.jpg,198.5,79.0,0.6203125,0.32916666666666666,0.040625,0.025
1005-2021_03_20_181851.jpg,car,11,155,320,7,240,74,1,166,81,LTAdatasets/1005/annotate/1005-2021_03_20_181851.jpg,160.5,77.5,0.5015625,0.3229166666666667,0.034375,0.029166666666666667
1005-2021_03_20_181851.jpg,car,13,219,320,9,240,84,1,232,93,LTAdatasets/1005/annotate/1005-2021_03_20_181851.jpg,225.5,88.5,0.7046875,0.36875,0.040625,0.0375
1005-2021_03_20_181851.jpg,car,29,151,320,22,240,218,1,180,240,LTAdatasets/1005/annotate/1005-2021_03_20_181851.jpg,165.5,229.0,0.5171875,0.9541666666666667,0.090625,0.09166666666666666
1005-2021_03_20_070416.jpg,bus,11,221,320,15,240,72,5,232,87,LTAdatasets/1005/annotate/1005-2021_03_20_070416.jpg,226.5,79.5,0.7078125,0.33125,0.034375,0.0625
1005-2021_03_20_070416.jpg,bike,7,92,320,11,240,102,4,99,113,LTAdatasets/1005/annotate/1005-2021_03_20_070416.jpg,95.5,107.5,0.2984375,0.4479166666666667,0.021875,0.04583333333333333
1005-2021_03_20_091302.jpg,bike,12,29,320,11,240,121,4,41,132,LTAdatasets/1005/annotate/1005-2021_03_20_091302.jpg,35.0,126.5,0.109375,0.5270833333333333,0.0375,0.04583333333333333
1005-2021_03_20_091302.jpg,car,27,56,320,18,240,113,1,83,131,LTAdatasets/1005/annotate/1005-2021_03_20_091302.jpg,69.5,122.0,0.2171875,0.5083333333333333,0.084375,0.075
1005-2021_03_20_091302.jpg,car,10,225,320,12,240,73,1,235,85,LTAdatasets/1005/annotate/1005-2021_03_20_091302.jpg,230.0,79.0,0.71875,0.32916666666666666,0.03125,0.05
1005-2021_03_20_091302.jpg,van,20,75,320,12,240,90,3,95,102,LTAdatasets/1005/annotate/1005-2021_03_20_091302.jpg,85.0,96.0,0.265625,0.4,0.0625,0.05
1005-2021_03_20_060353.jpg,car,9,113,320,6,240,83,1,122,89,LTAdatasets/1005/annotate/1005-2021_03_20_060353.jpg,117.5,86.0,0.3671875,0.35833333333333334,0.028125,0.025
1005-2021_03_20_060353.jpg,bike,6,145,320,10,240,74,4,151,84,LTAdatasets/1005/annotate/1005-2021_03_20_060353.jpg,148.0,79.0,0.4625,0.32916666666666666,0.01875,0.041666666666666664
1005-2021_03_20_215802.jpg,bike,12,191,320,12,240,98,4,203,110,LTAdatasets/1005/annotate/1005-2021_03_20_215802.jpg,197.0,104.0,0.615625,0.43333333333333335,0.0375,0.05
1005-2021_03_20_215802.jpg,lorry_truck,16,213,320,20,240,92,2,229,112,LTAdatasets/1005/annotate/1005-2021_03_20_215802.jpg,221.0,102.0,0.690625,0.425,0.05,0.08333333333333333
1005-2021_03_20_215802.jpg,car,16,76,320,8,240,92,1,92,100,LTAdatasets/1005/annotate/1005-2021_03_20_215802.jpg,84.0,96.0,0.2625,0.4,0.05,0.03333333333333333
1005-2021_03_20_215802.jpg,car,10,108,320,12,240,90,1,118,102,LTAdatasets/1005/annotate/1005-2021_03_20_215802.jpg,113.0,96.0,0.353125,0.4,0.03125,0.05
1005-2021_03_20_215802.jpg,car,29,74,320,30,240,153,1,103,183,LTAdatasets/1005/annotate/1005-2021_03_20_215802.jpg,88.5,168.0,0.2765625,0.7,0.090625,0.125
1005-2021_03_20_215802.jpg,car,33,121,320,40,240,158,1,154,198,LTAdatasets/1005/annotate/1005-2021_03_20_215802.jpg,137.5,178.0,0.4296875,0.7416666666666667,0.103125,0.16666666666666666
1005-2021_03_20_061313.jpg,bike,19,19,320,13,240,122,4,38,135,LTAdatasets/1005/annotate/1005-2021_03_20_061313.jpg,28.5,128.5,0.0890625,0.5354166666666667,0.059375,0.05416666666666667
1005-2021_03_20_061313.jpg,lorry_truck,17,134,320,11,240,68,2,151,79,LTAdatasets/1005/annotate/1005-2021_03_20_061313.jpg,142.5,73.5,0.4453125,0.30625,0.053125,0.04583333333333333
8701-2021_03_20_114851.jpg,car,35,236,640,30,360,194,1,271,224,LTAdatasets/8701/annotate/8701-2021_03_20_114851.jpg,253.5,209.0,0.39609375,0.5805555555555556,0.0546875,0.08333333333333333
8701-2021_03_20_114851.jpg,van,45,437,640,35,360,219,3,482,254,LTAdatasets/8701/annotate/8701-2021_03_20_114851.jpg,459.5,236.5,0.71796875,0.6569444444444444,0.0703125,0.09722222222222222
8701-2021_03_20_114851.jpg,van,28,472,640,28,360,186,3,500,214,LTAdatasets/8701/annotate/8701-2021_03_20_114851.jpg,486.0,200.0,0.759375,0.5555555555555556,0.04375,0.07777777777777778
8701-2021_03_20_114851.jpg,lorry_truck,37,435,640,29,360,187,2,472,216,LTAdatasets/8701/annotate/8701-2021_03_20_114851.jpg,453.5,201.5,0.70859375,0.5597222222222222,0.0578125,0.08055555555555556
8701-2021_03_20_114851.jpg,lorry_truck,23,155,640,29,360,132,2,178,161,LTAdatasets/8701/annotate/8701-2021_03_20_114851.jpg,166.5,146.5,0.26015625,0.40694444444444444,0.0359375,0.08055555555555556
8701-2021_03_20_114851.jpg,lorry_truck,19,187,640,17,360,136,2,206,153,LTAdatasets/8701/annotate/8701-2021_03_20_114851.jpg,196.5,144.5,0.30703125,0.4013888888888889,0.0296875,0.04722222222222222
8701-2021_03_20_114851.jpg,van,21,372,640,16,360,140,3,393,156,LTAdatasets/8701/annotate/8701-2021_03_20_114851.jpg,382.5,148.0,0.59765625,0.4111111111111111,0.0328125,0.044444444444444446
8701-2021_03_20_114851.jpg,lorry_truck,16,324,640,14,360,105,2,340,119,LTAdatasets/8701/annotate/8701-2021_03_20_114851.jpg,332.0,112.0,0.51875,0.3111111111111111,0.025,0.03888888888888889
8701-2021_03_20_114851.jpg,car,17,284,640,12,360,106,1,301,118,LTAdatasets/8701/annotate/8701-2021_03_20_114851.jpg,292.5,112.0,0.45703125,0.3111111111111111,0.0265625,0.03333333333333333
8701-2021_03_20_114851.jpg,car,12,205,640,12,360,119,1,217,131,LTAdatasets/8701/annotate/8701-2021_03_20_114851.jpg,211.0,125.0,0.3296875,0.3472222222222222,0.01875,0.03333333333333333
8701-2021_03_20_180110.jpg,car,36,280,640,33,360,271,1,316,304,LTAdatasets/8701/annotate/8701-2021_03_20_180110.jpg,298.0,287.5,0.465625,0.7986111111111112,0.05625,0.09166666666666666
8701-2021_03_20_180110.jpg,car,18,298,640,14,360,116,1,316,130,LTAdatasets/8701/annotate/8701-2021_03_20_180110.jpg,307.0,123.0,0.4796875,0.3416666666666667,0.028125,0.03888888888888889
8701-2021_03_20_180110.jpg,lorry_truck,18,287,640,15,360,93,2,305,108,LTAdatasets/8701/annotate/8701-2021_03_20_180110.jpg,296.0,100.5,0.4625,0.2791666666666667,0.028125,0.041666666666666664
8701-2021_03_20_180110.jpg,bike,24,570,640,33,360,254,4,594,287,LTAdatasets/8701/annotate/8701-2021_03_20_180110.jpg,582.0,270.5,0.909375,0.7513888888888889,0.0375,0.09166666666666666
8701-2021_03_20_180110.jpg,bike,9,161,640,11,360,100,4,170,111,LTAdatasets/8701/annotate/8701-2021_03_20_180110.jpg,165.5,105.5,0.25859375,0.29305555555555557,0.0140625,0.030555555555555555
8701-2021_03_20_120111.jpg,bike,27,182,640,27,360,333,4,209,360,LTAdatasets/8701/annotate/8701-2021_03_20_120111.jpg,195.5,346.5,0.30546875,0.9625,0.0421875,0.075
8701-2021_03_20_120111.jpg,lorry_truck,20,157,640,28,360,141,2,177,169,LTAdatasets/8701/annotate/8701-2021_03_20_120111.jpg,167.0,155.0,0.2609375,0.4305555555555556,0.03125,0.07777777777777778
8701-2021_03_20_120111.jpg,lorry_truck,16,161,640,22,360,109,2,177,131,LTAdatasets/8701/annotate/8701-2021_03_20_120111.jpg,169.0,120.0,0.2640625,0.3333333333333333,0.025,0.06111111111111111
8701-2021_03_20_120111.jpg,car,10,172,640,8,360,96,1,182,104,LTAdatasets/8701/annotate/8701-2021_03_20_120111.jpg,177.0,100.0,0.2765625,0.2777777777777778,0.015625,0.022222222222222223
8701-2021_03_20_120111.jpg,car,10,265,640,8,360,94,1,275,102,LTAdatasets/8701/annotate/8701-2021_03_20_120111.jpg,270.0,98.0,0.421875,0.2722222222222222,0.015625,0.022222222222222223
8701-2021_03_20_120111.jpg,lorry_truck,24,261,640,17,360,76,2,285,93,LTAdatasets/8701/annotate/8701-2021_03_20_120111.jpg,273.0,84.5,0.4265625,0.23472222222222222,0.0375,0.04722222222222222
8701-2021_03_20_120111.jpg,lorry_truck,36,541,640,15,360,86,2,577,101,LTAdatasets/8701/annotate/8701-2021_03_20_120111.jpg,559.0,93.5,0.8734375,0.25972222222222224,0.05625,0.041666666666666664
8701-2021_03_20_120111.jpg,car,16,472,640,7,360,84,1,488,91,LTAdatasets/8701/annotate/8701-2021_03_20_120111.jpg,480.0,87.5,0.75,0.24305555555555555,0.025,0.019444444444444445
8701-2021_03_20_120952.jpg,lorry_truck,29,305,640,27,360,100,2,334,127,LTAdatasets/8701/annotate/8701-2021_03_20_120952.jpg,319.5,113.5,0.49921875,0.31527777777777777,0.0453125,0.075
8701-2021_03_20_120952.jpg,van,12,275,640,10,360,100,3,287,110,LTAdatasets/8701/annotate/8701-2021_03_20_120952.jpg,281.0,105.0,0.4390625,0.2916666666666667,0.01875,0.027777777777777776
8701-2021_03_20_120952.jpg,lorry_truck,69,213,640,127,360,233,2,282,360,LTAdatasets/8701/annotate/8701-2021_03_20_120952.jpg,247.5,296.5,0.38671875,0.8236111111111111,0.1078125,0.3527777777777778
8701-2021_03_20_120952.jpg,lorry_truck,54,156,640,57,360,303,2,210,360,LTAdatasets/8701/annotate/8701-2021_03_20_120952.jpg,183.0,331.5,0.2859375,0.9208333333333333,0.084375,0.15833333333333333
8701-2021_03_20_120952.jpg,car,18,612,640,11,360,103,1,630,114,LTAdatasets/8701/annotate/8701-2021_03_20_120952.jpg,621.0,108.5,0.9703125,0.3013888888888889,0.028125,0.030555555555555555
8701-2021_03_20_120952.jpg,lorry_truck,17,561,640,10,360,93,2,578,103,LTAdatasets/8701/annotate/8701-2021_03_20_120952.jpg,569.5,98.0,0.88984375,0.2722222222222222,0.0265625,0.027777777777777776
8701-2021_03_20_115812.jpg,van,36,267,640,47,360,250,3,303,297,LTAdatasets/8701/annotate/8701-2021_03_20_115812.jpg,285.0,273.5,0.4453125,0.7597222222222222,0.05625,0.13055555555555556
8701-2021_03_20_115812.jpg,lorry_truck,27,163,640,41,360,173,2,190,214,LTAdatasets/8701/annotate/8701-2021_03_20_115812.jpg,176.5,193.5,0.27578125,0.5375,0.0421875,0.11388888888888889
8701-2021_03_20_115812.jpg,lorry_truck,48,371,640,46,360,134,2,419,180,LTAdatasets/8701/annotate/8701-2021_03_20_115812.jpg,395.0,157.0,0.6171875,0.4361111111111111,0.075,0.12777777777777777
8701-2021_03_20_115812.jpg,car,18,220,640,16,360,154,1,238,170,LTAdatasets/8701/annotate/8701-2021_03_20_115812.jpg,229.0,162.0,0.3578125,0.45,0.028125,0.044444444444444446
8701-2021_03_20_115812.jpg,car,17,237,640,12,360,135,1,254,147,LTAdatasets/8701/annotate/8701-2021_03_20_115812.jpg,245.5,141.0,0.38359375,0.39166666666666666,0.0265625,0.03333333333333333
8701-2021_03_20_115812.jpg,bike,11,202,640,20,360,178,4,213,198,LTAdatasets/8701/annotate/8701-2021_03_20_115812.jpg,207.5,188.0,0.32421875,0.5222222222222223,0.0171875,0.05555555555555555
8701-2021_03_20_115812.jpg,car,14,196,640,13,360,103,1,210,116,LTAdatasets/8701/annotate/8701-2021_03_20_115812.jpg,203.0,109.5,0.3171875,0.30416666666666664,0.021875,0.03611111111111111
8701-2021_03_20_122813.jpg,car,10,166,640,13,360,141,1,176,154,LTAdatasets/8701/annotate/8701-2021_03_20_122813.jpg,171.0,147.5,0.2671875,0.4097222222222222,0.015625,0.03611111111111111
8701-2021_03_20_122813.jpg,car,12,159,640,11,360,115,1,171,126,LTAdatasets/8701/annotate/8701-2021_03_20_122813.jpg,165.0,120.5,0.2578125,0.3347222222222222,0.01875,0.030555555555555555
8701-2021_03_20_122813.jpg,car,12,214,640,9,360,104,1,226,113,LTAdatasets/8701/annotate/8701-2021_03_20_122813.jpg,220.0,108.5,0.34375,0.3013888888888889,0.01875,0.025
8701-2021_03_20_122813.jpg,car,10,207,640,8,360,93,1,217,101,LTAdatasets/8701/annotate/8701-2021_03_20_122813.jpg,212.0,97.0,0.33125,0.26944444444444443,0.015625,0.022222222222222223
8701-2021_03_20_183112.jpg,lorry_truck,60,509,640,61,360,273,2,569,334,LTAdatasets/8701/annotate/8701-2021_03_20_183112.jpg,539.0,303.5,0.8421875,0.8430555555555556,0.09375,0.16944444444444445
8701-2021_03_20_183112.jpg,lorry_truck,33,193,640,34,360,169,2,226,203,LTAdatasets/8701/annotate/8701-2021_03_20_183112.jpg,209.5,186.0,0.32734375,0.5166666666666667,0.0515625,0.09444444444444444
8701-2021_03_20_183112.jpg,lorry_truck,34,158,640,48,360,207,2,192,255,LTAdatasets/8701/annotate/8701-2021_03_20_183112.jpg,175.0,231.0,0.2734375,0.6416666666666667,0.053125,0.13333333333333333
8701-2021_03_20_183112.jpg,car,16,237,640,12,360,137,1,253,149,LTAdatasets/8701/annotate/8701-2021_03_20_183112.jpg,245.0,143.0,0.3828125,0.3972222222222222,0.025,0.03333333333333333
8701-2021_03_20_183112.jpg,bus,22,156,640,32,360,122,5,178,154,LTAdatasets/8701/annotate/8701-2021_03_20_183112.jpg,167.0,138.0,0.2609375,0.38333333333333336,0.034375,0.08888888888888889
8701-2021_03_20_183112.jpg,bus,17,179,640,20,360,91,5,196,111,LTAdatasets/8701/annotate/8701-2021_03_20_183112.jpg,187.5,101.0,0.29296875,0.28055555555555556,0.0265625,0.05555555555555555
8701-2021_03_20_110348.jpg,bus,19,278,640,22,360,80,5,297,102,LTAdatasets/8701/annotate/8701-2021_03_20_110348.jpg,287.5,91.0,0.44921875,0.25277777777777777,0.0296875,0.06111111111111111
8701-2021_03_20_110348.jpg,lorry_truck,40,386,640,35,360,148,2,426,183,LTAdatasets/8701/annotate/8701-2021_03_20_110348.jpg,406.0,165.5,0.634375,0.4597222222222222,0.0625,0.09722222222222222
8701-2021_03_20_110348.jpg,lorry_truck,54,462,640,50,360,196,2,516,246,LTAdatasets/8701/annotate/8701-2021_03_20_110348.jpg,489.0,221.0,0.7640625,0.6138888888888889,0.084375,0.1388888888888889
8701-2021_03_20_110348.jpg,car,24,351,640,20,360,154,1,375,174,LTAdatasets/8701/annotate/8701-2021_03_20_110348.jpg,363.0,164.0,0.5671875,0.45555555555555555,0.0375,0.05555555555555555
8701-2021_03_20_110348.jpg,car,21,161,640,16,360,140,1,182,156,LTAdatasets/8701/annotate/8701-2021_03_20_110348.jpg,171.5,148.0,0.26796875,0.4111111111111111,0.0328125,0.044444444444444446
8701-2021_03_20_110348.jpg,lorry_truck,16,159,640,17,360,91,2,175,108,LTAdatasets/8701/annotate/8701-2021_03_20_110348.jpg,167.0,99.5,0.2609375,0.2763888888888889,0.025,0.04722222222222222
8701-2021_03_20_182752.jpg,bus,95,483,640,73,360,191,5,578,264,LTAdatasets/8701/annotate/8701-2021_03_20_182752.jpg,530.5,227.5,0.82890625,0.6319444444444444,0.1484375,0.20277777777777778
8701-2021_03_20_182752.jpg,car,31,385,640,28,360,214,1,416,242,LTAdatasets/8701/annotate/8701-2021_03_20_182752.jpg,400.5,228.0,0.62578125,0.6333333333333333,0.0484375,0.07777777777777778
8701-2021_03_20_182752.jpg,car,24,390,640,23,360,181,1,414,204,LTAdatasets/8701/annotate/8701-2021_03_20_182752.jpg,402.0,192.5,0.628125,0.5347222222222222,0.0375,0.06388888888888888
8701-2021_03_20_182752.jpg,lorry_truck,21,372,640,20,360,135,2,393,155,LTAdatasets/8701/annotate/8701-2021_03_20_182752.jpg,382.5,145.0,0.59765625,0.4027777777777778,0.0328125,0.05555555555555555
8701-2021_03_20_182752.jpg,lorry_truck,25,196,640,28,360,191,2,221,219,LTAdatasets/8701/annotate/8701-2021_03_20_182752.jpg,208.5,205.0,0.32578125,0.5694444444444444,0.0390625,0.07777777777777778
8701-2021_03_20_182752.jpg,lorry_truck,20,189,640,22,360,137,2,209,159,LTAdatasets/8701/annotate/8701-2021_03_20_182752.jpg,199.0,148.0,0.3109375,0.4111111111111111,0.03125,0.06111111111111111
8701-2021_03_20_182752.jpg,van,15,204,640,15,360,112,3,219,127,LTAdatasets/8701/annotate/8701-2021_03_20_182752.jpg,211.5,119.5,0.33046875,0.33194444444444443,0.0234375,0.041666666666666664
8701-2021_03_20_182752.jpg,van,23,224,640,26,360,156,3,247,182,LTAdatasets/8701/annotate/8701-2021_03_20_182752.jpg,235.5,169.0,0.36796875,0.46944444444444444,0.0359375,0.07222222222222222
8701-2021_03_20_182752.jpg,lorry_truck,17,305,640,14,360,109,2,322,123,LTAdatasets/8701/annotate/8701-2021_03_20_182752.jpg,313.5,116.0,0.48984375,0.32222222222222224,0.0265625,0.03888888888888889
8701-2021_03_20_182752.jpg,lorry_truck,10,173,640,11,360,96,2,183,107,LTAdatasets/8701/annotate/8701-2021_03_20_182752.jpg,178.0,101.5,0.278125,0.28194444444444444,0.015625,0.030555555555555555
8701-2021_03_20_182752.jpg,van,12,181,640,15,360,104,3,193,119,LTAdatasets/8701/annotate/8701-2021_03_20_182752.jpg,187.0,111.5,0.2921875,0.30972222222222223,0.01875,0.041666666666666664
8701-2021_03_20_182752.jpg,car,20,519,640,13,360,91,1,539,104,LTAdatasets/8701/annotate/8701-2021_03_20_182752.jpg,529.0,97.5,0.8265625,0.2708333333333333,0.03125,0.03611111111111111
8701-2021_03_20_101005.jpg,lorry_truck,29,365,640,28,360,135,2,394,163,LTAdatasets/8701/annotate/8701-2021_03_20_101005.jpg,379.5,149.0,0.59296875,0.41388888888888886,0.0453125,0.07777777777777778
8701-2021_03_20_101005.jpg,car,23,348,640,18,360,152,1,371,170,LTAdatasets/8701/annotate/8701-2021_03_20_101005.jpg,359.5,161.0,0.56171875,0.44722222222222224,0.0359375,0.05
8701-2021_03_20_101005.jpg,car,19,310,640,15,360,109,1,329,124,LTAdatasets/8701/annotate/8701-2021_03_20_101005.jpg,319.5,116.5,0.49921875,0.3236111111111111,0.0296875,0.041666666666666664
8701-2021_03_20_105508.jpg,car,32,180,640,34,360,263,1,212,297,LTAdatasets/8701/annotate/8701-2021_03_20_105508.jpg,196.0,280.0,0.30625,0.7777777777777778,0.05,0.09444444444444444
8701-2021_03_20_105508.jpg,car,24,159,640,20,360,169,1,183,189,LTAdatasets/8701/annotate/8701-2021_03_20_105508.jpg,171.0,179.0,0.2671875,0.49722222222222223,0.0375,0.05555555555555555
8701-2021_03_20_105508.jpg,bike,9,191,640,13,360,106,4,200,119,LTAdatasets/8701/annotate/8701-2021_03_20_105508.jpg,195.5,112.5,0.30546875,0.3125,0.0140625,0.03611111111111111
8701-2021_03_20_105508.jpg,car,11,193,640,9,360,93,1,204,102,LTAdatasets/8701/annotate/8701-2021_03_20_105508.jpg,198.5,97.5,0.31015625,0.2708333333333333,0.0171875,0.025
8701-2021_03_20_113950.jpg,van,24,204,640,23,360,196,3,228,219,LTAdatasets/8701/annotate/8701-2021_03_20_113950.jpg,216.0,207.5,0.3375,0.5763888888888888,0.0375,0.06388888888888888
8701-2021_03_20_113950.jpg,car,23,238,640,22,360,189,1,261,211,LTAdatasets/8701/annotate/8701-2021_03_20_113950.jpg,249.5,200.0,0.38984375,0.5555555555555556,0.0359375,0.06111111111111111
8701-2021_03_20_113950.jpg,car,17,160,640,14,360,146,1,177,160,LTAdatasets/8701/annotate/8701-2021_03_20_113950.jpg,168.5,153.0,0.26328125,0.425,0.0265625,0.03888888888888889
8701-2021_03_20_113950.jpg,car,15,207,640,14,360,129,1,222,143,LTAdatasets/8701/annotate/8701-2021_03_20_113950.jpg,214.5,136.0,0.33515625,0.37777777777777777,0.0234375,0.03888888888888889
8701-2021_03_20_113950.jpg,car,12,189,640,11,360,86,1,201,97,LTAdatasets/8701/annotate/8701-2021_03_20_113950.jpg,195.0,91.5,0.3046875,0.25416666666666665,0.01875,0.030555555555555555
8701-2021_03_20_112209.jpg,car,23,340,640,18,360,150,1,363,168,LTAdatasets/8701/annotate/8701-2021_03_20_112209.jpg,351.5,159.0,0.54921875,0.44166666666666665,0.0359375,0.05
8701-2021_03_20_112209.jpg,car,24,235,640,18,360,187,1,259,205,LTAdatasets/8701/annotate/8701-2021_03_20_112209.jpg,247.0,196.0,0.3859375,0.5444444444444444,0.0375,0.05
8701-2021_03_20_112209.jpg,car,29,193,640,31,360,253,1,222,284,LTAdatasets/8701/annotate/8701-2021_03_20_112209.jpg,207.5,268.5,0.32421875,0.7458333333333333,0.0453125,0.08611111111111111
8701-2021_03_20_112209.jpg,bike,29,597,640,35,360,307,4,626,342,LTAdatasets/8701/annotate/8701-2021_03_20_112209.jpg,611.5,324.5,0.95546875,0.9013888888888889,0.0453125,0.09722222222222222
8701-2021_03_20_112209.jpg,lorry_truck,57,397,640,47,360,163,2,454,210,LTAdatasets/8701/annotate/8701-2021_03_20_112209.jpg,425.5,186.5,0.66484375,0.5180555555555556,0.0890625,0.13055555555555556
8701-2021_03_20_112209.jpg,lorry_truck,24,156,640,27,360,126,2,180,153,LTAdatasets/8701/annotate/8701-2021_03_20_112209.jpg,168.0,139.5,0.2625,0.3875,0.0375,0.075
8701-2021_03_20_112209.jpg,car,13,175,640,11,360,95,1,188,106,LTAdatasets/8701/annotate/8701-2021_03_20_112209.jpg,181.5,100.5,0.28359375,0.2791666666666667,0.0203125,0.030555555555555555
8701-2021_03_20_123333.jpg,bike,8,164,640,10,360,100,4,172,110,LTAdatasets/8701/annotate/8701-2021_03_20_123333.jpg,168.0,105.0,0.2625,0.2916666666666667,0.0125,0.027777777777777776
8701-2021_03_20_123333.jpg,bike,11,269,640,10,360,96,4,280,106,LTAdatasets/8701/annotate/8701-2021_03_20_123333.jpg,274.5,101.0,0.42890625,0.28055555555555556,0.0171875,0.027777777777777776
8701-2021_03_20_103107.jpg,car,52,328,640,48,360,278,1,380,326,LTAdatasets/8701/annotate/8701-2021_03_20_103107.jpg,354.0,302.0,0.553125,0.8388888888888889,0.08125,0.13333333333333333
8701-2021_03_20_103107.jpg,car,28,373,640,25,360,177,1,401,202,LTAdatasets/8701/annotate/8701-2021_03_20_103107.jpg,387.0,189.5,0.6046875,0.5263888888888889,0.04375,0.06944444444444445
8701-2021_03_20_103107.jpg,car,15,318,640,13,360,131,1,333,144,LTAdatasets/8701/annotate/8701-2021_03_20_103107.jpg,325.5,137.5,0.50859375,0.3819444444444444,0.0234375,0.03611111111111111
8701-2021_03_20_103107.jpg,lorry_truck,36,355,640,27,360,119,2,391,146,LTAdatasets/8701/annotate/8701-2021_03_20_103107.jpg,373.0,132.5,0.5828125,0.3680555555555556,0.05625,0.075
8701-2021_03_20_103107.jpg,lorry_truck,39,407,640,42,360,157,2,446,199,LTAdatasets/8701/annotate/8701-2021_03_20_103107.jpg,426.5,178.0,0.66640625,0.49444444444444446,0.0609375,0.11666666666666667
8701-2021_03_20_103107.jpg,lorry_truck,25,304,640,26,360,93,2,329,119,LTAdatasets/8701/annotate/8701-2021_03_20_103107.jpg,316.5,106.0,0.49453125,0.29444444444444445,0.0390625,0.07222222222222222
8701-2021_03_20_180410.jpg,car,16,218,640,16,360,148,1,234,164,LTAdatasets/8701/annotate/8701-2021_03_20_180410.jpg,226.0,156.0,0.353125,0.43333333333333335,0.025,0.044444444444444446
8701-2021_03_20_180410.jpg,car,11,162,640,11,360,106,1,173,117,LTAdatasets/8701/annotate/8701-2021_03_20_180410.jpg,167.5,111.5,0.26171875,0.30972222222222223,0.0171875,0.030555555555555555
8701-2021_03_20_101546.jpg,car,45,505,640,43,360,278,1,550,321,LTAdatasets/8701/annotate/8701-2021_03_20_101546.jpg,527.5,299.5,0.82421875,0.8319444444444445,0.0703125,0.11944444444444445
8701-2021_03_20_101546.jpg,car,16,190,640,12,360,141,1,206,153,LTAdatasets/8701/annotate/8701-2021_03_20_101546.jpg,198.0,147.0,0.309375,0.4083333333333333,0.025,0.03333333333333333
8701-2021_03_20_101546.jpg,car,38,289,640,42,360,294,1,327,336,LTAdatasets/8701/annotate/8701-2021_03_20_101546.jpg,308.0,315.0,0.48125,0.875,0.059375,0.11666666666666667
8701-2021_03_20_101546.jpg,lorry_truck,40,208,640,47,360,200,2,248,247,LTAdatasets/8701/annotate/8701-2021_03_20_101546.jpg,228.0,223.5,0.35625,0.6208333333333333,0.0625,0.13055555555555556
8701-2021_03_20_101546.jpg,lorry_truck,33,158,640,40,360,172,2,191,212,LTAdatasets/8701/annotate/8701-2021_03_20_101546.jpg,174.5,192.0,0.27265625,0.5333333333333333,0.0515625,0.1111111111111111
8701-2021_03_20_101546.jpg,lorry_truck,23,151,640,31,360,130,2,174,161,LTAdatasets/8701/annotate/8701-2021_03_20_101546.jpg,162.5,145.5,0.25390625,0.4041666666666667,0.0359375,0.08611111111111111
8701-2021_03_20_101546.jpg,lorry_truck,21,179,640,34,360,99,2,200,133,LTAdatasets/8701/annotate/8701-2021_03_20_101546.jpg,189.5,116.0,0.29609375,0.32222222222222224,0.0328125,0.09444444444444444
8701-2021_03_20_101546.jpg,lorry_truck,17,159,640,18,360,97,2,176,115,LTAdatasets/8701/annotate/8701-2021_03_20_101546.jpg,167.5,106.0,0.26171875,0.29444444444444445,0.0265625,0.05
8701-2021_03_20_102506.jpg,lorry_truck,77,378,640,71,360,134,2,455,205,LTAdatasets/8701/annotate/8701-2021_03_20_102506.jpg,416.5,169.5,0.65078125,0.4708333333333333,0.1203125,0.19722222222222222
8701-2021_03_20_102506.jpg,car,26,346,640,18,360,154,1,372,172,LTAdatasets/8701/annotate/8701-2021_03_20_102506.jpg,359.0,163.0,0.5609375,0.4527777777777778,0.040625,0.05
8701-2021_03_20_102506.jpg,bike,16,180,640,13,360,127,4,196,140,LTAdatasets/8701/annotate/8701-2021_03_20_102506.jpg,188.0,133.5,0.29375,0.37083333333333335,0.025,0.03611111111111111
8701-2021_03_20_102506.jpg,car,9,204,640,8,360,85,1,213,93,LTAdatasets/8701/annotate/8701-2021_03_20_102506.jpg,208.5,89.0,0.32578125,0.24722222222222223,0.0140625,0.022222222222222223
8701-2021_03_20_123113.jpg,bus,88,533,640,76,360,214,5,621,290,LTAdatasets/8701/annotate/8701-2021_03_20_123113.jpg,577.0,252.0,0.9015625,0.7,0.1375,0.2111111111111111
8701-2021_03_20_123113.jpg,van,26,385,640,21,360,150,3,411,171,LTAdatasets/8701/annotate/8701-2021_03_20_123113.jpg,398.0,160.5,0.621875,0.44583333333333336,0.040625,0.058333333333333334
8701-2021_03_20_123113.jpg,bike,17,168,640,26,360,250,4,185,276,LTAdatasets/8701/annotate/8701-2021_03_20_123113.jpg,176.5,263.0,0.27578125,0.7305555555555555,0.0265625,0.07222222222222222
8701-2021_03_20_123113.jpg,van,30,570,640,19,360,91,3,600,110,LTAdatasets/8701/annotate/8701-2021_03_20_123113.jpg,585.0,100.5,0.9140625,0.2791666666666667,0.046875,0.05277777777777778
8701-2021_03_20_123113.jpg,car,15,177,640,15,360,115,1,192,130,LTAdatasets/8701/annotate/8701-2021_03_20_123113.jpg,184.5,122.5,0.28828125,0.3402777777777778,0.0234375,0.041666666666666664
8701-2021_03_20_123113.jpg,bike,11,206,640,8,360,97,4,217,105,LTAdatasets/8701/annotate/8701-2021_03_20_123113.jpg,211.5,101.0,0.33046875,0.28055555555555556,0.0171875,0.022222222222222223
8701-2021_03_20_123113.jpg,car,8,254,640,7,360,85,1,262,92,LTAdatasets/8701/annotate/8701-2021_03_20_123113.jpg,258.0,88.5,0.403125,0.24583333333333332,0.0125,0.019444444444444445
8701-2021_03_20_195136.jpg,van,40,170,640,51,360,276,3,210,327,LTAdatasets/8701/annotate/8701-2021_03_20_195136.jpg,190.0,301.5,0.296875,0.8375,0.0625,0.14166666666666666
8701-2021_03_20_195136.jpg,bike,10,242,640,16,360,150,4,252,166,LTAdatasets/8701/annotate/8701-2021_03_20_195136.jpg,247.0,158.0,0.3859375,0.4388888888888889,0.015625,0.044444444444444446
8701-2021_03_20_195136.jpg,bike,12,326,640,17,360,123,4,338,140,LTAdatasets/8701/annotate/8701-2021_03_20_195136.jpg,332.0,131.5,0.51875,0.36527777777777776,0.01875,0.04722222222222222
8701-2021_03_20_195136.jpg,bike,7,217,640,11,360,107,4,224,118,LTAdatasets/8701/annotate/8701-2021_03_20_195136.jpg,220.5,112.5,0.34453125,0.3125,0.0109375,0.030555555555555555
8701-2021_03_20_195136.jpg,bike,10,204,640,12,360,112,4,214,124,LTAdatasets/8701/annotate/8701-2021_03_20_195136.jpg,209.0,118.0,0.3265625,0.3277777777777778,0.015625,0.03333333333333333
8701-2021_03_20_195136.jpg,lorry_truck,37,444,640,36,360,192,2,481,228,LTAdatasets/8701/annotate/8701-2021_03_20_195136.jpg,462.5,210.0,0.72265625,0.5833333333333334,0.0578125,0.1
8701-2021_03_20_195136.jpg,lorry_truck,52,524,640,36,360,227,2,576,263,LTAdatasets/8701/annotate/8701-2021_03_20_195136.jpg,550.0,245.0,0.859375,0.6805555555555556,0.08125,0.1
8701-2021_03_20_195136.jpg,lorry_truck,48,446,640,37,360,237,2,494,274,LTAdatasets/8701/annotate/8701-2021_03_20_195136.jpg,470.0,255.5,0.734375,0.7097222222222223,0.075,0.10277777777777777
8701-2021_03_20_195136.jpg,car,14,193,640,12,360,131,1,207,143,LTAdatasets/8701/annotate/8701-2021_03_20_195136.jpg,200.0,137.0,0.3125,0.38055555555555554,0.021875,0.03333333333333333
8701-2021_03_20_195136.jpg,car,12,281,640,10,360,84,1,293,94,LTAdatasets/8701/annotate/8701-2021_03_20_195136.jpg,287.0,89.0,0.4484375,0.24722222222222223,0.01875,0.027777777777777776
8701-2021_03_20_195136.jpg,car,44,243,640,36,360,324,1,287,360,LTAdatasets/8701/annotate/8701-2021_03_20_195136.jpg,265.0,342.0,0.4140625,0.95,0.06875,0.1
8701-2021_03_20_123953.jpg,lorry_truck,27,189,640,31,360,157,2,216,188,LTAdatasets/8701/annotate/8701-2021_03_20_123953.jpg,202.5,172.5,0.31640625,0.4791666666666667,0.0421875,0.08611111111111111
8701-2021_03_20_123953.jpg,van,17,341,640,19,360,127,3,358,146,LTAdatasets/8701/annotate/8701-2021_03_20_123953.jpg,349.5,136.5,0.54609375,0.37916666666666665,0.0265625,0.05277777777777778
8701-2021_03_20_123953.jpg,car,16,293,640,12,360,113,1,309,125,LTAdatasets/8701/annotate/8701-2021_03_20_123953.jpg,301.0,119.0,0.4703125,0.33055555555555555,0.025,0.03333333333333333
8701-2021_03_20_123953.jpg,van,11,195,640,12,360,98,3,206,110,LTAdatasets/8701/annotate/8701-2021_03_20_123953.jpg,200.5,104.0,0.31328125,0.28888888888888886,0.0171875,0.03333333333333333
8701-2021_03_20_123953.jpg,van,9,179,640,11,360,98,3,188,109,LTAdatasets/8701/annotate/8701-2021_03_20_123953.jpg,183.5,103.5,0.28671875,0.2875,0.0140625,0.030555555555555555
8701-2021_03_20_110128.jpg,bike,27,572,640,34,360,311,4,599,345,LTAdatasets/8701/annotate/8701-2021_03_20_110128.jpg,585.5,328.0,0.91484375,0.9111111111111111,0.0421875,0.09444444444444444
8701-2021_03_20_110128.jpg,bike,15,466,640,22,360,186,4,481,208,LTAdatasets/8701/annotate/8701-2021_03_20_110128.jpg,473.5,197.0,0.73984375,0.5472222222222223,0.0234375,0.06111111111111111
8701-2021_03_20_110128.jpg,lorry_truck,17,188,640,18,360,139,2,205,157,LTAdatasets/8701/annotate/8701-2021_03_20_110128.jpg,196.5,148.0,0.30703125,0.4111111111111111,0.0265625,0.05
8701-2021_03_20_110128.jpg,lorry_truck,43,150,640,50,360,194,2,193,244,LTAdatasets/8701/annotate/8701-2021_03_20_110128.jpg,171.5,219.0,0.26796875,0.6083333333333333,0.0671875,0.1388888888888889
8701-2021_03_20_110128.jpg,van,33,607,640,55,360,303,3,640,358,LTAdatasets/8701/annotate/8701-2021_03_20_110128.jpg,623.5,330.5,0.97421875,0.9180555555555555,0.0515625,0.1527777777777778
8701-2021_03_20_110128.jpg,car,20,216,640,17,360,135,1,236,152,LTAdatasets/8701/annotate/8701-2021_03_20_110128.jpg,226.0,143.5,0.353125,0.39861111111111114,0.03125,0.04722222222222222
8701-2021_03_20_110128.jpg,car,15,305,640,13,360,105,1,320,118,LTAdatasets/8701/annotate/8701-2021_03_20_110128.jpg,312.5,111.5,0.48828125,0.30972222222222223,0.0234375,0.03611111111111111
8701-2021_03_20_110128.jpg,van,12,293,640,14,360,106,3,305,120,LTAdatasets/8701/annotate/8701-2021_03_20_110128.jpg,299.0,113.0,0.4671875,0.3138888888888889,0.01875,0.03888888888888889
8701-2021_03_20_110128.jpg,van,14,279,640,9,360,93,3,293,102,LTAdatasets/8701/annotate/8701-2021_03_20_110128.jpg,286.0,97.5,0.446875,0.2708333333333333,0.021875,0.025
8701-2021_03_20_184613.jpg,bike,12,329,640,15,360,144,4,341,159,LTAdatasets/8701/annotate/8701-2021_03_20_184613.jpg,335.0,151.5,0.5234375,0.42083333333333334,0.01875,0.041666666666666664
8701-2021_03_20_184613.jpg,car,27,376,640,30,360,167,1,403,197,LTAdatasets/8701/annotate/8701-2021_03_20_184613.jpg,389.5,182.0,0.60859375,0.5055555555555555,0.0421875,0.08333333333333333
8701-2021_03_20_184613.jpg,car,35,463,640,29,360,242,1,498,271,LTAdatasets/8701/annotate/8701-2021_03_20_184613.jpg,480.5,256.5,0.75078125,0.7125,0.0546875,0.08055555555555556
8701-2021_03_20_184613.jpg,van,16,297,640,18,360,99,3,313,117,LTAdatasets/8701/annotate/8701-2021_03_20_184613.jpg,305.0,108.0,0.4765625,0.3,0.025,0.05
8701-2021_03_20_184613.jpg,lorry_truck,22,200,640,26,360,175,2,222,201,LTAdatasets/8701/annotate/8701-2021_03_20_184613.jpg,211.0,188.0,0.3296875,0.5222222222222223,0.034375,0.07222222222222222
8701-2021_03_20_184613.jpg,lorry_truck,24,157,640,25,360,143,2,181,168,LTAdatasets/8701/annotate/8701-2021_03_20_184613.jpg,169.0,155.5,0.2640625,0.43194444444444446,0.0375,0.06944444444444445
8701-2021_03_20_184613.jpg,lorry_truck,14,180,640,13,360,117,2,194,130,LTAdatasets/8701/annotate/8701-2021_03_20_184613.jpg,187.0,123.5,0.2921875,0.34305555555555556,0.021875,0.03611111111111111
8701-2021_03_20_184613.jpg,lorry_truck,12,159,640,12,360,91,2,171,103,LTAdatasets/8701/annotate/8701-2021_03_20_184613.jpg,165.0,97.0,0.2578125,0.26944444444444443,0.01875,0.03333333333333333
8701-2021_03_20_184613.jpg,lorry_truck,10,178,640,12,360,89,2,188,101,LTAdatasets/8701/annotate/8701-2021_03_20_184613.jpg,183.0,95.0,0.2859375,0.2638888888888889,0.015625,0.03333333333333333
8701-2021_03_20_194315.jpg,lorry_truck,46,464,640,41,360,219,2,510,260,LTAdatasets/8701/annotate/8701-2021_03_20_194315.jpg,487.0,239.5,0.7609375,0.6652777777777777,0.071875,0.11388888888888889
8701-2021_03_20_194315.jpg,lorry_truck,40,456,640,32,360,179,2,496,211,LTAdatasets/8701/annotate/8701-2021_03_20_194315.jpg,476.0,195.0,0.74375,0.5416666666666666,0.0625,0.08888888888888889
8701-2021_03_20_194315.jpg,lorry_truck,21,370,640,20,360,133,2,391,153,LTAdatasets/8701/annotate/8701-2021_03_20_194315.jpg,380.5,143.0,0.59453125,0.3972222222222222,0.0328125,0.05555555555555555
8701-2021_03_20_194315.jpg,car,20,370,640,15,360,154,1,390,169,LTAdatasets/8701/annotate/8701-2021_03_20_194315.jpg,380.0,161.5,0.59375,0.4486111111111111,0.03125,0.041666666666666664
8701-2021_03_20_194315.jpg,car,21,190,640,20,360,152,1,211,172,LTAdatasets/8701/annotate/8701-2021_03_20_194315.jpg,200.5,162.0,0.31328125,0.45,0.0328125,0.05555555555555555
8701-2021_03_20_194315.jpg,car,15,164,640,12,360,134,1,179,146,LTAdatasets/8701/annotate/8701-2021_03_20_194315.jpg,171.5,140.0,0.26796875,0.3888888888888889,0.0234375,0.03333333333333333
8701-2021_03_20_194315.jpg,car,13,293,640,12,360,112,1,306,124,LTAdatasets/8701/annotate/8701-2021_03_20_194315.jpg,299.5,118.0,0.46796875,0.3277777777777778,0.0203125,0.03333333333333333
8701-2021_03_20_194315.jpg,lorry_truck,15,294,640,16,360,87,2,309,103,LTAdatasets/8701/annotate/8701-2021_03_20_194315.jpg,301.5,95.0,0.47109375,0.2638888888888889,0.0234375,0.044444444444444446
8701-2021_03_20_112750.jpg,lorry_truck,26,411,640,27,360,146,2,437,173,LTAdatasets/8701/annotate/8701-2021_03_20_112750.jpg,424.0,159.5,0.6625,0.44305555555555554,0.040625,0.075
8701-2021_03_20_112750.jpg,lorry_truck,28,379,640,26,360,147,2,407,173,LTAdatasets/8701/annotate/8701-2021_03_20_112750.jpg,393.0,160.0,0.6140625,0.4444444444444444,0.04375,0.07222222222222222
8701-2021_03_20_112750.jpg,car,24,353,640,23,360,157,1,377,180,LTAdatasets/8701/annotate/8701-2021_03_20_112750.jpg,365.0,168.5,0.5703125,0.46805555555555556,0.0375,0.06388888888888888
8701-2021_03_20_112750.jpg,lorry_truck,23,327,640,20,360,113,2,350,133,LTAdatasets/8701/annotate/8701-2021_03_20_112750.jpg,338.5,123.0,0.52890625,0.3416666666666667,0.0359375,0.05555555555555555
8701-2021_03_20_200637.jpg,lorry_truck,19,212,640,16,360,136,2,231,152,LTAdatasets/8701/annotate/8701-2021_03_20_200637.jpg,221.5,144.0,0.34609375,0.4,0.0296875,0.044444444444444446
8701-2021_03_20_200637.jpg,car,17,226,640,12,360,120,1,243,132,LTAdatasets/8701/annotate/8701-2021_03_20_200637.jpg,234.5,126.0,0.36640625,0.35,0.0265625,0.03333333333333333
8701-2021_03_20_200637.jpg,lorry_truck,16,307,640,12,360,109,2,323,121,LTAdatasets/8701/annotate/8701-2021_03_20_200637.jpg,315.0,115.0,0.4921875,0.3194444444444444,0.025,0.03333333333333333
8701-2021_03_20_181551.jpg,car,56,533,640,55,360,302,1,589,357,LTAdatasets/8701/annotate/8701-2021_03_20_181551.jpg,561.0,329.5,0.8765625,0.9152777777777777,0.0875,0.1527777777777778
8701-2021_03_20_181551.jpg,car,39,268,640,30,360,257,1,307,287,LTAdatasets/8701/annotate/8701-2021_03_20_181551.jpg,287.5,272.0,0.44921875,0.7555555555555555,0.0609375,0.08333333333333333
8701-2021_03_20_181551.jpg,bike,11,333,640,14,360,126,4,344,140,LTAdatasets/8701/annotate/8701-2021_03_20_181551.jpg,338.5,133.0,0.52890625,0.36944444444444446,0.0171875,0.03888888888888889
8701-2021_03_20_181551.jpg,bike,12,235,640,17,360,133,4,247,150,LTAdatasets/8701/annotate/8701-2021_03_20_181551.jpg,241.0,141.5,0.3765625,0.39305555555555555,0.01875,0.04722222222222222
8701-2021_03_20_181551.jpg,car,17,286,640,15,360,105,1,303,120,LTAdatasets/8701/annotate/8701-2021_03_20_181551.jpg,294.5,112.5,0.46015625,0.3125,0.0265625,0.041666666666666664
8701-2021_03_20_181551.jpg,lorry_truck,20,159,640,20,360,108,2,179,128,LTAdatasets/8701/annotate/8701-2021_03_20_181551.jpg,169.0,118.0,0.2640625,0.3277777777777778,0.03125,0.05555555555555555
8701-2021_03_20_181551.jpg,lorry_truck,18,267,640,17,360,83,2,285,100,LTAdatasets/8701/annotate/8701-2021_03_20_181551.jpg,276.0,91.5,0.43125,0.25416666666666665,0.028125,0.04722222222222222
8701-2021_03_20_195736.jpg,lorry_truck,42,435,640,31,360,172,2,477,203,LTAdatasets/8701/annotate/8701-2021_03_20_195736.jpg,456.0,187.5,0.7125,0.5208333333333334,0.065625,0.08611111111111111
8701-2021_03_20_195736.jpg,van,26,552,640,16,360,91,3,578,107,LTAdatasets/8701/annotate/8701-2021_03_20_195736.jpg,565.0,99.0,0.8828125,0.275,0.040625,0.044444444444444446
8701-2021_03_20_195736.jpg,van,35,164,640,43,360,221,3,199,264,LTAdatasets/8701/annotate/8701-2021_03_20_195736.jpg,181.5,242.5,0.28359375,0.6736111111111112,0.0546875,0.11944444444444445
8701-2021_03_20_195736.jpg,van,11,165,640,12,360,103,3,176,115,LTAdatasets/8701/annotate/8701-2021_03_20_195736.jpg,170.5,109.0,0.26640625,0.30277777777777776,0.0171875,0.03333333333333333
8701-2021_03_20_195736.jpg,bus,21,277,640,21,360,84,5,298,105,LTAdatasets/8701/annotate/8701-2021_03_20_195736.jpg,287.5,94.5,0.44921875,0.2625,0.0328125,0.058333333333333334
8701-2021_03_20_195736.jpg,lorry_truck,21,212,640,20,360,137,2,233,157,LTAdatasets/8701/annotate/8701-2021_03_20_195736.jpg,222.5,147.0,0.34765625,0.4083333333333333,0.0328125,0.05555555555555555
8701-2021_03_20_195736.jpg,car,14,182,640,13,360,95,1,196,108,LTAdatasets/8701/annotate/8701-2021_03_20_195736.jpg,189.0,101.5,0.2953125,0.28194444444444444,0.021875,0.03611111111111111
8701-2021_03_20_181251.jpg,car,42,426,640,35,360,210,1,468,245,LTAdatasets/8701/annotate/8701-2021_03_20_181251.jpg,447.0,227.5,0.6984375,0.6319444444444444,0.065625,0.09722222222222222
8701-2021_03_20_181251.jpg,car,22,244,640,16,360,151,1,266,167,LTAdatasets/8701/annotate/8701-2021_03_20_181251.jpg,255.0,159.0,0.3984375,0.44166666666666665,0.034375,0.044444444444444446
8701-2021_03_20_181251.jpg,car,16,225,640,15,360,121,1,241,136,LTAdatasets/8701/annotate/8701-2021_03_20_181251.jpg,233.0,128.5,0.3640625,0.35694444444444445,0.025,0.041666666666666664
8701-2021_03_20_181251.jpg,car,15,162,640,13,360,127,1,177,140,LTAdatasets/8701/annotate/8701-2021_03_20_181251.jpg,169.5,133.5,0.26484375,0.37083333333333335,0.0234375,0.03611111111111111
8701-2021_03_20_181251.jpg,lorry_truck,23,187,640,32,360,133,2,210,165,LTAdatasets/8701/annotate/8701-2021_03_20_181251.jpg,198.5,149.0,0.31015625,0.41388888888888886,0.0359375,0.08888888888888889
8701-2021_03_20_181251.jpg,van,16,318,640,12,360,115,3,334,127,LTAdatasets/8701/annotate/8701-2021_03_20_181251.jpg,326.0,121.0,0.509375,0.33611111111111114,0.025,0.03333333333333333
8701-2021_03_20_181251.jpg,car,10,261,640,11,360,89,1,271,100,LTAdatasets/8701/annotate/8701-2021_03_20_181251.jpg,266.0,94.5,0.415625,0.2625,0.015625,0.030555555555555555
8701-2021_03_20_193115.jpg,bike,22,568,640,27,360,282,4,590,309,LTAdatasets/8701/annotate/8701-2021_03_20_193115.jpg,579.0,295.5,0.9046875,0.8208333333333333,0.034375,0.075
8701-2021_03_20_193115.jpg,lorry_truck,43,499,640,41,360,207,2,542,248,LTAdatasets/8701/annotate/8701-2021_03_20_193115.jpg,520.5,227.5,0.81328125,0.6319444444444444,0.0671875,0.11388888888888889
8701-2021_03_20_193115.jpg,car,17,322,640,15,360,120,1,339,135,LTAdatasets/8701/annotate/8701-2021_03_20_193115.jpg,330.5,127.5,0.51640625,0.3541666666666667,0.0265625,0.041666666666666664
8701-2021_03_20_193115.jpg,lorry_truck,23,188,640,25,360,143,2,211,168,LTAdatasets/8701/annotate/8701-2021_03_20_193115.jpg,199.5,155.5,0.31171875,0.43194444444444446,0.0359375,0.06944444444444445
8701-2021_03_20_193115.jpg,car,14,213,640,12,360,100,1,227,112,LTAdatasets/8701/annotate/8701-2021_03_20_193115.jpg,220.0,106.0,0.34375,0.29444444444444445,0.021875,0.03333333333333333
8701-2021_03_20_193115.jpg,lorry_truck,12,177,640,14,360,84,2,189,98,LTAdatasets/8701/annotate/8701-2021_03_20_193115.jpg,183.0,91.0,0.2859375,0.25277777777777777,0.01875,0.03888888888888889
8701-2021_03_20_193115.jpg,lorry_truck,15,295,640,11,360,95,2,310,106,LTAdatasets/8701/annotate/8701-2021_03_20_193115.jpg,302.5,100.5,0.47265625,0.2791666666666667,0.0234375,0.030555555555555555
8701-2021_03_20_101906.jpg,lorry_truck,35,155,640,55,360,188,2,190,243,LTAdatasets/8701/annotate/8701-2021_03_20_101906.jpg,172.5,215.5,0.26953125,0.5986111111111111,0.0546875,0.1527777777777778
8701-2021_03_20_101906.jpg,lorry_truck,64,201,640,102,360,258,2,265,360,LTAdatasets/8701/annotate/8701-2021_03_20_101906.jpg,233.0,309.0,0.3640625,0.8583333333333333,0.1,0.2833333333333333
8701-2021_03_20_101906.jpg,lorry_truck,21,185,640,27,360,121,2,206,148,LTAdatasets/8701/annotate/8701-2021_03_20_101906.jpg,195.5,134.5,0.30546875,0.3736111111111111,0.0328125,0.075
8701-2021_03_20_101906.jpg,lorry_truck,18,327,640,20,360,102,2,345,122,LTAdatasets/8701/annotate/8701-2021_03_20_101906.jpg,336.0,112.0,0.525,0.3111111111111111,0.028125,0.05555555555555555
8701-2021_03_20_101906.jpg,car,23,403,640,23,360,171,1,426,194,LTAdatasets/8701/annotate/8701-2021_03_20_101906.jpg,414.5,182.5,0.64765625,0.5069444444444444,0.0359375,0.06388888888888888
8701-2021_03_20_101906.jpg,car,22,352,640,22,360,136,1,374,158,LTAdatasets/8701/annotate/8701-2021_03_20_101906.jpg,363.0,147.0,0.5671875,0.4083333333333333,0.034375,0.06111111111111111
8701-2021_03_20_101906.jpg,car,22,227,640,16,360,123,1,249,139,LTAdatasets/8701/annotate/8701-2021_03_20_101906.jpg,238.0,131.0,0.371875,0.3638888888888889,0.034375,0.044444444444444446
8701-2021_03_20_101906.jpg,car,11,195,640,9,360,108,1,206,117,LTAdatasets/8701/annotate/8701-2021_03_20_101906.jpg,200.5,112.5,0.31328125,0.3125,0.0171875,0.025
8701-2021_03_20_101906.jpg,bike,11,321,640,15,360,132,4,332,147,LTAdatasets/8701/annotate/8701-2021_03_20_101906.jpg,326.5,139.5,0.51015625,0.3875,0.0171875,0.041666666666666664
8701-2021_03_20_120712.jpg,bike,21,552,640,31,360,301,4,573,332,LTAdatasets/8701/annotate/8701-2021_03_20_120712.jpg,562.5,316.5,0.87890625,0.8791666666666667,0.0328125,0.08611111111111111
8701-2021_03_20_120712.jpg,bike,15,401,640,18,360,148,4,416,166,LTAdatasets/8701/annotate/8701-2021_03_20_120712.jpg,408.5,157.0,0.63828125,0.4361111111111111,0.0234375,0.05
8701-2021_03_20_120712.jpg,car,29,611,640,37,360,316,1,640,353,LTAdatasets/8701/annotate/8701-2021_03_20_120712.jpg,625.5,334.5,0.97734375,0.9291666666666667,0.0453125,0.10277777777777777
8701-2021_03_20_120712.jpg,car,15,292,640,12,360,112,1,307,124,LTAdatasets/8701/annotate/8701-2021_03_20_120712.jpg,299.5,118.0,0.46796875,0.3277777777777778,0.0234375,0.03333333333333333
8701-2021_03_20_120712.jpg,lorry_truck,15,160,640,15,360,91,2,175,106,LTAdatasets/8701/annotate/8701-2021_03_20_120712.jpg,167.5,98.5,0.26171875,0.27361111111111114,0.0234375,0.041666666666666664
8701-2021_03_20_180710.jpg,lorry_truck,16,161,640,20,360,154,2,177,174,LTAdatasets/8701/annotate/8701-2021_03_20_180710.jpg,169.0,164.0,0.2640625,0.45555555555555555,0.025,0.05555555555555555
8701-2021_03_20_180710.jpg,van,14,182,640,17,360,113,3,196,130,LTAdatasets/8701/annotate/8701-2021_03_20_180710.jpg,189.0,121.5,0.2953125,0.3375,0.021875,0.04722222222222222
8701-2021_03_20_180710.jpg,lorry_truck,15,205,640,17,360,121,2,220,138,LTAdatasets/8701/annotate/8701-2021_03_20_180710.jpg,212.5,129.5,0.33203125,0.3597222222222222,0.0234375,0.04722222222222222
8701-2021_03_20_180710.jpg,lorry_truck,22,300,640,22,360,98,2,322,120,LTAdatasets/8701/annotate/8701-2021_03_20_180710.jpg,311.0,109.0,0.4859375,0.30277777777777776,0.034375,0.06111111111111111
8701-2021_03_20_180710.jpg,lorry_truck,18,282,640,17,360,90,2,300,107,LTAdatasets/8701/annotate/8701-2021_03_20_180710.jpg,291.0,98.5,0.4546875,0.27361111111111114,0.028125,0.04722222222222222
8701-2021_03_20_181011.jpg,lorry_truck,47,465,640,35,360,189,2,512,224,LTAdatasets/8701/annotate/8701-2021_03_20_181011.jpg,488.5,206.5,0.76328125,0.5736111111111111,0.0734375,0.09722222222222222
8701-2021_03_20_181011.jpg,lorry_truck,17,318,640,16,360,106,2,335,122,LTAdatasets/8701/annotate/8701-2021_03_20_181011.jpg,326.5,114.0,0.51015625,0.31666666666666665,0.0265625,0.044444444444444446
8701-2021_03_20_181011.jpg,lorry_truck,14,177,640,14,360,90,2,191,104,LTAdatasets/8701/annotate/8701-2021_03_20_181011.jpg,184.0,97.0,0.2875,0.26944444444444443,0.021875,0.03888888888888889
8701-2021_03_20_181011.jpg,bike,11,354,640,14,360,146,4,365,160,LTAdatasets/8701/annotate/8701-2021_03_20_181011.jpg,359.5,153.0,0.56171875,0.425,0.0171875,0.03888888888888889
8701-2021_03_20_181011.jpg,car,44,335,640,41,360,295,1,379,336,LTAdatasets/8701/annotate/8701-2021_03_20_181011.jpg,357.0,315.5,0.5578125,0.8763888888888889,0.06875,0.11388888888888889
8701-2021_03_20_181011.jpg,car,14,161,640,10,360,104,1,175,114,LTAdatasets/8701/annotate/8701-2021_03_20_181011.jpg,168.0,109.0,0.2625,0.30277777777777776,0.021875,0.027777777777777776
8701-2021_03_20_181011.jpg,van,16,217,640,20,360,147,3,233,167,LTAdatasets/8701/annotate/8701-2021_03_20_181011.jpg,225.0,157.0,0.3515625,0.4361111111111111,0.025,0.05555555555555555
8701-2021_03_20_181011.jpg,bike,13,200,640,13,360,124,4,213,137,LTAdatasets/8701/annotate/8701-2021_03_20_181011.jpg,206.5,130.5,0.32265625,0.3625,0.0203125,0.03611111111111111
8701-2021_03_20_181011.jpg,bike,7,267,640,10,360,91,4,274,101,LTAdatasets/8701/annotate/8701-2021_03_20_181011.jpg,270.5,96.0,0.42265625,0.26666666666666666,0.0109375,0.027777777777777776
8701-2021_03_20_181011.jpg,car,11,194,640,12,360,90,1,205,102,LTAdatasets/8701/annotate/8701-2021_03_20_181011.jpg,199.5,96.0,0.31171875,0.26666666666666666,0.0171875,0.03333333333333333
8701-2021_03_20_124914.jpg,car,47,449,640,35,360,240,1,496,275,LTAdatasets/8701/annotate/8701-2021_03_20_124914.jpg,472.5,257.5,0.73828125,0.7152777777777778,0.0734375,0.09722222222222222
8701-2021_03_20_124914.jpg,car,18,366,640,18,360,148,1,384,166,LTAdatasets/8701/annotate/8701-2021_03_20_124914.jpg,375.0,157.0,0.5859375,0.4361111111111111,0.028125,0.05
8701-2021_03_20_124914.jpg,car,18,325,640,16,360,137,1,343,153,LTAdatasets/8701/annotate/8701-2021_03_20_124914.jpg,334.0,145.0,0.521875,0.4027777777777778,0.028125,0.044444444444444446
8701-2021_03_20_124914.jpg,car,21,249,640,15,360,160,1,270,175,LTAdatasets/8701/annotate/8701-2021_03_20_124914.jpg,259.5,167.5,0.40546875,0.4652777777777778,0.0328125,0.041666666666666664
8701-2021_03_20_124914.jpg,car,20,207,640,12,360,141,1,227,153,LTAdatasets/8701/annotate/8701-2021_03_20_124914.jpg,217.0,147.0,0.3390625,0.4083333333333333,0.03125,0.03333333333333333
8701-2021_03_20_124914.jpg,van,12,160,640,14,360,123,3,172,137,LTAdatasets/8701/annotate/8701-2021_03_20_124914.jpg,166.0,130.0,0.259375,0.3611111111111111,0.01875,0.03888888888888889
8701-2021_03_20_124914.jpg,lorry_truck,35,416,640,34,360,151,2,451,185,LTAdatasets/8701/annotate/8701-2021_03_20_124914.jpg,433.5,168.0,0.67734375,0.4666666666666667,0.0546875,0.09444444444444444
8701-2021_03_20_124914.jpg,lorry_truck,16,158,640,23,360,97,2,174,120,LTAdatasets/8701/annotate/8701-2021_03_20_124914.jpg,166.0,108.5,0.259375,0.3013888888888889,0.025,0.06388888888888888
8701-2021_03_20_124914.jpg,car,14,293,640,14,360,109,1,307,123,LTAdatasets/8701/annotate/8701-2021_03_20_124914.jpg,300.0,116.0,0.46875,0.32222222222222224,0.021875,0.03888888888888889
8701-2021_03_20_114551.jpg,lorry_truck,17,192,640,22,360,150,2,209,172,LTAdatasets/8701/annotate/8701-2021_03_20_114551.jpg,200.5,161.0,0.31328125,0.44722222222222224,0.0265625,0.06111111111111111
8701-2021_03_20_114551.jpg,lorry_truck,19,351,640,21,360,116,2,370,137,LTAdatasets/8701/annotate/8701-2021_03_20_114551.jpg,360.5,126.5,0.56328125,0.35138888888888886,0.0296875,0.058333333333333334
8701-2021_03_20_114551.jpg,lorry_truck,9,163,640,17,360,90,2,172,107,LTAdatasets/8701/annotate/8701-2021_03_20_114551.jpg,167.5,98.5,0.26171875,0.27361111111111114,0.0140625,0.04722222222222222
8701-2021_03_20_114551.jpg,lorry_truck,15,271,640,12,360,85,2,286,97,LTAdatasets/8701/annotate/8701-2021_03_20_114551.jpg,278.5,91.0,0.43515625,0.25277777777777777,0.0234375,0.03333333333333333
8701-2021_03_20_201317.jpg,lorry_truck,46,477,640,40,360,219,2,523,259,LTAdatasets/8701/annotate/8701-2021_03_20_201317.jpg,500.0,239.0,0.78125,0.6638888888888889,0.071875,0.1111111111111111
8701-2021_03_20_201317.jpg,lorry_truck,31,292,640,21,360,98,2,323,119,LTAdatasets/8701/annotate/8701-2021_03_20_201317.jpg,307.5,108.5,0.48046875,0.3013888888888889,0.0484375,0.058333333333333334
8701-2021_03_20_201317.jpg,bus,30,187,640,45,360,135,5,217,180,LTAdatasets/8701/annotate/8701-2021_03_20_201317.jpg,202.0,157.5,0.315625,0.4375,0.046875,0.125
8701-2021_03_20_201317.jpg,bus,32,156,640,52,360,152,5,188,204,LTAdatasets/8701/annotate/8701-2021_03_20_201317.jpg,172.0,178.0,0.26875,0.49444444444444446,0.05,0.14444444444444443
8701-2021_03_20_201317.jpg,car,15,219,640,11,360,144,1,234,155,LTAdatasets/8701/annotate/8701-2021_03_20_201317.jpg,226.5,149.5,0.35390625,0.4152777777777778,0.0234375,0.030555555555555555
8701-2021_03_20_201317.jpg,van,12,182,640,14,360,121,3,194,135,LTAdatasets/8701/annotate/8701-2021_03_20_201317.jpg,188.0,128.0,0.29375,0.35555555555555557,0.01875,0.03888888888888889
8701-2021_03_20_201317.jpg,car,13,195,640,9,360,102,1,208,111,LTAdatasets/8701/annotate/8701-2021_03_20_201317.jpg,201.5,106.5,0.31484375,0.29583333333333334,0.0203125,0.025
8701-2021_03_20_201317.jpg,lorry_truck,11,170,640,10,360,97,2,181,107,LTAdatasets/8701/annotate/8701-2021_03_20_201317.jpg,175.5,102.0,0.27421875,0.2833333333333333,0.0171875,0.027777777777777776
8701-2021_03_20_190413.jpg,lorry_truck,23,159,640,28,360,146,2,182,174,LTAdatasets/8701/annotate/8701-2021_03_20_190413.jpg,170.5,160.0,0.26640625,0.4444444444444444,0.0359375,0.07777777777777778
8701-2021_03_20_190413.jpg,lorry_truck,15,173,640,14,360,107,2,188,121,LTAdatasets/8701/annotate/8701-2021_03_20_190413.jpg,180.5,114.0,0.28203125,0.31666666666666665,0.0234375,0.03888888888888889
8701-2021_03_20_190413.jpg,bike,9,283,640,11,360,104,4,292,115,LTAdatasets/8701/annotate/8701-2021_03_20_190413.jpg,287.5,109.5,0.44921875,0.30416666666666664,0.0140625,0.030555555555555555
8701-2021_03_20_200416.jpg,lorry_truck,43,443,640,35,360,194,2,486,229,LTAdatasets/8701/annotate/8701-2021_03_20_200416.jpg,464.5,211.5,0.72578125,0.5875,0.0671875,0.09722222222222222
8701-2021_03_20_200416.jpg,lorry_truck,31,162,640,43,360,214,2,193,257,LTAdatasets/8701/annotate/8701-2021_03_20_200416.jpg,177.5,235.5,0.27734375,0.6541666666666667,0.0484375,0.11944444444444445
8701-2021_03_20_200416.jpg,lorry_truck,14,210,640,18,360,127,2,224,145,LTAdatasets/8701/annotate/8701-2021_03_20_200416.jpg,217.0,136.0,0.3390625,0.37777777777777777,0.021875,0.05
8701-2021_03_20_200416.jpg,lorry_truck,21,176,640,20,360,99,2,197,119,LTAdatasets/8701/annotate/8701-2021_03_20_200416.jpg,186.5,109.0,0.29140625,0.30277777777777776,0.0328125,0.05555555555555555
8701-2021_03_20_200416.jpg,bike,10,156,640,11,360,114,4,166,125,LTAdatasets/8701/annotate/8701-2021_03_20_200416.jpg,161.0,119.5,0.2515625,0.33194444444444443,0.015625,0.030555555555555555
8701-2021_03_20_200416.jpg,bike,18,522,640,26,360,278,4,540,304,LTAdatasets/8701/annotate/8701-2021_03_20_200416.jpg,531.0,291.0,0.8296875,0.8083333333333333,0.028125,0.07222222222222222
8701-2021_03_20_200416.jpg,car,18,335,640,18,360,127,1,353,145,LTAdatasets/8701/annotate/8701-2021_03_20_200416.jpg,344.0,136.0,0.5375,0.37777777777777777,0.028125,0.05
8701-2021_03_20_200416.jpg,van,18,318,640,17,360,129,3,336,146,LTAdatasets/8701/annotate/8701-2021_03_20_200416.jpg,327.0,137.5,0.5109375,0.3819444444444444,0.028125,0.04722222222222222
8701-2021_03_20_200416.jpg,car,14,264,640,12,360,102,1,278,114,LTAdatasets/8701/annotate/8701-2021_03_20_200416.jpg,271.0,108.0,0.4234375,0.3,0.021875,0.03333333333333333
8701-2021_03_20_113410.jpg,car,21,239,640,26,360,193,1,260,219,LTAdatasets/8701/annotate/8701-2021_03_20_113410.jpg,249.5,206.0,0.38984375,0.5722222222222222,0.0328125,0.07222222222222222
8701-2021_03_20_113410.jpg,car,16,240,640,15,360,139,1,256,154,LTAdatasets/8701/annotate/8701-2021_03_20_113410.jpg,248.0,146.5,0.3875,0.40694444444444444,0.025,0.041666666666666664
8701-2021_03_20_113410.jpg,car,15,217,640,17,360,152,1,232,169,LTAdatasets/8701/annotate/8701-2021_03_20_113410.jpg,224.5,160.5,0.35078125,0.44583333333333336,0.0234375,0.04722222222222222
8701-2021_03_20_113410.jpg,car,17,202,640,14,360,121,1,219,135,LTAdatasets/8701/annotate/8701-2021_03_20_113410.jpg,210.5,128.0,0.32890625,0.35555555555555557,0.0265625,0.03888888888888889
8701-2021_03_20_113410.jpg,car,11,313,640,12,360,124,1,324,136,LTAdatasets/8701/annotate/8701-2021_03_20_113410.jpg,318.5,130.0,0.49765625,0.3611111111111111,0.0171875,0.03333333333333333
8701-2021_03_20_113410.jpg,car,11,219,640,12,360,106,1,230,118,LTAdatasets/8701/annotate/8701-2021_03_20_113410.jpg,224.5,112.0,0.35078125,0.3111111111111111,0.0171875,0.03333333333333333
8701-2021_03_20_113410.jpg,car,52,566,640,33,360,327,1,618,360,LTAdatasets/8701/annotate/8701-2021_03_20_113410.jpg,592.0,343.5,0.925,0.9541666666666667,0.08125,0.09166666666666666
8701-2021_03_20_113410.jpg,lorry_truck,76,527,640,68,360,210,2,603,278,LTAdatasets/8701/annotate/8701-2021_03_20_113410.jpg,565.0,244.0,0.8828125,0.6777777777777778,0.11875,0.18888888888888888
8701-2021_03_20_113410.jpg,lorry_truck,69,397,640,71,360,141,2,466,212,LTAdatasets/8701/annotate/8701-2021_03_20_113410.jpg,431.5,176.5,0.67421875,0.49027777777777776,0.1078125,0.19722222222222222
8701-2021_03_20_113410.jpg,lorry_truck,41,181,640,54,360,190,2,222,244,LTAdatasets/8701/annotate/8701-2021_03_20_113410.jpg,201.5,217.0,0.31484375,0.6027777777777777,0.0640625,0.15
8701-2021_03_20_113410.jpg,lorry_truck,50,237,640,48,360,312,2,287,360,LTAdatasets/8701/annotate/8701-2021_03_20_113410.jpg,262.0,336.0,0.409375,0.9333333333333333,0.078125,0.13333333333333333
8701-2021_03_20_113410.jpg,lorry_truck,17,178,640,18,360,110,2,195,128,LTAdatasets/8701/annotate/8701-2021_03_20_113410.jpg,186.5,119.0,0.29140625,0.33055555555555555,0.0265625,0.05
8701-2021_03_20_113410.jpg,lorry_truck,15,158,640,15,360,93,2,173,108,LTAdatasets/8701/annotate/8701-2021_03_20_113410.jpg,165.5,100.5,0.25859375,0.2791666666666667,0.0234375,0.041666666666666664
8701-2021_03_20_113410.jpg,car,10,192,640,9,360,99,1,202,108,LTAdatasets/8701/annotate/8701-2021_03_20_113410.jpg,197.0,103.5,0.3078125,0.2875,0.015625,0.025
8701-2021_03_20_113410.jpg,car,9,191,640,8,360,89,1,200,97,LTAdatasets/8701/annotate/8701-2021_03_20_113410.jpg,195.5,93.0,0.30546875,0.25833333333333336,0.0140625,0.022222222222222223
8701-2021_03_20_201617.jpg,car,53,458,640,44,360,242,1,511,286,LTAdatasets/8701/annotate/8701-2021_03_20_201617.jpg,484.5,264.0,0.75703125,0.7333333333333333,0.0828125,0.12222222222222222
8701-2021_03_20_201617.jpg,car,10,287,640,11,360,106,1,297,117,LTAdatasets/8701/annotate/8701-2021_03_20_201617.jpg,292.0,111.5,0.45625,0.30972222222222223,0.015625,0.030555555555555555
8701-2021_03_20_202758.jpg,lorry_truck,53,535,640,43,360,230,2,588,273,LTAdatasets/8701/annotate/8701-2021_03_20_202758.jpg,561.5,251.5,0.87734375,0.6986111111111111,0.0828125,0.11944444444444445
8701-2021_03_20_202758.jpg,bike,27,596,640,24,360,336,4,623,360,LTAdatasets/8701/annotate/8701-2021_03_20_202758.jpg,609.5,348.0,0.95234375,0.9666666666666667,0.0421875,0.06666666666666667
8701-2021_03_20_202758.jpg,lorry_truck,31,466,640,18,360,76,2,497,94,LTAdatasets/8701/annotate/8701-2021_03_20_202758.jpg,481.5,85.0,0.75234375,0.2361111111111111,0.0484375,0.05
8701-2021_03_20_111609.jpg,lorry_truck,40,426,640,37,360,158,2,466,195,LTAdatasets/8701/annotate/8701-2021_03_20_111609.jpg,446.0,176.5,0.696875,0.49027777777777776,0.0625,0.10277777777777777
8701-2021_03_20_111609.jpg,lorry_truck,20,331,640,15,360,125,2,351,140,LTAdatasets/8701/annotate/8701-2021_03_20_111609.jpg,341.0,132.5,0.5328125,0.3680555555555556,0.03125,0.041666666666666664
8701-2021_03_20_111609.jpg,lorry_truck,23,176,640,26,360,112,2,199,138,LTAdatasets/8701/annotate/8701-2021_03_20_111609.jpg,187.5,125.0,0.29296875,0.3472222222222222,0.0359375,0.07222222222222222
8701-2021_03_20_111609.jpg,van,20,205,640,15,360,115,3,225,130,LTAdatasets/8701/annotate/8701-2021_03_20_111609.jpg,215.0,122.5,0.3359375,0.3402777777777778,0.03125,0.041666666666666664
8701-2021_03_20_111609.jpg,car,15,250,640,15,360,151,1,265,166,LTAdatasets/8701/annotate/8701-2021_03_20_111609.jpg,257.5,158.5,0.40234375,0.44027777777777777,0.0234375,0.041666666666666664
8701-2021_03_20_111609.jpg,car,15,311,640,12,360,113,1,326,125,LTAdatasets/8701/annotate/8701-2021_03_20_111609.jpg,318.5,119.0,0.49765625,0.33055555555555555,0.0234375,0.03333333333333333
8701-2021_03_20_194616.jpg,bus,39,379,640,36,360,144,5,418,180,LTAdatasets/8701/annotate/8701-2021_03_20_194616.jpg,398.5,162.0,0.62265625,0.45,0.0609375,0.1
8701-2021_03_20_194616.jpg,bike,21,417,640,29,360,204,4,438,233,LTAdatasets/8701/annotate/8701-2021_03_20_194616.jpg,427.5,218.5,0.66796875,0.6069444444444444,0.0328125,0.08055555555555556
8701-2021_03_20_194616.jpg,lorry_truck,12,278,640,18,360,86,2,290,104,LTAdatasets/8701/annotate/8701-2021_03_20_194616.jpg,284.0,95.0,0.44375,0.2638888888888889,0.01875,0.05
8701-2021_03_20_122152.jpg,van,20,342,640,19,360,128,3,362,147,LTAdatasets/8701/annotate/8701-2021_03_20_122152.jpg,352.0,137.5,0.55,0.3819444444444444,0.03125,0.05277777777777778
8701-2021_03_20_122152.jpg,lorry_truck,23,538,640,18,360,85,2,561,103,LTAdatasets/8701/annotate/8701-2021_03_20_122152.jpg,549.5,94.0,0.85859375,0.2611111111111111,0.0359375,0.05
8701-2021_03_20_122152.jpg,car,12,197,640,12,360,106,1,209,118,LTAdatasets/8701/annotate/8701-2021_03_20_122152.jpg,203.0,112.0,0.3171875,0.3111111111111111,0.01875,0.03333333333333333
8701-2021_03_20_122152.jpg,bus,15,290,640,15,360,86,5,305,101,LTAdatasets/8701/annotate/8701-2021_03_20_122152.jpg,297.5,93.5,0.46484375,0.25972222222222224,0.0234375,0.041666666666666664
8701-2021_03_20_122152.jpg,lorry_truck,12,270,640,11,360,84,2,282,95,LTAdatasets/8701/annotate/8701-2021_03_20_122152.jpg,276.0,89.5,0.43125,0.24861111111111112,0.01875,0.030555555555555555
8701-2021_03_20_122152.jpg,lorry_truck,10,162,640,9,360,91,2,172,100,LTAdatasets/8701/annotate/8701-2021_03_20_122152.jpg,167.0,95.5,0.2609375,0.2652777777777778,0.015625,0.025
8701-2021_03_20_122152.jpg,car,12,192,640,7,360,93,1,204,100,LTAdatasets/8701/annotate/8701-2021_03_20_122152.jpg,198.0,96.5,0.309375,0.26805555555555555,0.01875,0.019444444444444445
8701-2021_03_20_123713.jpg,bike,13,363,640,15,360,143,4,376,158,LTAdatasets/8701/annotate/8701-2021_03_20_123713.jpg,369.5,150.5,0.57734375,0.41805555555555557,0.0203125,0.041666666666666664
8701-2021_03_20_123713.jpg,car,19,192,640,21,360,168,1,211,189,LTAdatasets/8701/annotate/8701-2021_03_20_123713.jpg,201.5,178.5,0.31484375,0.49583333333333335,0.0296875,0.058333333333333334
8701-2021_03_20_123713.jpg,car,12,197,640,12,360,106,1,209,118,LTAdatasets/8701/annotate/8701-2021_03_20_123713.jpg,203.0,112.0,0.3171875,0.3111111111111111,0.01875,0.03333333333333333
8701-2021_03_20_123713.jpg,lorry_truck,9,268,640,11,360,84,2,277,95,LTAdatasets/8701/annotate/8701-2021_03_20_123713.jpg,272.5,89.5,0.42578125,0.24861111111111112,0.0140625,0.030555555555555555
8701-2021_03_20_185753.jpg,lorry_truck,26,186,640,31,360,142,2,212,173,LTAdatasets/8701/annotate/8701-2021_03_20_185753.jpg,199.0,157.5,0.3109375,0.4375,0.040625,0.08611111111111111
8701-2021_03_20_185753.jpg,lorry_truck,31,360,640,23,360,125,2,391,148,LTAdatasets/8701/annotate/8701-2021_03_20_185753.jpg,375.5,136.5,0.58671875,0.37916666666666665,0.0484375,0.06388888888888888
8701-2021_03_20_185753.jpg,bike,11,374,640,17,360,170,4,385,187,LTAdatasets/8701/annotate/8701-2021_03_20_185753.jpg,379.5,178.5,0.59296875,0.49583333333333335,0.0171875,0.04722222222222222
8701-2021_03_20_185753.jpg,bike,12,375,640,15,360,147,4,387,162,LTAdatasets/8701/annotate/8701-2021_03_20_185753.jpg,381.0,154.5,0.5953125,0.42916666666666664,0.01875,0.041666666666666664
8701-2021_03_20_185753.jpg,van,22,222,640,21,360,149,3,244,170,LTAdatasets/8701/annotate/8701-2021_03_20_185753.jpg,233.0,159.5,0.3640625,0.44305555555555554,0.034375,0.058333333333333334
8701-2021_03_20_185753.jpg,car,23,347,640,24,360,149,1,370,173,LTAdatasets/8701/annotate/8701-2021_03_20_185753.jpg,358.5,161.0,0.56015625,0.44722222222222224,0.0359375,0.06666666666666667
8701-2021_03_20_185753.jpg,car,50,564,640,38,360,322,1,614,360,LTAdatasets/8701/annotate/8701-2021_03_20_185753.jpg,589.0,341.0,0.9203125,0.9472222222222222,0.078125,0.10555555555555556
8701-2021_03_20_185753.jpg,car,13,287,640,11,360,96,1,300,107,LTAdatasets/8701/annotate/8701-2021_03_20_185753.jpg,293.5,101.5,0.45859375,0.28194444444444444,0.0203125,0.030555555555555555
8701-2021_03_20_185753.jpg,lorry_truck,21,612,640,15,360,102,2,633,117,LTAdatasets/8701/annotate/8701-2021_03_20_185753.jpg,622.5,109.5,0.97265625,0.30416666666666664,0.0328125,0.041666666666666664
8701-2021_03_20_185753.jpg,bike,12,205,640,12,360,112,4,217,124,LTAdatasets/8701/annotate/8701-2021_03_20_185753.jpg,211.0,118.0,0.3296875,0.3277777777777778,0.01875,0.03333333333333333
8701-2021_03_20_114310.jpg,lorry_truck,29,348,640,28,360,126,2,377,154,LTAdatasets/8701/annotate/8701-2021_03_20_114310.jpg,362.5,140.0,0.56640625,0.3888888888888889,0.0453125,0.07777777777777778
8701-2021_03_20_114310.jpg,van,22,391,640,21,360,142,3,413,163,LTAdatasets/8701/annotate/8701-2021_03_20_114310.jpg,402.0,152.5,0.628125,0.4236111111111111,0.034375,0.058333333333333334
8701-2021_03_20_114310.jpg,car,17,216,640,13,360,109,1,233,122,LTAdatasets/8701/annotate/8701-2021_03_20_114310.jpg,224.5,115.5,0.35078125,0.32083333333333336,0.0265625,0.03611111111111111
8701-2021_03_20_114310.jpg,car,36,435,640,30,360,216,1,471,246,LTAdatasets/8701/annotate/8701-2021_03_20_114310.jpg,453.0,231.0,0.7078125,0.6416666666666667,0.05625,0.08333333333333333
8701-2021_03_20_114310.jpg,car,17,327,640,16,360,140,1,344,156,LTAdatasets/8701/annotate/8701-2021_03_20_114310.jpg,335.5,148.0,0.52421875,0.4111111111111111,0.0265625,0.044444444444444446
8701-2021_03_20_114310.jpg,car,11,181,640,12,360,109,1,192,121,LTAdatasets/8701/annotate/8701-2021_03_20_114310.jpg,186.5,115.0,0.29140625,0.3194444444444444,0.0171875,0.03333333333333333
8701-2021_03_20_114310.jpg,car,15,293,640,11,360,112,1,308,123,LTAdatasets/8701/annotate/8701-2021_03_20_114310.jpg,300.5,117.5,0.46953125,0.3263888888888889,0.0234375,0.030555555555555555
8701-2021_03_20_114310.jpg,lorry_truck,15,159,640,13,360,94,2,174,107,LTAdatasets/8701/annotate/8701-2021_03_20_114310.jpg,166.5,100.5,0.26015625,0.2791666666666667,0.0234375,0.03611111111111111
8701-2021_03_20_114310.jpg,lorry_truck,28,601,640,15,360,100,2,629,115,LTAdatasets/8701/annotate/8701-2021_03_20_114310.jpg,615.0,107.5,0.9609375,0.2986111111111111,0.04375,0.041666666666666664
8701-2021_03_20_114310.jpg,van,15,302,640,13,360,93,3,317,106,LTAdatasets/8701/annotate/8701-2021_03_20_114310.jpg,309.5,99.5,0.48359375,0.2763888888888889,0.0234375,0.03611111111111111
8701-2021_03_20_203358.jpg,car,48,282,640,54,360,299,1,330,353,LTAdatasets/8701/annotate/8701-2021_03_20_203358.jpg,306.0,326.0,0.478125,0.9055555555555556,0.075,0.15
8701-2021_03_20_203358.jpg,lorry_truck,28,156,640,39,360,133,2,184,172,LTAdatasets/8701/annotate/8701-2021_03_20_203358.jpg,170.0,152.5,0.265625,0.4236111111111111,0.04375,0.10833333333333334
8701-2021_03_20_203358.jpg,car,15,220,640,11,360,113,1,235,124,LTAdatasets/8701/annotate/8701-2021_03_20_203358.jpg,227.5,118.5,0.35546875,0.32916666666666666,0.0234375,0.030555555555555555
8701-2021_03_20_203358.jpg,lorry_truck,28,301,640,21,360,106,2,329,127,LTAdatasets/8701/annotate/8701-2021_03_20_203358.jpg,315.0,116.5,0.4921875,0.3236111111111111,0.04375,0.058333333333333334
8701-2021_03_20_103707.jpg,lorry_truck,50,418,640,62,360,150,2,468,212,LTAdatasets/8701/annotate/8701-2021_03_20_103707.jpg,443.0,181.0,0.6921875,0.5027777777777778,0.078125,0.17222222222222222
8701-2021_03_20_103707.jpg,lorry_truck,26,186,640,34,360,133,2,212,167,LTAdatasets/8701/annotate/8701-2021_03_20_103707.jpg,199.0,150.0,0.3109375,0.4166666666666667,0.040625,0.09444444444444444
8701-2021_03_20_103707.jpg,lorry_truck,31,206,640,41,360,211,2,237,252,LTAdatasets/8701/annotate/8701-2021_03_20_103707.jpg,221.5,231.5,0.34609375,0.6430555555555556,0.0484375,0.11388888888888889
8701-2021_03_20_103707.jpg,lorry_truck,37,174,640,41,360,319,2,211,360,LTAdatasets/8701/annotate/8701-2021_03_20_103707.jpg,192.5,339.5,0.30078125,0.9430555555555555,0.0578125,0.11388888888888889
8701-2021_03_20_103707.jpg,lorry_truck,19,205,640,17,360,115,2,224,132,LTAdatasets/8701/annotate/8701-2021_03_20_103707.jpg,214.5,123.5,0.33515625,0.34305555555555556,0.0296875,0.04722222222222222
8701-2021_03_20_103707.jpg,lorry_truck,22,159,640,21,360,97,2,181,118,LTAdatasets/8701/annotate/8701-2021_03_20_103707.jpg,170.0,107.5,0.265625,0.2986111111111111,0.034375,0.058333333333333334
8701-2021_03_20_103707.jpg,lorry_truck,22,161,640,26,360,136,2,183,162,LTAdatasets/8701/annotate/8701-2021_03_20_103707.jpg,172.0,149.0,0.26875,0.41388888888888886,0.034375,0.07222222222222222
8701-2021_03_20_191914.jpg,car,26,414,640,22,360,185,1,440,207,LTAdatasets/8701/annotate/8701-2021_03_20_191914.jpg,427.0,196.0,0.6671875,0.5444444444444444,0.040625,0.06111111111111111
8701-2021_03_20_191914.jpg,car,35,468,640,30,360,210,1,503,240,LTAdatasets/8701/annotate/8701-2021_03_20_191914.jpg,485.5,225.0,0.75859375,0.625,0.0546875,0.08333333333333333
8701-2021_03_20_191914.jpg,bike,19,396,640,20,360,192,4,415,212,LTAdatasets/8701/annotate/8701-2021_03_20_191914.jpg,405.5,202.0,0.63359375,0.5611111111111111,0.0296875,0.05555555555555555
8701-2021_03_20_191914.jpg,car,30,292,640,26,360,211,1,322,237,LTAdatasets/8701/annotate/8701-2021_03_20_191914.jpg,307.0,224.0,0.4796875,0.6222222222222222,0.046875,0.07222222222222222
8701-2021_03_20_191914.jpg,lorry_truck,25,240,640,31,360,192,2,265,223,LTAdatasets/8701/annotate/8701-2021_03_20_191914.jpg,252.5,207.5,0.39453125,0.5763888888888888,0.0390625,0.08611111111111111
8701-2021_03_20_191914.jpg,car,20,171,640,18,360,171,1,191,189,LTAdatasets/8701/annotate/8701-2021_03_20_191914.jpg,181.0,180.0,0.2828125,0.5,0.03125,0.05
8701-2021_03_20_191914.jpg,car,15,244,640,14,360,141,1,259,155,LTAdatasets/8701/annotate/8701-2021_03_20_191914.jpg,251.5,148.0,0.39296875,0.4111111111111111,0.0234375,0.03888888888888889
8701-2021_03_20_191914.jpg,car,10,224,640,9,360,112,1,234,121,LTAdatasets/8701/annotate/8701-2021_03_20_191914.jpg,229.0,116.5,0.3578125,0.3236111111111111,0.015625,0.025
8701-2021_03_20_191914.jpg,bike,10,225,640,12,360,140,4,235,152,LTAdatasets/8701/annotate/8701-2021_03_20_191914.jpg,230.0,146.0,0.359375,0.40555555555555556,0.015625,0.03333333333333333
8701-2021_03_20_184913.jpg,lorry_truck,33,472,640,26,360,193,2,505,219,LTAdatasets/8701/annotate/8701-2021_03_20_184913.jpg,488.5,206.0,0.76328125,0.5722222222222222,0.0515625,0.07222222222222222
8701-2021_03_20_184913.jpg,car,28,381,640,23,360,184,1,409,207,LTAdatasets/8701/annotate/8701-2021_03_20_184913.jpg,395.0,195.5,0.6171875,0.5430555555555555,0.04375,0.06388888888888888
8701-2021_03_20_184913.jpg,bus,40,469,640,20,360,74,5,509,94,LTAdatasets/8701/annotate/8701-2021_03_20_184913.jpg,489.0,84.0,0.7640625,0.23333333333333334,0.0625,0.05555555555555555
8701-2021_03_20_184913.jpg,car,28,248,640,22,360,215,1,276,237,LTAdatasets/8701/annotate/8701-2021_03_20_184913.jpg,262.0,226.0,0.409375,0.6277777777777778,0.04375,0.06111111111111111
8701-2021_03_20_184913.jpg,bike,8,222,640,11,360,119,4,230,130,LTAdatasets/8701/annotate/8701-2021_03_20_184913.jpg,226.0,124.5,0.353125,0.3458333333333333,0.0125,0.030555555555555555
8701-2021_03_20_184913.jpg,lorry_truck,14,159,640,17,360,107,2,173,124,LTAdatasets/8701/annotate/8701-2021_03_20_184913.jpg,166.0,115.5,0.259375,0.32083333333333336,0.021875,0.04722222222222222
8701-2021_03_20_104307.jpg,lorry_truck,73,532,640,49,360,257,2,605,306,LTAdatasets/8701/annotate/8701-2021_03_20_104307.jpg,568.5,281.5,0.88828125,0.7819444444444444,0.1140625,0.1361111111111111
8701-2021_03_20_104307.jpg,car,47,543,640,41,360,310,1,590,351,LTAdatasets/8701/annotate/8701-2021_03_20_104307.jpg,566.5,330.5,0.88515625,0.9180555555555555,0.0734375,0.11388888888888889
8701-2021_03_20_104307.jpg,car,16,291,640,10,360,112,1,307,122,LTAdatasets/8701/annotate/8701-2021_03_20_104307.jpg,299.0,117.0,0.4671875,0.325,0.025,0.027777777777777776
8701-2021_03_20_104307.jpg,car,16,269,640,10,360,97,1,285,107,LTAdatasets/8701/annotate/8701-2021_03_20_104307.jpg,277.0,102.0,0.4328125,0.2833333333333333,0.025,0.027777777777777776
8701-2021_03_20_104307.jpg,bike,23,396,640,21,360,180,4,419,201,LTAdatasets/8701/annotate/8701-2021_03_20_104307.jpg,407.5,190.5,0.63671875,0.5291666666666667,0.0359375,0.058333333333333334
8701-2021_03_20_104307.jpg,lorry_truck,47,154,640,75,360,195,2,201,270,LTAdatasets/8701/annotate/8701-2021_03_20_104307.jpg,177.5,232.5,0.27734375,0.6458333333333334,0.0734375,0.20833333333333334
8701-2021_03_20_104307.jpg,lorry_truck,18,282,640,21,360,83,2,300,104,LTAdatasets/8701/annotate/8701-2021_03_20_104307.jpg,291.0,93.5,0.4546875,0.25972222222222224,0.028125,0.058333333333333334
8701-2021_03_20_104307.jpg,car,15,161,640,15,360,115,1,176,130,LTAdatasets/8701/annotate/8701-2021_03_20_104307.jpg,168.5,122.5,0.26328125,0.3402777777777778,0.0234375,0.041666666666666664
8701-2021_03_20_182451.jpg,lorry_truck,40,422,640,34,360,155,2,462,189,LTAdatasets/8701/annotate/8701-2021_03_20_182451.jpg,442.0,172.0,0.690625,0.4777777777777778,0.0625,0.09444444444444444
8701-2021_03_20_182451.jpg,lorry_truck,20,347,640,26,360,114,2,367,140,LTAdatasets/8701/annotate/8701-2021_03_20_182451.jpg,357.0,127.0,0.5578125,0.3527777777777778,0.03125,0.07222222222222222
8701-2021_03_20_182451.jpg,van,15,324,640,15,360,119,3,339,134,LTAdatasets/8701/annotate/8701-2021_03_20_182451.jpg,331.5,126.5,0.51796875,0.35138888888888886,0.0234375,0.041666666666666664
8701-2021_03_20_182451.jpg,van,22,166,640,29,360,219,3,188,248,LTAdatasets/8701/annotate/8701-2021_03_20_182451.jpg,177.0,233.5,0.2765625,0.6486111111111111,0.034375,0.08055555555555556
8701-2021_03_20_182451.jpg,van,17,194,640,19,360,159,3,211,178,LTAdatasets/8701/annotate/8701-2021_03_20_182451.jpg,202.5,168.5,0.31640625,0.46805555555555556,0.0265625,0.05277777777777778
8701-2021_03_20_182451.jpg,lorry_truck,12,174,640,11,360,85,2,186,96,LTAdatasets/8701/annotate/8701-2021_03_20_182451.jpg,180.0,90.5,0.28125,0.2513888888888889,0.01875,0.030555555555555555
8701-2021_03_20_194916.jpg,car,26,250,640,23,360,211,1,276,234,LTAdatasets/8701/annotate/8701-2021_03_20_194916.jpg,263.0,222.5,0.4109375,0.6180555555555556,0.040625,0.06388888888888888
8701-2021_03_20_194916.jpg,car,17,219,640,17,360,148,1,236,165,LTAdatasets/8701/annotate/8701-2021_03_20_194916.jpg,227.5,156.5,0.35546875,0.43472222222222223,0.0265625,0.04722222222222222
8701-2021_03_20_194916.jpg,car,15,181,640,10,360,126,1,196,136,LTAdatasets/8701/annotate/8701-2021_03_20_194916.jpg,188.5,131.0,0.29453125,0.3638888888888889,0.0234375,0.027777777777777776
8701-2021_03_20_194916.jpg,bus,19,309,640,19,360,106,5,328,125,LTAdatasets/8701/annotate/8701-2021_03_20_194916.jpg,318.5,115.5,0.49765625,0.32083333333333336,0.0296875,0.05277777777777778
8701-2021_03_20_194916.jpg,bus,46,390,640,47,360,155,5,436,202,LTAdatasets/8701/annotate/8701-2021_03_20_194916.jpg,413.0,178.5,0.6453125,0.49583333333333335,0.071875,0.13055555555555556
8701-2021_03_20_194916.jpg,van,38,170,640,51,360,309,3,208,360,LTAdatasets/8701/annotate/8701-2021_03_20_194916.jpg,189.0,334.5,0.2953125,0.9291666666666667,0.059375,0.14166666666666666
8701-2021_03_20_194916.jpg,lorry_truck,20,204,640,15,360,123,2,224,138,LTAdatasets/8701/annotate/8701-2021_03_20_194916.jpg,214.0,130.5,0.334375,0.3625,0.03125,0.041666666666666664
8701-2021_03_20_194916.jpg,bus,17,288,640,15,360,83,5,305,98,LTAdatasets/8701/annotate/8701-2021_03_20_194916.jpg,296.5,90.5,0.46328125,0.2513888888888889,0.0265625,0.041666666666666664
8701-2021_03_20_194916.jpg,car,15,216,640,10,360,105,1,231,115,LTAdatasets/8701/annotate/8701-2021_03_20_194916.jpg,223.5,110.0,0.34921875,0.3055555555555556,0.0234375,0.027777777777777776
8701-2021_03_20_203058.jpg,bus,21,328,640,27,360,99,5,349,126,LTAdatasets/8701/annotate/8701-2021_03_20_203058.jpg,338.5,112.5,0.52890625,0.3125,0.0328125,0.075
8701-2021_03_20_203058.jpg,car,48,430,640,37,360,259,1,478,296,LTAdatasets/8701/annotate/8701-2021_03_20_203058.jpg,454.0,277.5,0.709375,0.7708333333333334,0.075,0.10277777777777777
8701-2021_03_20_203058.jpg,car,46,575,640,41,360,288,1,621,329,LTAdatasets/8701/annotate/8701-2021_03_20_203058.jpg,598.0,308.5,0.934375,0.8569444444444444,0.071875,0.11388888888888889
8701-2021_03_20_203058.jpg,bike,28,549,640,30,360,303,4,577,333,LTAdatasets/8701/annotate/8701-2021_03_20_203058.jpg,563.0,318.0,0.8796875,0.8833333333333333,0.04375,0.08333333333333333
8701-2021_03_20_203058.jpg,lorry_truck,23,161,640,22,360,144,2,184,166,LTAdatasets/8701/annotate/8701-2021_03_20_203058.jpg,172.5,155.0,0.26953125,0.4305555555555556,0.0359375,0.06111111111111111
8701-2021_03_20_203058.jpg,car,14,180,640,11,360,95,1,194,106,LTAdatasets/8701/annotate/8701-2021_03_20_203058.jpg,187.0,100.5,0.2921875,0.2791666666666667,0.021875,0.030555555555555555
8701-2021_03_20_193635.jpg,lorry_truck,48,432,640,37,360,214,2,480,251,LTAdatasets/8701/annotate/8701-2021_03_20_193635.jpg,456.0,232.5,0.7125,0.6458333333333334,0.075,0.10277777777777777
8701-2021_03_20_193635.jpg,lorry_truck,36,433,640,33,360,162,2,469,195,LTAdatasets/8701/annotate/8701-2021_03_20_193635.jpg,451.0,178.5,0.7046875,0.49583333333333335,0.05625,0.09166666666666666
8701-2021_03_20_193635.jpg,bike,16,509,640,17,360,217,4,525,234,LTAdatasets/8701/annotate/8701-2021_03_20_193635.jpg,517.0,225.5,0.8078125,0.6263888888888889,0.025,0.04722222222222222
8701-2021_03_20_193635.jpg,bike,15,557,640,23,360,243,4,572,266,LTAdatasets/8701/annotate/8701-2021_03_20_193635.jpg,564.5,254.5,0.88203125,0.7069444444444445,0.0234375,0.06388888888888888
8701-2021_03_20_193635.jpg,car,24,395,640,30,360,216,1,419,246,LTAdatasets/8701/annotate/8701-2021_03_20_193635.jpg,407.0,231.0,0.6359375,0.6416666666666667,0.0375,0.08333333333333333
8701-2021_03_20_193635.jpg,car,16,286,640,14,360,103,1,302,117,LTAdatasets/8701/annotate/8701-2021_03_20_193635.jpg,294.0,110.0,0.459375,0.3055555555555556,0.025,0.03888888888888889
8701-2021_03_20_193635.jpg,car,17,623,640,11,360,106,1,640,117,LTAdatasets/8701/annotate/8701-2021_03_20_193635.jpg,631.5,111.5,0.98671875,0.30972222222222223,0.0265625,0.030555555555555555
8701-2021_03_20_191234.jpg,car,37,457,640,41,360,222,1,494,263,LTAdatasets/8701/annotate/8701-2021_03_20_191234.jpg,475.5,242.5,0.74296875,0.6736111111111112,0.0578125,0.11388888888888889
8701-2021_03_20_191234.jpg,car,31,394,640,33,360,216,1,425,249,LTAdatasets/8701/annotate/8701-2021_03_20_191234.jpg,409.5,232.5,0.63984375,0.6458333333333334,0.0484375,0.09166666666666666
8701-2021_03_20_191234.jpg,car,20,327,640,14,360,122,1,347,136,LTAdatasets/8701/annotate/8701-2021_03_20_191234.jpg,337.0,129.0,0.5265625,0.35833333333333334,0.03125,0.03888888888888889
8701-2021_03_20_191234.jpg,car,23,248,640,18,360,160,1,271,178,LTAdatasets/8701/annotate/8701-2021_03_20_191234.jpg,259.5,169.0,0.40546875,0.46944444444444444,0.0359375,0.05
8701-2021_03_20_191234.jpg,car,12,159,640,11,360,108,1,171,119,LTAdatasets/8701/annotate/8701-2021_03_20_191234.jpg,165.0,113.5,0.2578125,0.31527777777777777,0.01875,0.030555555555555555
8701-2021_03_20_191234.jpg,bike,10,199,640,8,360,112,4,209,120,LTAdatasets/8701/annotate/8701-2021_03_20_191234.jpg,204.0,116.0,0.31875,0.32222222222222224,0.015625,0.022222222222222223
8701-2021_03_20_191234.jpg,car,14,273,640,12,360,98,1,287,110,LTAdatasets/8701/annotate/8701-2021_03_20_191234.jpg,280.0,104.0,0.4375,0.28888888888888886,0.021875,0.03333333333333333
8701-2021_03_20_191234.jpg,car,10,258,640,8,360,89,1,268,97,LTAdatasets/8701/annotate/8701-2021_03_20_191234.jpg,263.0,93.0,0.4109375,0.25833333333333336,0.015625,0.022222222222222223
8701-2021_03_20_191234.jpg,car,20,531,640,10,360,92,1,551,102,LTAdatasets/8701/annotate/8701-2021_03_20_191234.jpg,541.0,97.0,0.8453125,0.26944444444444443,0.03125,0.027777777777777776
8701-2021_03_20_191234.jpg,car,20,479,640,8,360,85,1,499,93,LTAdatasets/8701/annotate/8701-2021_03_20_191234.jpg,489.0,89.0,0.7640625,0.24722222222222223,0.03125,0.022222222222222223
8701-2021_03_20_182151.jpg,car,23,360,640,21,360,155,1,383,176,LTAdatasets/8701/annotate/8701-2021_03_20_182151.jpg,371.5,165.5,0.58046875,0.4597222222222222,0.0359375,0.058333333333333334
8701-2021_03_20_182151.jpg,car,9,339,640,14,360,115,1,348,129,LTAdatasets/8701/annotate/8701-2021_03_20_182151.jpg,343.5,122.0,0.53671875,0.3388888888888889,0.0140625,0.03888888888888889
8701-2021_03_20_182151.jpg,car,24,203,640,21,360,206,1,227,227,LTAdatasets/8701/annotate/8701-2021_03_20_182151.jpg,215.0,216.5,0.3359375,0.6013888888888889,0.0375,0.058333333333333334
8701-2021_03_20_182151.jpg,lorry_truck,18,162,640,21,360,146,2,180,167,LTAdatasets/8701/annotate/8701-2021_03_20_182151.jpg,171.0,156.5,0.2671875,0.43472222222222223,0.028125,0.058333333333333334
8701-2021_03_20_182151.jpg,lorry_truck,18,284,640,18,360,83,2,302,101,LTAdatasets/8701/annotate/8701-2021_03_20_182151.jpg,293.0,92.0,0.4578125,0.25555555555555554,0.028125,0.05
8701-2021_03_20_182151.jpg,lorry_truck,18,175,640,21,360,97,2,193,118,LTAdatasets/8701/annotate/8701-2021_03_20_182151.jpg,184.0,107.5,0.2875,0.2986111111111111,0.028125,0.058333333333333334
8701-2021_03_20_182151.jpg,bike,10,199,640,10,360,108,4,209,118,LTAdatasets/8701/annotate/8701-2021_03_20_182151.jpg,204.0,113.0,0.31875,0.3138888888888889,0.015625,0.027777777777777776
8701-2021_03_20_200116.jpg,lorry_truck,23,182,640,24,360,139,2,205,163,LTAdatasets/8701/annotate/8701-2021_03_20_200116.jpg,193.5,151.0,0.30234375,0.41944444444444445,0.0359375,0.06666666666666667
8701-2021_03_20_200116.jpg,lorry_truck,17,157,640,27,360,122,2,174,149,LTAdatasets/8701/annotate/8701-2021_03_20_200116.jpg,165.5,135.5,0.25859375,0.3763888888888889,0.0265625,0.075
8701-2021_03_20_200116.jpg,car,15,204,640,12,360,122,1,219,134,LTAdatasets/8701/annotate/8701-2021_03_20_200116.jpg,211.5,128.0,0.33046875,0.35555555555555557,0.0234375,0.03333333333333333
8701-2021_03_20_200116.jpg,car,12,183,640,12,360,103,1,195,115,LTAdatasets/8701/annotate/8701-2021_03_20_200116.jpg,189.0,109.0,0.2953125,0.30277777777777776,0.01875,0.03333333333333333
8701-2021_03_20_124314.jpg,lorry_truck,37,402,640,34,360,142,2,439,176,LTAdatasets/8701/annotate/8701-2021_03_20_124314.jpg,420.5,159.0,0.65703125,0.44166666666666665,0.0578125,0.09444444444444444
8701-2021_03_20_124314.jpg,lorry_truck,21,179,640,18,360,115,2,200,133,LTAdatasets/8701/annotate/8701-2021_03_20_124314.jpg,189.5,124.0,0.29609375,0.34444444444444444,0.0328125,0.05
8701-2021_03_20_124314.jpg,lorry_truck,18,175,640,24,360,88,2,193,112,LTAdatasets/8701/annotate/8701-2021_03_20_124314.jpg,184.0,100.0,0.2875,0.2777777777777778,0.028125,0.06666666666666667
8701-2021_03_20_124314.jpg,lorry_truck,15,159,640,16,360,102,2,174,118,LTAdatasets/8701/annotate/8701-2021_03_20_124314.jpg,166.5,110.0,0.26015625,0.3055555555555556,0.0234375,0.044444444444444446
8701-2021_03_20_124314.jpg,car,11,269,640,8,360,95,1,280,103,LTAdatasets/8701/annotate/8701-2021_03_20_124314.jpg,274.5,99.0,0.42890625,0.275,0.0171875,0.022222222222222223
8701-2021_03_20_124314.jpg,bike,16,439,640,20,360,197,4,455,217,LTAdatasets/8701/annotate/8701-2021_03_20_124314.jpg,447.0,207.0,0.6984375,0.575,0.025,0.05555555555555555
8701-2021_03_20_124314.jpg,car,15,313,640,17,360,124,1,328,141,LTAdatasets/8701/annotate/8701-2021_03_20_124314.jpg,320.5,132.5,0.50078125,0.3680555555555556,0.0234375,0.04722222222222222
8701-2021_03_20_200937.jpg,van,29,165,640,34,360,187,3,194,221,LTAdatasets/8701/annotate/8701-2021_03_20_200937.jpg,179.5,204.0,0.28046875,0.5666666666666667,0.0453125,0.09444444444444444
8701-2021_03_20_200937.jpg,lorry_truck,26,360,640,27,360,120,2,386,147,LTAdatasets/8701/annotate/8701-2021_03_20_200937.jpg,373.0,133.5,0.5828125,0.37083333333333335,0.040625,0.075
8701-2021_03_20_200937.jpg,lorry_truck,17,331,640,17,360,122,2,348,139,LTAdatasets/8701/annotate/8701-2021_03_20_200937.jpg,339.5,130.5,0.53046875,0.3625,0.0265625,0.04722222222222222
8701-2021_03_20_200937.jpg,car,11,287,640,11,360,108,1,298,119,LTAdatasets/8701/annotate/8701-2021_03_20_200937.jpg,292.5,113.5,0.45703125,0.31527777777777777,0.0171875,0.030555555555555555
8701-2021_03_20_190113.jpg,lorry_truck,42,585,640,44,360,254,2,627,298,LTAdatasets/8701/annotate/8701-2021_03_20_190113.jpg,606.0,276.0,0.946875,0.7666666666666667,0.065625,0.12222222222222222
8701-2021_03_20_190113.jpg,car,39,436,640,36,360,220,1,475,256,LTAdatasets/8701/annotate/8701-2021_03_20_190113.jpg,455.5,238.0,0.71171875,0.6611111111111111,0.0609375,0.1
8701-2021_03_20_190113.jpg,car,26,373,640,24,360,150,1,399,174,LTAdatasets/8701/annotate/8701-2021_03_20_190113.jpg,386.0,162.0,0.603125,0.45,0.040625,0.06666666666666667
8701-2021_03_20_190113.jpg,lorry_truck,15,316,640,13,360,113,2,331,126,LTAdatasets/8701/annotate/8701-2021_03_20_190113.jpg,323.5,119.5,0.50546875,0.33194444444444443,0.0234375,0.03611111111111111
8701-2021_03_20_190113.jpg,car,11,313,640,11,360,100,1,324,111,LTAdatasets/8701/annotate/8701-2021_03_20_190113.jpg,318.5,105.5,0.49765625,0.29305555555555557,0.0171875,0.030555555555555555
8701-2021_03_20_190113.jpg,car,12,202,640,12,360,111,1,214,123,LTAdatasets/8701/annotate/8701-2021_03_20_190113.jpg,208.0,117.0,0.325,0.325,0.01875,0.03333333333333333
8701-2021_03_20_190113.jpg,bike,15,162,640,18,360,200,4,177,218,LTAdatasets/8701/annotate/8701-2021_03_20_190113.jpg,169.5,209.0,0.26484375,0.5805555555555556,0.0234375,0.05
8701-2021_03_20_190113.jpg,van,15,289,640,13,360,104,3,304,117,LTAdatasets/8701/annotate/8701-2021_03_20_190113.jpg,296.5,110.5,0.46328125,0.30694444444444446,0.0234375,0.03611111111111111
8701-2021_03_20_103927.jpg,bus,39,331,640,37,360,108,5,370,145,LTAdatasets/8701/annotate/8701-2021_03_20_103927.jpg,350.5,126.5,0.54765625,0.35138888888888886,0.0609375,0.10277777777777777
8701-2021_03_20_103927.jpg,lorry_truck,68,482,640,54,360,209,2,550,263,LTAdatasets/8701/annotate/8701-2021_03_20_103927.jpg,516.0,236.0,0.80625,0.6555555555555556,0.10625,0.15
8701-2021_03_20_103927.jpg,van,27,405,640,23,360,166,3,432,189,LTAdatasets/8701/annotate/8701-2021_03_20_103927.jpg,418.5,177.5,0.65390625,0.4930555555555556,0.0421875,0.06388888888888888
8701-2021_03_20_103927.jpg,car,24,367,640,23,360,169,1,391,192,LTAdatasets/8701/annotate/8701-2021_03_20_103927.jpg,379.0,180.5,0.5921875,0.5013888888888889,0.0375,0.06388888888888888
8701-2021_03_20_103927.jpg,car,15,327,640,15,360,139,1,342,154,LTAdatasets/8701/annotate/8701-2021_03_20_103927.jpg,334.5,146.5,0.52265625,0.40694444444444444,0.0234375,0.041666666666666664
8701-2021_03_20_191014.jpg,car,22,265,640,18,360,179,1,287,197,LTAdatasets/8701/annotate/8701-2021_03_20_191014.jpg,276.0,188.0,0.43125,0.5222222222222223,0.034375,0.05
8701-2021_03_20_191014.jpg,car,20,344,640,18,360,150,1,364,168,LTAdatasets/8701/annotate/8701-2021_03_20_191014.jpg,354.0,159.0,0.553125,0.44166666666666665,0.03125,0.05
8701-2021_03_20_191014.jpg,car,20,233,640,15,360,138,1,253,153,LTAdatasets/8701/annotate/8701-2021_03_20_191014.jpg,243.0,145.5,0.3796875,0.4041666666666667,0.03125,0.041666666666666664
8701-2021_03_20_191014.jpg,lorry_truck,20,188,640,20,360,138,2,208,158,LTAdatasets/8701/annotate/8701-2021_03_20_191014.jpg,198.0,148.0,0.309375,0.4111111111111111,0.03125,0.05555555555555555
8701-2021_03_20_191014.jpg,lorry_truck,18,157,640,16,360,127,2,175,143,LTAdatasets/8701/annotate/8701-2021_03_20_191014.jpg,166.0,135.0,0.259375,0.375,0.028125,0.044444444444444446
8701-2021_03_20_191014.jpg,bike,16,172,640,21,360,191,4,188,212,LTAdatasets/8701/annotate/8701-2021_03_20_191014.jpg,180.0,201.5,0.28125,0.5597222222222222,0.025,0.058333333333333334
8701-2021_03_20_191014.jpg,bus,12,179,640,28,360,102,5,191,130,LTAdatasets/8701/annotate/8701-2021_03_20_191014.jpg,185.0,116.0,0.2890625,0.32222222222222224,0.01875,0.07777777777777778
8701-2021_03_20_191014.jpg,lorry_truck,43,216,640,53,360,250,2,259,303,LTAdatasets/8701/annotate/8701-2021_03_20_191014.jpg,237.5,276.5,0.37109375,0.7680555555555556,0.0671875,0.14722222222222223
8701-2021_03_20_191014.jpg,lorry_truck,39,256,640,39,360,228,2,295,267,LTAdatasets/8701/annotate/8701-2021_03_20_191014.jpg,275.5,247.5,0.43046875,0.6875,0.0609375,0.10833333333333334
8701-2021_03_20_191014.jpg,car,11,198,640,10,360,101,1,209,111,LTAdatasets/8701/annotate/8701-2021_03_20_191014.jpg,203.5,106.0,0.31796875,0.29444444444444445,0.0171875,0.027777777777777776
8701-2021_03_20_113710.jpg,lorry_truck,86,539,640,67,360,223,2,625,290,LTAdatasets/8701/annotate/8701-2021_03_20_113710.jpg,582.0,256.5,0.909375,0.7125,0.134375,0.18611111111111112
8701-2021_03_20_113710.jpg,lorry_truck,40,365,640,50,360,123,2,405,173,LTAdatasets/8701/annotate/8701-2021_03_20_113710.jpg,385.0,148.0,0.6015625,0.4111111111111111,0.0625,0.1388888888888889
8701-2021_03_20_113710.jpg,lorry_truck,35,436,640,27,360,191,2,471,218,LTAdatasets/8701/annotate/8701-2021_03_20_113710.jpg,453.5,204.5,0.70859375,0.5680555555555555,0.0546875,0.075
8701-2021_03_20_113710.jpg,van,12,335,640,13,360,114,3,347,127,LTAdatasets/8701/annotate/8701-2021_03_20_113710.jpg,341.0,120.5,0.5328125,0.3347222222222222,0.01875,0.03611111111111111
8701-2021_03_20_113710.jpg,car,11,286,640,10,360,105,1,297,115,LTAdatasets/8701/annotate/8701-2021_03_20_113710.jpg,291.5,110.0,0.45546875,0.3055555555555556,0.0171875,0.027777777777777776
8701-2021_03_20_113710.jpg,car,11,262,640,10,360,87,1,273,97,LTAdatasets/8701/annotate/8701-2021_03_20_113710.jpg,267.5,92.0,0.41796875,0.25555555555555554,0.0171875,0.027777777777777776
8701-2021_03_20_113710.jpg,lorry_truck,14,177,640,13,360,101,2,191,114,LTAdatasets/8701/annotate/8701-2021_03_20_113710.jpg,184.0,107.5,0.2875,0.2986111111111111,0.021875,0.03611111111111111
8701-2021_03_20_113710.jpg,van,9,161,640,12,360,98,3,170,110,LTAdatasets/8701/annotate/8701-2021_03_20_113710.jpg,165.5,104.0,0.25859375,0.28888888888888886,0.0140625,0.03333333333333333
8701-2021_03_20_111249.jpg,car,20,231,640,24,360,169,1,251,193,LTAdatasets/8701/annotate/8701-2021_03_20_111249.jpg,241.0,181.0,0.3765625,0.5027777777777778,0.03125,0.06666666666666667
8701-2021_03_20_111249.jpg,lorry_truck,28,185,640,34,360,137,2,213,171,LTAdatasets/8701/annotate/8701-2021_03_20_111249.jpg,199.0,154.0,0.3109375,0.42777777777777776,0.04375,0.09444444444444444
8701-2021_03_20_111249.jpg,car,16,311,640,12,360,125,1,327,137,LTAdatasets/8701/annotate/8701-2021_03_20_111249.jpg,319.0,131.0,0.4984375,0.3638888888888889,0.025,0.03333333333333333
8701-2021_03_20_111249.jpg,car,13,202,640,11,360,120,1,215,131,LTAdatasets/8701/annotate/8701-2021_03_20_111249.jpg,208.5,125.5,0.32578125,0.3486111111111111,0.0203125,0.030555555555555555
8701-2021_03_20_111249.jpg,car,12,211,640,9,360,93,1,223,102,LTAdatasets/8701/annotate/8701-2021_03_20_111249.jpg,217.0,97.5,0.3390625,0.2708333333333333,0.01875,0.025
8701-2021_03_20_185153.jpg,car,43,459,640,34,360,282,1,502,316,LTAdatasets/8701/annotate/8701-2021_03_20_185153.jpg,480.5,299.0,0.75078125,0.8305555555555556,0.0671875,0.09444444444444444
8701-2021_03_20_185153.jpg,bike,22,473,640,26,360,232,4,495,258,LTAdatasets/8701/annotate/8701-2021_03_20_185153.jpg,484.0,245.0,0.75625,0.6805555555555556,0.034375,0.07222222222222222
8701-2021_03_20_185153.jpg,car,29,401,640,26,360,192,1,430,218,LTAdatasets/8701/annotate/8701-2021_03_20_185153.jpg,415.5,205.0,0.64921875,0.5694444444444444,0.0453125,0.07222222222222222
8701-2021_03_20_185153.jpg,car,18,230,640,18,360,127,1,248,145,LTAdatasets/8701/annotate/8701-2021_03_20_185153.jpg,239.0,136.0,0.3734375,0.37777777777777777,0.028125,0.05
8701-2021_03_20_185153.jpg,lorry_truck,21,186,640,27,360,125,2,207,152,LTAdatasets/8701/annotate/8701-2021_03_20_185153.jpg,196.5,138.5,0.30703125,0.38472222222222224,0.0328125,0.075
8701-2021_03_20_185153.jpg,lorry_truck,18,160,640,17,360,119,2,178,136,LTAdatasets/8701/annotate/8701-2021_03_20_185153.jpg,169.0,127.5,0.2640625,0.3541666666666667,0.028125,0.04722222222222222
8701-2021_03_20_185153.jpg,lorry_truck,17,282,640,15,360,92,2,299,107,LTAdatasets/8701/annotate/8701-2021_03_20_185153.jpg,290.5,99.5,0.45390625,0.2763888888888889,0.0265625,0.041666666666666664
8701-2021_03_20_185153.jpg,van,15,161,640,15,360,137,3,176,152,LTAdatasets/8701/annotate/8701-2021_03_20_185153.jpg,168.5,144.5,0.26328125,0.4013888888888889,0.0234375,0.041666666666666664
8701-2021_03_20_185153.jpg,car,20,374,640,22,360,195,1,394,217,LTAdatasets/8701/annotate/8701-2021_03_20_185153.jpg,384.0,206.0,0.6,0.5722222222222222,0.03125,0.06111111111111111
8701-2021_03_20_185153.jpg,lorry_truck,11,160,640,12,360,99,2,171,111,LTAdatasets/8701/annotate/8701-2021_03_20_185153.jpg,165.5,105.0,0.25859375,0.2916666666666667,0.0171875,0.03333333333333333
8701-2021_03_20_201917.jpg,car,16,340,640,16,360,147,1,356,163,LTAdatasets/8701/annotate/8701-2021_03_20_201917.jpg,348.0,155.0,0.54375,0.4305555555555556,0.025,0.044444444444444446
8701-2021_03_20_115151.jpg,lorry_truck,48,499,640,38,360,240,2,547,278,LTAdatasets/8701/annotate/8701-2021_03_20_115151.jpg,523.0,259.0,0.8171875,0.7194444444444444,0.075,0.10555555555555556
8701-2021_03_20_115151.jpg,lorry_truck,40,163,640,69,360,209,2,203,278,LTAdatasets/8701/annotate/8701-2021_03_20_115151.jpg,183.0,243.5,0.2859375,0.6763888888888889,0.0625,0.19166666666666668
8701-2021_03_20_115151.jpg,lorry_truck,18,156,640,36,360,109,2,174,145,LTAdatasets/8701/annotate/8701-2021_03_20_115151.jpg,165.0,127.0,0.2578125,0.3527777777777778,0.028125,0.1
8701-2021_03_20_115151.jpg,van,16,201,640,14,360,110,3,217,124,LTAdatasets/8701/annotate/8701-2021_03_20_115151.jpg,209.0,117.0,0.3265625,0.325,0.025,0.03888888888888889
8701-2021_03_20_115151.jpg,van,18,343,640,18,360,115,3,361,133,LTAdatasets/8701/annotate/8701-2021_03_20_115151.jpg,352.0,124.0,0.55,0.34444444444444444,0.028125,0.05
8701-2021_03_20_115151.jpg,lorry_truck,17,280,640,16,360,87,2,297,103,LTAdatasets/8701/annotate/8701-2021_03_20_115151.jpg,288.5,95.0,0.45078125,0.2638888888888889,0.0265625,0.044444444444444446
8701-2021_03_20_115151.jpg,lorry_truck,36,162,640,29,360,331,2,198,360,LTAdatasets/8701/annotate/8701-2021_03_20_115151.jpg,180.0,345.5,0.28125,0.9597222222222223,0.05625,0.08055555555555556
8701-2021_03_20_115151.jpg,lorry_truck,12,177,640,12,360,93,2,189,105,LTAdatasets/8701/annotate/8701-2021_03_20_115151.jpg,183.0,99.0,0.2859375,0.275,0.01875,0.03333333333333333
8701-2021_03_20_193415.jpg,lorry_truck,37,603,640,61,360,258,2,640,319,LTAdatasets/8701/annotate/8701-2021_03_20_193415.jpg,621.5,288.5,0.97109375,0.8013888888888889,0.0578125,0.16944444444444445
8701-2021_03_20_193415.jpg,van,21,370,640,15,360,131,3,391,146,LTAdatasets/8701/annotate/8701-2021_03_20_193415.jpg,380.5,138.5,0.59453125,0.38472222222222224,0.0328125,0.041666666666666664
8701-2021_03_20_193415.jpg,van,34,254,640,31,360,216,3,288,247,LTAdatasets/8701/annotate/8701-2021_03_20_193415.jpg,271.0,231.5,0.4234375,0.6430555555555556,0.053125,0.08611111111111111
8701-2021_03_20_193415.jpg,bike,29,525,640,34,360,277,4,554,311,LTAdatasets/8701/annotate/8701-2021_03_20_193415.jpg,539.5,294.0,0.84296875,0.8166666666666667,0.0453125,0.09444444444444444
8701-2021_03_20_193415.jpg,lorry_truck,18,209,640,18,360,131,2,227,149,LTAdatasets/8701/annotate/8701-2021_03_20_193415.jpg,218.0,140.0,0.340625,0.3888888888888889,0.028125,0.05
8701-2021_03_20_193415.jpg,lorry_truck,29,191,640,43,360,154,2,220,197,LTAdatasets/8701/annotate/8701-2021_03_20_193415.jpg,205.5,175.5,0.32109375,0.4875,0.0453125,0.11944444444444445
8701-2021_03_20_193415.jpg,lorry_truck,49,219,640,54,360,255,2,268,309,LTAdatasets/8701/annotate/8701-2021_03_20_193415.jpg,243.5,282.0,0.38046875,0.7833333333333333,0.0765625,0.15
8701-2021_03_20_193415.jpg,car,14,193,640,10,360,112,1,207,122,LTAdatasets/8701/annotate/8701-2021_03_20_193415.jpg,200.0,117.0,0.3125,0.325,0.021875,0.027777777777777776
8701-2021_03_20_181851.jpg,car,26,419,640,19,360,168,1,445,187,LTAdatasets/8701/annotate/8701-2021_03_20_181851.jpg,432.0,177.5,0.675,0.4930555555555556,0.040625,0.05277777777777778
8701-2021_03_20_181851.jpg,car,45,470,640,44,360,280,1,515,324,LTAdatasets/8701/annotate/8701-2021_03_20_181851.jpg,492.5,302.0,0.76953125,0.8388888888888889,0.0703125,0.12222222222222222
8701-2021_03_20_181851.jpg,bike,15,375,640,17,360,166,4,390,183,LTAdatasets/8701/annotate/8701-2021_03_20_181851.jpg,382.5,174.5,0.59765625,0.4847222222222222,0.0234375,0.04722222222222222
8701-2021_03_20_181851.jpg,lorry_truck,16,161,640,16,360,129,2,177,145,LTAdatasets/8701/annotate/8701-2021_03_20_181851.jpg,169.0,137.0,0.2640625,0.38055555555555554,0.025,0.044444444444444446
8701-2021_03_20_181851.jpg,car,11,276,640,12,360,89,1,287,101,LTAdatasets/8701/annotate/8701-2021_03_20_181851.jpg,281.5,95.0,0.43984375,0.2638888888888889,0.0171875,0.03333333333333333
8701-2021_03_20_104908.jpg,lorry_truck,62,447,640,53,360,185,2,509,238,LTAdatasets/8701/annotate/8701-2021_03_20_104908.jpg,478.0,211.5,0.746875,0.5875,0.096875,0.14722222222222223
8701-2021_03_20_104908.jpg,bus,40,532,640,16,360,85,5,572,101,LTAdatasets/8701/annotate/8701-2021_03_20_104908.jpg,552.0,93.0,0.8625,0.25833333333333336,0.0625,0.044444444444444446
8701-2021_03_20_104908.jpg,car,22,231,640,17,360,171,1,253,188,LTAdatasets/8701/annotate/8701-2021_03_20_104908.jpg,242.0,179.5,0.378125,0.4986111111111111,0.034375,0.04722222222222222
8701-2021_03_20_104908.jpg,car,18,160,640,14,360,154,1,178,168,LTAdatasets/8701/annotate/8701-2021_03_20_104908.jpg,169.0,161.0,0.2640625,0.44722222222222224,0.028125,0.03888888888888889
8701-2021_03_20_104908.jpg,lorry_truck,27,183,640,29,360,130,2,210,159,LTAdatasets/8701/annotate/8701-2021_03_20_104908.jpg,196.5,144.5,0.30703125,0.4013888888888889,0.0421875,0.08055555555555556
8701-2021_03_20_104908.jpg,lorry_truck,42,193,640,52,360,180,2,235,232,LTAdatasets/8701/annotate/8701-2021_03_20_104908.jpg,214.0,206.0,0.334375,0.5722222222222222,0.065625,0.14444444444444443
8701-2021_03_20_104908.jpg,lorry_truck,15,267,640,10,360,80,2,282,90,LTAdatasets/8701/annotate/8701-2021_03_20_104908.jpg,274.5,85.0,0.42890625,0.2361111111111111,0.0234375,0.027777777777777776
8701-2021_03_20_104607.jpg,van,17,192,640,15,360,134,3,209,149,LTAdatasets/8701/annotate/8701-2021_03_20_104607.jpg,200.5,141.5,0.31328125,0.39305555555555555,0.0265625,0.041666666666666664
8701-2021_03_20_104607.jpg,van,14,304,640,11,360,96,3,318,107,LTAdatasets/8701/annotate/8701-2021_03_20_104607.jpg,311.0,101.5,0.4859375,0.28194444444444444,0.021875,0.030555555555555555
8701-2021_03_20_202437.jpg,bus,23,303,640,26,360,95,5,326,121,LTAdatasets/8701/annotate/8701-2021_03_20_202437.jpg,314.5,108.0,0.49140625,0.3,0.0359375,0.07222222222222222
8701-2021_03_20_202437.jpg,car,17,328,640,10,360,112,1,345,122,LTAdatasets/8701/annotate/8701-2021_03_20_202437.jpg,336.5,117.0,0.52578125,0.325,0.0265625,0.027777777777777776
8701-2021_03_20_202437.jpg,car,22,241,640,17,360,144,1,263,161,LTAdatasets/8701/annotate/8701-2021_03_20_202437.jpg,252.0,152.5,0.39375,0.4236111111111111,0.034375,0.04722222222222222
8701-2021_03_20_202437.jpg,car,26,286,640,27,360,199,1,312,226,LTAdatasets/8701/annotate/8701-2021_03_20_202437.jpg,299.0,212.5,0.4671875,0.5902777777777778,0.040625,0.075
8701-2021_03_20_183412.jpg,car,50,444,640,42,360,266,1,494,308,LTAdatasets/8701/annotate/8701-2021_03_20_183412.jpg,469.0,287.0,0.7328125,0.7972222222222223,0.078125,0.11666666666666667
8701-2021_03_20_183412.jpg,car,21,167,640,20,360,209,1,188,229,LTAdatasets/8701/annotate/8701-2021_03_20_183412.jpg,177.5,219.0,0.27734375,0.6083333333333333,0.0328125,0.05555555555555555
8701-2021_03_20_183412.jpg,car,10,264,640,9,360,92,1,274,101,LTAdatasets/8701/annotate/8701-2021_03_20_183412.jpg,269.0,96.5,0.4203125,0.26805555555555555,0.015625,0.025
8701-2021_03_20_191614.jpg,car,50,306,640,39,360,321,1,356,360,LTAdatasets/8701/annotate/8701-2021_03_20_191614.jpg,331.0,340.5,0.5171875,0.9458333333333333,0.078125,0.10833333333333334
8701-2021_03_20_191614.jpg,car,18,216,640,16,360,138,1,234,154,LTAdatasets/8701/annotate/8701-2021_03_20_191614.jpg,225.0,146.0,0.3515625,0.40555555555555556,0.028125,0.044444444444444446
8701-2021_03_20_191614.jpg,bike,11,200,640,14,360,150,4,211,164,LTAdatasets/8701/annotate/8701-2021_03_20_191614.jpg,205.5,157.0,0.32109375,0.4361111111111111,0.0171875,0.03888888888888889
8701-2021_03_20_191614.jpg,lorry_truck,19,162,640,21,360,130,2,181,151,LTAdatasets/8701/annotate/8701-2021_03_20_191614.jpg,171.5,140.5,0.26796875,0.3902777777777778,0.0296875,0.058333333333333334
8701-2021_03_20_191614.jpg,lorry_truck,12,158,640,10,360,119,2,170,129,LTAdatasets/8701/annotate/8701-2021_03_20_191614.jpg,164.0,124.0,0.25625,0.34444444444444444,0.01875,0.027777777777777776
8701-2021_03_20_191614.jpg,car,12,291,640,9,360,111,1,303,120,LTAdatasets/8701/annotate/8701-2021_03_20_191614.jpg,297.0,115.5,0.4640625,0.32083333333333336,0.01875,0.025
8701-2021_03_20_183712.jpg,lorry_truck,33,443,640,33,360,193,2,476,226,LTAdatasets/8701/annotate/8701-2021_03_20_183712.jpg,459.5,209.5,0.71796875,0.5819444444444445,0.0515625,0.09166666666666666
8701-2021_03_20_183712.jpg,car,26,412,640,32,360,201,1,438,233,LTAdatasets/8701/annotate/8701-2021_03_20_183712.jpg,425.0,217.0,0.6640625,0.6027777777777777,0.040625,0.08888888888888889
8701-2021_03_20_183712.jpg,lorry_truck,38,194,640,60,360,168,2,232,228,LTAdatasets/8701/annotate/8701-2021_03_20_183712.jpg,213.0,198.0,0.3328125,0.55,0.059375,0.16666666666666666
8701-2021_03_20_183712.jpg,van,14,333,640,15,360,111,3,347,126,LTAdatasets/8701/annotate/8701-2021_03_20_183712.jpg,340.0,118.5,0.53125,0.32916666666666666,0.021875,0.041666666666666664
8701-2021_03_20_183712.jpg,lorry_truck,17,296,640,20,360,96,2,313,116,LTAdatasets/8701/annotate/8701-2021_03_20_183712.jpg,304.5,106.0,0.47578125,0.29444444444444445,0.0265625,0.05555555555555555
8701-2021_03_20_192515.jpg,lorry_truck,67,497,640,60,360,236,2,564,296,LTAdatasets/8701/annotate/8701-2021_03_20_192515.jpg,530.5,266.0,0.82890625,0.7388888888888889,0.1046875,0.16666666666666666
8701-2021_03_20_192515.jpg,lorry_truck,34,369,640,25,360,141,2,403,166,LTAdatasets/8701/annotate/8701-2021_03_20_192515.jpg,386.0,153.5,0.603125,0.4263888888888889,0.053125,0.06944444444444445
8701-2021_03_20_192515.jpg,lorry_truck,18,326,640,22,360,111,2,344,133,LTAdatasets/8701/annotate/8701-2021_03_20_192515.jpg,335.0,122.0,0.5234375,0.3388888888888889,0.028125,0.06111111111111111
8701-2021_03_20_192515.jpg,bike,15,335,640,12,360,144,4,350,156,LTAdatasets/8701/annotate/8701-2021_03_20_192515.jpg,342.5,150.0,0.53515625,0.4166666666666667,0.0234375,0.03333333333333333
8701-2021_03_20_192515.jpg,bike,16,234,640,23,360,279,4,250,302,LTAdatasets/8701/annotate/8701-2021_03_20_192515.jpg,242.0,290.5,0.378125,0.8069444444444445,0.025,0.06388888888888888
8701-2021_03_20_185453.jpg,bike,17,527,640,27,360,311,4,544,338,LTAdatasets/8701/annotate/8701-2021_03_20_185453.jpg,535.5,324.5,0.83671875,0.9013888888888889,0.0265625,0.075
8701-2021_03_20_185453.jpg,car,34,444,640,31,360,222,1,478,253,LTAdatasets/8701/annotate/8701-2021_03_20_185453.jpg,461.0,237.5,0.7203125,0.6597222222222222,0.053125,0.08611111111111111
8701-2021_03_20_185453.jpg,lorry_truck,40,213,640,55,360,229,2,253,284,LTAdatasets/8701/annotate/8701-2021_03_20_185453.jpg,233.0,256.5,0.3640625,0.7125,0.0625,0.1527777777777778
8701-2021_03_20_185453.jpg,car,21,222,640,13,360,164,1,243,177,LTAdatasets/8701/annotate/8701-2021_03_20_185453.jpg,232.5,170.5,0.36328125,0.4736111111111111,0.0328125,0.03611111111111111
8701-2021_03_20_185453.jpg,car,16,185,640,14,360,134,1,201,148,LTAdatasets/8701/annotate/8701-2021_03_20_185453.jpg,193.0,141.0,0.3015625,0.39166666666666666,0.025,0.03888888888888889
8701-2021_03_20_121932.jpg,car,49,436,640,37,360,269,1,485,306,LTAdatasets/8701/annotate/8701-2021_03_20_121932.jpg,460.5,287.5,0.71953125,0.7986111111111112,0.0765625,0.10277777777777777
8701-2021_03_20_121932.jpg,car,44,487,640,34,360,264,1,531,298,LTAdatasets/8701/annotate/8701-2021_03_20_121932.jpg,509.0,281.0,0.7953125,0.7805555555555556,0.06875,0.09444444444444444
8701-2021_03_20_121932.jpg,bike,16,249,640,20,360,218,4,265,238,LTAdatasets/8701/annotate/8701-2021_03_20_121932.jpg,257.0,228.0,0.4015625,0.6333333333333333,0.025,0.05555555555555555
8701-2021_03_20_121932.jpg,bike,12,213,640,13,360,120,4,225,133,LTAdatasets/8701/annotate/8701-2021_03_20_121932.jpg,219.0,126.5,0.3421875,0.35138888888888886,0.01875,0.03611111111111111
8701-2021_03_20_121932.jpg,lorry_truck,17,176,640,17,360,97,2,193,114,LTAdatasets/8701/annotate/8701-2021_03_20_121932.jpg,184.5,105.5,0.28828125,0.29305555555555557,0.0265625,0.04722222222222222
8701-2021_03_20_105128.jpg,lorry_truck,44,406,640,47,360,156,2,450,203,LTAdatasets/8701/annotate/8701-2021_03_20_105128.jpg,428.0,179.5,0.66875,0.4986111111111111,0.06875,0.13055555555555556
8701-2021_03_20_105128.jpg,car,37,263,640,31,360,262,1,300,293,LTAdatasets/8701/annotate/8701-2021_03_20_105128.jpg,281.5,277.5,0.43984375,0.7708333333333334,0.0578125,0.08611111111111111
8701-2021_03_20_105128.jpg,car,15,208,640,11,360,123,1,223,134,LTAdatasets/8701/annotate/8701-2021_03_20_105128.jpg,215.5,128.5,0.33671875,0.35694444444444445,0.0234375,0.030555555555555555
8701-2021_03_20_105128.jpg,lorry_truck,13,281,640,11,360,79,2,294,90,LTAdatasets/8701/annotate/8701-2021_03_20_105128.jpg,287.5,84.5,0.44921875,0.23472222222222222,0.0203125,0.030555555555555555
8701-2021_03_20_105128.jpg,lorry_truck,11,267,640,7,360,84,2,278,91,LTAdatasets/8701/annotate/8701-2021_03_20_105128.jpg,272.5,87.5,0.42578125,0.24305555555555555,0.0171875,0.019444444444444445
8701-2021_03_20_192735.jpg,lorry_truck,23,198,640,30,360,161,2,221,191,LTAdatasets/8701/annotate/8701-2021_03_20_192735.jpg,209.5,176.0,0.32734375,0.4888888888888889,0.0359375,0.08333333333333333
8701-2021_03_20_192735.jpg,lorry_truck,28,164,640,43,360,246,2,192,289,LTAdatasets/8701/annotate/8701-2021_03_20_192735.jpg,178.0,267.5,0.278125,0.7430555555555556,0.04375,0.11944444444444445
8701-2021_03_20_192735.jpg,car,24,179,640,21,360,191,1,203,212,LTAdatasets/8701/annotate/8701-2021_03_20_192735.jpg,191.0,201.5,0.2984375,0.5597222222222222,0.0375,0.058333333333333334
8701-2021_03_20_192735.jpg,car,17,228,640,11,360,126,1,245,137,LTAdatasets/8701/annotate/8701-2021_03_20_192735.jpg,236.5,131.5,0.36953125,0.36527777777777776,0.0265625,0.030555555555555555
8701-2021_03_20_192735.jpg,car,12,179,640,15,360,117,1,191,132,LTAdatasets/8701/annotate/8701-2021_03_20_192735.jpg,185.0,124.5,0.2890625,0.3458333333333333,0.01875,0.041666666666666664
8701-2021_03_20_192735.jpg,car,14,176,640,9,360,98,1,190,107,LTAdatasets/8701/annotate/8701-2021_03_20_192735.jpg,183.0,102.5,0.2859375,0.2847222222222222,0.021875,0.025
8701-2021_03_20_192735.jpg,lorry_truck,15,280,640,16,360,89,2,295,105,LTAdatasets/8701/annotate/8701-2021_03_20_192735.jpg,287.5,97.0,0.44921875,0.26944444444444443,0.0234375,0.044444444444444446
8701-2021_03_20_192735.jpg,lorry_truck,40,564,640,24,360,86,2,604,110,LTAdatasets/8701/annotate/8701-2021_03_20_192735.jpg,584.0,98.0,0.9125,0.2722222222222222,0.0625,0.06666666666666667
8701-2021_03_20_193935.jpg,car,32,305,640,36,360,233,1,337,269,LTAdatasets/8701/annotate/8701-2021_03_20_193935.jpg,321.0,251.0,0.5015625,0.6972222222222222,0.05,0.1
8701-2021_03_20_193935.jpg,car,26,235,640,23,360,180,1,261,203,LTAdatasets/8701/annotate/8701-2021_03_20_193935.jpg,248.0,191.5,0.3875,0.5319444444444444,0.040625,0.06388888888888888
8701-2021_03_20_193935.jpg,car,23,198,640,21,360,188,1,221,209,LTAdatasets/8701/annotate/8701-2021_03_20_193935.jpg,209.5,198.5,0.32734375,0.5513888888888889,0.0359375,0.058333333333333334
8701-2021_03_20_193935.jpg,car,21,343,640,14,360,153,1,364,167,LTAdatasets/8701/annotate/8701-2021_03_20_193935.jpg,353.5,160.0,0.55234375,0.4444444444444444,0.0328125,0.03888888888888889
8701-2021_03_20_193935.jpg,car,21,164,640,20,360,169,1,185,189,LTAdatasets/8701/annotate/8701-2021_03_20_193935.jpg,174.5,179.0,0.27265625,0.49722222222222223,0.0328125,0.05555555555555555
8701-2021_03_20_193935.jpg,lorry_truck,33,167,640,56,360,278,2,200,334,LTAdatasets/8701/annotate/8701-2021_03_20_193935.jpg,183.5,306.0,0.28671875,0.85,0.0515625,0.15555555555555556
8701-2021_03_20_193935.jpg,car,15,218,640,7,360,111,1,233,118,LTAdatasets/8701/annotate/8701-2021_03_20_193935.jpg,225.5,114.5,0.35234375,0.31805555555555554,0.0234375,0.019444444444444445
8701-2021_03_20_193935.jpg,lorry_truck,18,271,640,10,360,98,2,289,108,LTAdatasets/8701/annotate/8701-2021_03_20_193935.jpg,280.0,103.0,0.4375,0.2861111111111111,0.028125,0.027777777777777776
8701-2021_03_20_193935.jpg,car,45,579,640,21,360,92,1,624,113,LTAdatasets/8701/annotate/8701-2021_03_20_193935.jpg,601.5,102.5,0.93984375,0.2847222222222222,0.0703125,0.058333333333333334
8701-2021_03_20_103347.jpg,lorry_truck,59,432,640,47,360,182,2,491,229,LTAdatasets/8701/annotate/8701-2021_03_20_103347.jpg,461.5,205.5,0.72109375,0.5708333333333333,0.0921875,0.13055555555555556
8701-2021_03_20_103347.jpg,lorry_truck,27,189,640,26,360,156,2,216,182,LTAdatasets/8701/annotate/8701-2021_03_20_103347.jpg,202.5,169.0,0.31640625,0.46944444444444444,0.0421875,0.07222222222222222
8701-2021_03_20_103347.jpg,lorry_truck,14,184,640,10,360,117,2,198,127,LTAdatasets/8701/annotate/8701-2021_03_20_103347.jpg,191.0,122.0,0.2984375,0.3388888888888889,0.021875,0.027777777777777776
8701-2021_03_20_103347.jpg,lorry_truck,16,280,640,12,360,91,2,296,103,LTAdatasets/8701/annotate/8701-2021_03_20_103347.jpg,288.0,97.0,0.45,0.26944444444444443,0.025,0.03333333333333333
8701-2021_03_20_202217.jpg,bike,16,169,640,25,360,214,4,185,239,LTAdatasets/8701/annotate/8701-2021_03_20_202217.jpg,177.0,226.5,0.2765625,0.6291666666666667,0.025,0.06944444444444445
8701-2021_03_20_202217.jpg,lorry_truck,14,178,640,13,360,105,2,192,118,LTAdatasets/8701/annotate/8701-2021_03_20_202217.jpg,185.0,111.5,0.2890625,0.30972222222222223,0.021875,0.03611111111111111
8701-2021_03_20_202217.jpg,lorry_truck,36,429,640,33,360,181,2,465,214,LTAdatasets/8701/annotate/8701-2021_03_20_202217.jpg,447.0,197.5,0.6984375,0.5486111111111112,0.05625,0.09166666666666666
8701-2021_03_20_202217.jpg,van,30,476,640,31,360,191,3,506,222,LTAdatasets/8701/annotate/8701-2021_03_20_202217.jpg,491.0,206.5,0.7671875,0.5736111111111111,0.046875,0.08611111111111111
8701-2021_03_20_202217.jpg,car,33,396,640,25,360,198,1,429,223,LTAdatasets/8701/annotate/8701-2021_03_20_202217.jpg,412.5,210.5,0.64453125,0.5847222222222223,0.0515625,0.06944444444444445
8701-2021_03_20_183952.jpg,car,33,472,640,26,360,216,1,505,242,LTAdatasets/8701/annotate/8701-2021_03_20_183952.jpg,488.5,229.0,0.76328125,0.6361111111111111,0.0515625,0.07222222222222222
8701-2021_03_20_183952.jpg,car,18,366,640,16,360,171,1,384,187,LTAdatasets/8701/annotate/8701-2021_03_20_183952.jpg,375.0,179.0,0.5859375,0.49722222222222223,0.028125,0.044444444444444446
8701-2021_03_20_183952.jpg,car,43,340,640,41,360,286,1,383,327,LTAdatasets/8701/annotate/8701-2021_03_20_183952.jpg,361.5,306.5,0.56484375,0.8513888888888889,0.0671875,0.11388888888888889
8701-2021_03_20_183952.jpg,car,17,315,640,10,360,106,1,332,116,LTAdatasets/8701/annotate/8701-2021_03_20_183952.jpg,323.5,111.0,0.50546875,0.30833333333333335,0.0265625,0.027777777777777776
8701-2021_03_20_183952.jpg,car,18,322,640,13,360,146,1,340,159,LTAdatasets/8701/annotate/8701-2021_03_20_183952.jpg,331.0,152.5,0.5171875,0.4236111111111111,0.028125,0.03611111111111111
8701-2021_03_20_183952.jpg,car,17,198,640,12,360,123,1,215,135,LTAdatasets/8701/annotate/8701-2021_03_20_183952.jpg,206.5,129.0,0.32265625,0.35833333333333334,0.0265625,0.03333333333333333
8701-2021_03_20_183952.jpg,car,11,198,640,9,360,102,1,209,111,LTAdatasets/8701/annotate/8701-2021_03_20_183952.jpg,203.5,106.5,0.31796875,0.29583333333333334,0.0171875,0.025
8701-2021_03_20_183952.jpg,lorry_truck,23,549,640,14,360,91,2,572,105,LTAdatasets/8701/annotate/8701-2021_03_20_183952.jpg,560.5,98.0,0.87578125,0.2722222222222222,0.0359375,0.03888888888888889
8701-2021_03_20_183952.jpg,car,15,625,640,8,360,109,1,640,117,LTAdatasets/8701/annotate/8701-2021_03_20_183952.jpg,632.5,113.0,0.98828125,0.3138888888888889,0.0234375,0.022222222222222223
8701-2021_03_20_100705.jpg,car,34,402,640,29,360,230,1,436,259,LTAdatasets/8701/annotate/8701-2021_03_20_100705.jpg,419.0,244.5,0.6546875,0.6791666666666667,0.053125,0.08055555555555556
8701-2021_03_20_100705.jpg,car,28,398,640,26,360,194,1,426,220,LTAdatasets/8701/annotate/8701-2021_03_20_100705.jpg,412.0,207.0,0.64375,0.575,0.04375,0.07222222222222222
8701-2021_03_20_100705.jpg,bike,17,460,640,20,360,234,4,477,254,LTAdatasets/8701/annotate/8701-2021_03_20_100705.jpg,468.5,244.0,0.73203125,0.6777777777777778,0.0265625,0.05555555555555555
8701-2021_03_20_100705.jpg,van,23,164,640,34,360,204,3,187,238,LTAdatasets/8701/annotate/8701-2021_03_20_100705.jpg,175.5,221.0,0.27421875,0.6138888888888889,0.0359375,0.09444444444444444
8701-2021_03_20_100705.jpg,lorry_truck,22,372,640,20,360,129,2,394,149,LTAdatasets/8701/annotate/8701-2021_03_20_100705.jpg,383.0,139.0,0.5984375,0.3861111111111111,0.034375,0.05555555555555555
8701-2021_03_20_100705.jpg,lorry_truck,23,339,640,18,360,122,2,362,140,LTAdatasets/8701/annotate/8701-2021_03_20_100705.jpg,350.5,131.0,0.54765625,0.3638888888888889,0.0359375,0.05
8701-2021_03_20_100705.jpg,car,21,321,640,15,360,134,1,342,149,LTAdatasets/8701/annotate/8701-2021_03_20_100705.jpg,331.5,141.5,0.51796875,0.39305555555555555,0.0328125,0.041666666666666664
8701-2021_03_20_100705.jpg,bus,45,595,640,34,360,82,5,640,116,LTAdatasets/8701/annotate/8701-2021_03_20_100705.jpg,617.5,99.0,0.96484375,0.275,0.0703125,0.09444444444444444
8701-2021_03_20_100705.jpg,lorry_truck,16,191,640,20,360,137,2,207,157,LTAdatasets/8701/annotate/8701-2021_03_20_100705.jpg,199.0,147.0,0.3109375,0.4083333333333333,0.025,0.05555555555555555
8701-2021_03_20_124534.jpg,car,44,320,640,31,360,269,1,364,300,LTAdatasets/8701/annotate/8701-2021_03_20_124534.jpg,342.0,284.5,0.534375,0.7902777777777777,0.06875,0.08611111111111111
8701-2021_03_20_124534.jpg,car,33,532,640,23,360,234,1,565,257,LTAdatasets/8701/annotate/8701-2021_03_20_124534.jpg,548.5,245.5,0.85703125,0.6819444444444445,0.0515625,0.06388888888888888
8701-2021_03_20_124534.jpg,car,36,439,640,33,360,222,1,475,255,LTAdatasets/8701/annotate/8701-2021_03_20_124534.jpg,457.0,238.5,0.7140625,0.6625,0.05625,0.09166666666666666
8701-2021_03_20_124534.jpg,car,18,223,640,15,360,156,1,241,171,LTAdatasets/8701/annotate/8701-2021_03_20_124534.jpg,232.0,163.5,0.3625,0.45416666666666666,0.028125,0.041666666666666664
8701-2021_03_20_124534.jpg,car,18,206,640,13,360,134,1,224,147,LTAdatasets/8701/annotate/8701-2021_03_20_124534.jpg,215.0,140.5,0.3359375,0.3902777777777778,0.028125,0.03611111111111111
8701-2021_03_20_124534.jpg,lorry_truck,16,300,640,14,360,102,2,316,116,LTAdatasets/8701/annotate/8701-2021_03_20_124534.jpg,308.0,109.0,0.48125,0.30277777777777776,0.025,0.03888888888888889
8701-2021_03_20_124534.jpg,car,17,197,640,8,360,111,1,214,119,LTAdatasets/8701/annotate/8701-2021_03_20_124534.jpg,205.5,115.0,0.32109375,0.3194444444444444,0.0265625,0.022222222222222223
8701-2021_03_20_100105.jpg,lorry_truck,50,394,640,52,360,147,2,444,199,LTAdatasets/8701/annotate/8701-2021_03_20_100105.jpg,419.0,173.0,0.6546875,0.48055555555555557,0.078125,0.14444444444444443
8701-2021_03_20_100105.jpg,lorry_truck,43,562,640,50,360,231,2,605,281,LTAdatasets/8701/annotate/8701-2021_03_20_100105.jpg,583.5,256.0,0.91171875,0.7111111111111111,0.0671875,0.1388888888888889
8701-2021_03_20_100105.jpg,lorry_truck,23,345,640,25,360,128,2,368,153,LTAdatasets/8701/annotate/8701-2021_03_20_100105.jpg,356.5,140.5,0.55703125,0.3902777777777778,0.0359375,0.06944444444444445
8701-2021_03_20_100105.jpg,lorry_truck,24,199,640,26,360,168,2,223,194,LTAdatasets/8701/annotate/8701-2021_03_20_100105.jpg,211.0,181.0,0.3296875,0.5027777777777778,0.0375,0.07222222222222222
8701-2021_03_20_100105.jpg,lorry_truck,17,182,640,18,360,105,2,199,123,LTAdatasets/8701/annotate/8701-2021_03_20_100105.jpg,190.5,114.0,0.29765625,0.31666666666666665,0.0265625,0.05
8701-2021_03_20_100105.jpg,car,12,211,640,13,360,125,1,223,138,LTAdatasets/8701/annotate/8701-2021_03_20_100105.jpg,217.0,131.5,0.3390625,0.36527777777777776,0.01875,0.03611111111111111
8701-2021_03_20_100105.jpg,car,18,229,640,12,360,123,1,247,135,LTAdatasets/8701/annotate/8701-2021_03_20_100105.jpg,238.0,129.0,0.371875,0.35833333333333334,0.028125,0.03333333333333333
8701-2021_03_20_100105.jpg,lorry_truck,18,265,640,20,360,74,2,283,94,LTAdatasets/8701/annotate/8701-2021_03_20_100105.jpg,274.0,84.0,0.428125,0.23333333333333334,0.028125,0.05555555555555555
8701-2021_03_20_100105.jpg,lorry_truck,27,566,640,23,360,86,2,593,109,LTAdatasets/8701/annotate/8701-2021_03_20_100105.jpg,579.5,97.5,0.90546875,0.2708333333333333,0.0421875,0.06388888888888888
8701-2021_03_20_115511.jpg,lorry_truck,39,223,640,40,360,163,2,262,203,LTAdatasets/8701/annotate/8701-2021_03_20_115511.jpg,242.5,183.0,0.37890625,0.5083333333333333,0.0609375,0.1111111111111111
8701-2021_03_20_115511.jpg,lorry_truck,20,275,640,20,360,191,2,295,211,LTAdatasets/8701/annotate/8701-2021_03_20_115511.jpg,285.0,201.0,0.4453125,0.5583333333333333,0.03125,0.05555555555555555
8701-2021_03_20_115511.jpg,bus,19,179,640,25,360,110,5,198,135,LTAdatasets/8701/annotate/8701-2021_03_20_115511.jpg,188.5,122.5,0.29453125,0.3402777777777778,0.0296875,0.06944444444444445
8701-2021_03_20_115511.jpg,car,15,224,640,10,360,119,1,239,129,LTAdatasets/8701/annotate/8701-2021_03_20_115511.jpg,231.5,124.0,0.36171875,0.34444444444444444,0.0234375,0.027777777777777776
8701-2021_03_20_115511.jpg,car,12,204,640,10,360,120,1,216,130,LTAdatasets/8701/annotate/8701-2021_03_20_115511.jpg,210.0,125.0,0.328125,0.3472222222222222,0.01875,0.027777777777777776
8701-2021_03_20_115511.jpg,car,11,215,640,10,360,99,1,226,109,LTAdatasets/8701/annotate/8701-2021_03_20_115511.jpg,220.5,104.0,0.34453125,0.28888888888888886,0.0171875,0.027777777777777776
8701-2021_03_20_115511.jpg,lorry_truck,17,157,640,22,360,90,2,174,112,LTAdatasets/8701/annotate/8701-2021_03_20_115511.jpg,165.5,101.0,0.25859375,0.28055555555555556,0.0265625,0.06111111111111111
8701-2021_03_20_115511.jpg,car,49,378,640,29,360,331,1,427,360,LTAdatasets/8701/annotate/8701-2021_03_20_115511.jpg,402.5,345.5,0.62890625,0.9597222222222223,0.0765625,0.08055555555555556
8701-2021_03_20_115511.jpg,car,10,264,640,9,360,94,1,274,103,LTAdatasets/8701/annotate/8701-2021_03_20_115511.jpg,269.0,98.5,0.4203125,0.27361111111111114,0.015625,0.025
8701-2021_03_20_190634.jpg,lorry_truck,35,216,640,52,360,245,2,251,297,LTAdatasets/8701/annotate/8701-2021_03_20_190634.jpg,233.5,271.0,0.36484375,0.7527777777777778,0.0546875,0.14444444444444443
8701-2021_03_20_190634.jpg,car,22,161,640,18,360,214,1,183,232,LTAdatasets/8701/annotate/8701-2021_03_20_190634.jpg,172.0,223.0,0.26875,0.6194444444444445,0.034375,0.05
8701-2021_03_20_190634.jpg,lorry_truck,12,164,640,17,360,133,2,176,150,LTAdatasets/8701/annotate/8701-2021_03_20_190634.jpg,170.0,141.5,0.265625,0.39305555555555555,0.01875,0.04722222222222222
8701-2021_03_20_190634.jpg,bus,16,175,640,19,360,90,5,191,109,LTAdatasets/8701/annotate/8701-2021_03_20_190634.jpg,183.0,99.5,0.2859375,0.2763888888888889,0.025,0.05277777777777778
8701-2021_03_20_190634.jpg,lorry_truck,15,291,640,12,360,86,2,306,98,LTAdatasets/8701/annotate/8701-2021_03_20_190634.jpg,298.5,92.0,0.46640625,0.25555555555555554,0.0234375,0.03333333333333333
8701-2021_03_20_190634.jpg,car,13,275,640,9,360,98,1,288,107,LTAdatasets/8701/annotate/8701-2021_03_20_190634.jpg,281.5,102.5,0.43984375,0.2847222222222222,0.0203125,0.025
8701-2021_03_20_190634.jpg,van,11,163,640,10,360,103,3,174,113,LTAdatasets/8701/annotate/8701-2021_03_20_190634.jpg,168.5,108.0,0.26328125,0.3,0.0171875,0.027777777777777776
8701-2021_03_20_192214.jpg,lorry_truck,59,576,640,60,360,277,2,635,337,LTAdatasets/8701/annotate/8701-2021_03_20_192214.jpg,605.5,307.0,0.94609375,0.8527777777777777,0.0921875,0.16666666666666666
8701-2021_03_20_192214.jpg,car,36,403,640,25,360,198,1,439,223,LTAdatasets/8701/annotate/8701-2021_03_20_192214.jpg,421.0,210.5,0.6578125,0.5847222222222223,0.05625,0.06944444444444445
8701-2021_03_20_192214.jpg,van,14,305,640,16,360,117,3,319,133,LTAdatasets/8701/annotate/8701-2021_03_20_192214.jpg,312.0,125.0,0.4875,0.3472222222222222,0.021875,0.044444444444444446
8701-2021_03_20_192214.jpg,lorry_truck,42,161,640,70,360,251,2,203,321,LTAdatasets/8701/annotate/8701-2021_03_20_192214.jpg,182.0,286.0,0.284375,0.7944444444444444,0.065625,0.19444444444444445
8701-2021_03_20_192214.jpg,lorry_truck,17,309,640,11,360,108,2,326,119,LTAdatasets/8701/annotate/8701-2021_03_20_192214.jpg,317.5,113.5,0.49609375,0.31527777777777777,0.0265625,0.030555555555555555
8701-2021_03_20_113050.jpg,car,35,529,640,31,360,228,1,564,259,LTAdatasets/8701/annotate/8701-2021_03_20_113050.jpg,546.5,243.5,0.85390625,0.6763888888888889,0.0546875,0.08611111111111111
8701-2021_03_20_113050.jpg,lorry_truck,50,552,640,46,360,270,2,602,316,LTAdatasets/8701/annotate/8701-2021_03_20_113050.jpg,577.0,293.0,0.9015625,0.8138888888888889,0.078125,0.12777777777777777
8701-2021_03_20_113050.jpg,lorry_truck,31,377,640,29,360,172,2,408,201,LTAdatasets/8701/annotate/8701-2021_03_20_113050.jpg,392.5,186.5,0.61328125,0.5180555555555556,0.0484375,0.08055555555555556
8701-2021_03_20_113050.jpg,bike,11,350,640,18,360,143,4,361,161,LTAdatasets/8701/annotate/8701-2021_03_20_113050.jpg,355.5,152.0,0.55546875,0.4222222222222222,0.0171875,0.05
8701-2021_03_20_112510.jpg,car,46,507,640,43,360,281,1,553,324,LTAdatasets/8701/annotate/8701-2021_03_20_112510.jpg,530.0,302.5,0.828125,0.8402777777777778,0.071875,0.11944444444444445
8701-2021_03_20_112510.jpg,car,11,329,640,12,360,110,1,340,122,LTAdatasets/8701/annotate/8701-2021_03_20_112510.jpg,334.5,116.0,0.52265625,0.32222222222222224,0.0171875,0.03333333333333333
8701-2021_03_20_112510.jpg,car,18,209,640,15,360,126,1,227,141,LTAdatasets/8701/annotate/8701-2021_03_20_112510.jpg,218.0,133.5,0.340625,0.37083333333333335,0.028125,0.041666666666666664
8701-2021_03_20_112510.jpg,lorry_truck,18,272,640,13,360,84,2,290,97,LTAdatasets/8701/annotate/8701-2021_03_20_112510.jpg,281.0,90.5,0.4390625,0.2513888888888889,0.028125,0.03611111111111111
8701-2021_03_20_112510.jpg,lorry_truck,10,255,640,11,360,72,2,265,83,LTAdatasets/8701/annotate/8701-2021_03_20_112510.jpg,260.0,77.5,0.40625,0.2152777777777778,0.015625,0.030555555555555555
8701-2021_03_20_111009.jpg,lorry_truck,27,454,640,33,360,193,2,481,226,LTAdatasets/8701/annotate/8701-2021_03_20_111009.jpg,467.5,209.5,0.73046875,0.5819444444444445,0.0421875,0.09166666666666666
8701-2021_03_20_111009.jpg,lorry_truck,69,571,640,66,360,267,2,640,333,LTAdatasets/8701/annotate/8701-2021_03_20_111009.jpg,605.5,300.0,0.94609375,0.8333333333333334,0.1078125,0.18333333333333332
8701-2021_03_20_111009.jpg,lorry_truck,17,476,640,25,360,182,2,493,207,LTAdatasets/8701/annotate/8701-2021_03_20_111009.jpg,484.5,194.5,0.75703125,0.5402777777777777,0.0265625,0.06944444444444445
8701-2021_03_20_111009.jpg,van,29,384,640,25,360,171,3,413,196,LTAdatasets/8701/annotate/8701-2021_03_20_111009.jpg,398.5,183.5,0.62265625,0.5097222222222222,0.0453125,0.06944444444444445
8701-2021_03_20_111009.jpg,car,20,363,640,18,360,132,1,383,150,LTAdatasets/8701/annotate/8701-2021_03_20_111009.jpg,373.0,141.0,0.5828125,0.39166666666666666,0.03125,0.05
8701-2021_03_20_111009.jpg,lorry_truck,16,307,640,22,360,98,2,323,120,LTAdatasets/8701/annotate/8701-2021_03_20_111009.jpg,315.0,109.0,0.4921875,0.30277777777777776,0.025,0.06111111111111111
8701-2021_03_20_111009.jpg,bike,20,293,640,22,360,204,4,313,226,LTAdatasets/8701/annotate/8701-2021_03_20_111009.jpg,303.0,215.0,0.4734375,0.5972222222222222,0.03125,0.06111111111111111
8701-2021_03_20_111009.jpg,car,12,270,640,7,360,97,1,282,104,LTAdatasets/8701/annotate/8701-2021_03_20_111009.jpg,276.0,100.5,0.43125,0.2791666666666667,0.01875,0.019444444444444445
8701-2021_03_20_120412.jpg,bike,15,294,640,28,360,248,4,309,276,LTAdatasets/8701/annotate/8701-2021_03_20_120412.jpg,301.5,262.0,0.47109375,0.7277777777777777,0.0234375,0.07777777777777778
8701-2021_03_20_120412.jpg,car,17,223,640,15,360,156,1,240,171,LTAdatasets/8701/annotate/8701-2021_03_20_120412.jpg,231.5,163.5,0.36171875,0.45416666666666666,0.0265625,0.041666666666666664
8701-2021_03_20_120412.jpg,car,20,168,640,16,360,177,1,188,193,LTAdatasets/8701/annotate/8701-2021_03_20_120412.jpg,178.0,185.0,0.278125,0.5138888888888888,0.03125,0.044444444444444446
8701-2021_03_20_120412.jpg,car,14,163,640,15,360,132,1,177,147,LTAdatasets/8701/annotate/8701-2021_03_20_120412.jpg,170.0,139.5,0.265625,0.3875,0.021875,0.041666666666666664
8701-2021_03_20_120412.jpg,car,12,162,640,9,360,118,1,174,127,LTAdatasets/8701/annotate/8701-2021_03_20_120412.jpg,168.0,122.5,0.2625,0.3402777777777778,0.01875,0.025
8701-2021_03_20_120412.jpg,lorry_truck,14,305,640,12,360,97,2,319,109,LTAdatasets/8701/annotate/8701-2021_03_20_120412.jpg,312.0,103.0,0.4875,0.2861111111111111,0.021875,0.03333333333333333
8701-2021_03_20_120412.jpg,lorry_truck,16,178,640,20,360,100,2,194,120,LTAdatasets/8701/annotate/8701-2021_03_20_120412.jpg,186.0,110.0,0.290625,0.3055555555555556,0.025,0.05555555555555555
8701-2021_03_20_110709.jpg,car,28,377,640,22,360,177,1,405,199,LTAdatasets/8701/annotate/8701-2021_03_20_110709.jpg,391.0,188.0,0.6109375,0.5222222222222223,0.04375,0.06111111111111111
8701-2021_03_20_110709.jpg,car,11,279,640,10,360,100,1,290,110,LTAdatasets/8701/annotate/8701-2021_03_20_110709.jpg,284.5,105.0,0.44453125,0.2916666666666667,0.0171875,0.027777777777777776
8701-2021_03_20_110709.jpg,bus,15,175,640,18,360,91,5,190,109,LTAdatasets/8701/annotate/8701-2021_03_20_110709.jpg,182.5,100.0,0.28515625,0.2777777777777778,0.0234375,0.05
8701-2021_03_20_101306.jpg,lorry_truck,39,271,640,48,360,244,2,310,292,LTAdatasets/8701/annotate/8701-2021_03_20_101306.jpg,290.5,268.0,0.45390625,0.7444444444444445,0.0609375,0.13333333333333333
8701-2021_03_20_101306.jpg,lorry_truck,27,210,640,29,360,189,2,237,218,LTAdatasets/8701/annotate/8701-2021_03_20_101306.jpg,223.5,203.5,0.34921875,0.5652777777777778,0.0421875,0.08055555555555556
8701-2021_03_20_101306.jpg,lorry_truck,26,351,640,28,360,124,2,377,152,LTAdatasets/8701/annotate/8701-2021_03_20_101306.jpg,364.0,138.0,0.56875,0.38333333333333336,0.040625,0.07777777777777778
8701-2021_03_20_101306.jpg,car,26,352,640,22,360,156,1,378,178,LTAdatasets/8701/annotate/8701-2021_03_20_101306.jpg,365.0,167.0,0.5703125,0.4638888888888889,0.040625,0.06111111111111111
8701-2021_03_20_101306.jpg,lorry_truck,19,319,640,14,360,113,2,338,127,LTAdatasets/8701/annotate/8701-2021_03_20_101306.jpg,328.5,120.0,0.51328125,0.3333333333333333,0.0296875,0.03888888888888889
8701-2021_03_20_101306.jpg,lorry_truck,13,282,640,17,360,83,2,295,100,LTAdatasets/8701/annotate/8701-2021_03_20_101306.jpg,288.5,91.5,0.45078125,0.25416666666666665,0.0203125,0.04722222222222222
8701-2021_03_20_101306.jpg,car,12,306,640,11,360,95,1,318,106,LTAdatasets/8701/annotate/8701-2021_03_20_101306.jpg,312.0,100.5,0.4875,0.2791666666666667,0.01875,0.030555555555555555
8701-2021_03_20_101306.jpg,car,17,198,640,12,360,110,1,215,122,LTAdatasets/8701/annotate/8701-2021_03_20_101306.jpg,206.5,116.0,0.32265625,0.32222222222222224,0.0265625,0.03333333333333333
8701-2021_03_20_121552.jpg,car,16,243,640,12,360,148,1,259,160,LTAdatasets/8701/annotate/8701-2021_03_20_121552.jpg,251.0,154.0,0.3921875,0.42777777777777776,0.025,0.03333333333333333
8701-2021_03_20_121552.jpg,car,20,201,640,13,360,140,1,221,153,LTAdatasets/8701/annotate/8701-2021_03_20_121552.jpg,211.0,146.5,0.3296875,0.40694444444444444,0.03125,0.03611111111111111
8701-2021_03_20_121552.jpg,car,16,333,640,17,360,137,1,349,154,LTAdatasets/8701/annotate/8701-2021_03_20_121552.jpg,341.0,145.5,0.5328125,0.4041666666666667,0.025,0.04722222222222222
8701-2021_03_20_121552.jpg,car,13,283,640,11,360,104,1,296,115,LTAdatasets/8701/annotate/8701-2021_03_20_121552.jpg,289.5,109.5,0.45234375,0.30416666666666664,0.0203125,0.030555555555555555
8701-2021_03_20_121552.jpg,car,11,176,640,9,360,95,1,187,104,LTAdatasets/8701/annotate/8701-2021_03_20_121552.jpg,181.5,99.5,0.28359375,0.2763888888888889,0.0171875,0.025
1505-2021_03_20_100105.jpg,car,22,187,320,20,240,102,1,209,122,LTAdatasets/1505/annotate/1505-2021_03_20_100105.jpg,198.0,112.0,0.61875,0.4666666666666667,0.06875,0.08333333333333333
1505-2021_03_20_194916.jpg,car,19,188,320,13,240,105,1,207,118,LTAdatasets/1505/annotate/1505-2021_03_20_194916.jpg,197.5,111.5,0.6171875,0.46458333333333335,0.059375,0.05416666666666667
1505-2021_03_20_181251.jpg,car,12,195,320,9,240,102,1,207,111,LTAdatasets/1505/annotate/1505-2021_03_20_181251.jpg,201.0,106.5,0.628125,0.44375,0.0375,0.0375
1505-2021_03_20_180410.jpg,car,14,197,320,9,240,103,1,211,112,LTAdatasets/1505/annotate/1505-2021_03_20_180410.jpg,204.0,107.5,0.6375,0.4479166666666667,0.04375,0.0375
1505-2021_03_20_190413.jpg,car,13,210,320,9,240,101,1,223,110,LTAdatasets/1505/annotate/1505-2021_03_20_190413.jpg,216.5,105.5,0.6765625,0.4395833333333333,0.040625,0.0375
1505-2021_03_20_083340.jpg,car,13,195,320,8,240,103,1,208,111,LTAdatasets/1505/annotate/1505-2021_03_20_083340.jpg,201.5,107.0,0.6296875,0.44583333333333336,0.040625,0.03333333333333333
1505-2021_03_20_212801.jpg,car,21,183,320,11,240,104,1,204,115,LTAdatasets/1505/annotate/1505-2021_03_20_212801.jpg,193.5,109.5,0.6046875,0.45625,0.065625,0.04583333333333333
1505-2021_03_20_212801.jpg,car,20,222,320,22,240,101,1,242,123,LTAdatasets/1505/annotate/1505-2021_03_20_212801.jpg,232.0,112.0,0.725,0.4666666666666667,0.0625,0.09166666666666666
1505-2021_03_20_193415.jpg,car,12,209,320,5,240,105,1,221,110,LTAdatasets/1505/annotate/1505-2021_03_20_193415.jpg,215.0,107.5,0.671875,0.4479166666666667,0.0375,0.020833333333333332
1505-2021_03_20_094305.jpg,car,12,211,320,8,240,103,1,223,111,LTAdatasets/1505/annotate/1505-2021_03_20_094305.jpg,217.0,107.0,0.678125,0.44583333333333336,0.0375,0.03333333333333333
1505-2021_03_20_192515.jpg,lorry_truck,151,0,320,111,240,129,2,151,240,LTAdatasets/1505/annotate/1505-2021_03_20_192515.jpg,75.5,184.5,0.2359375,0.76875,0.471875,0.4625
1505-2021_03_20_191914.jpg,car,14,209,320,8,240,105,1,223,113,LTAdatasets/1505/annotate/1505-2021_03_20_191914.jpg,216.0,109.0,0.675,0.45416666666666666,0.04375,0.03333333333333333
1505-2021_03_20_183412.jpg,car,44,175,320,35,240,114,1,219,149,LTAdatasets/1505/annotate/1505-2021_03_20_183412.jpg,197.0,131.5,0.615625,0.5479166666666667,0.1375,0.14583333333333334
1505-2021_03_20_183412.jpg,car,10,211,320,6,240,104,1,221,110,LTAdatasets/1505/annotate/1505-2021_03_20_183412.jpg,216.0,107.0,0.675,0.44583333333333336,0.03125,0.025
1505-2021_03_20_094024.jpg,van,15,216,320,16,240,97,3,231,113,LTAdatasets/1505/annotate/1505-2021_03_20_094024.jpg,223.5,105.0,0.6984375,0.4375,0.046875,0.06666666666666667
1505-2021_03_20_214021.jpg,car,109,0,320,80,240,160,1,109,240,LTAdatasets/1505/annotate/1505-2021_03_20_214021.jpg,54.5,200.0,0.1703125,0.8333333333333334,0.340625,0.3333333333333333
1505-2021_03_20_214021.jpg,lorry_truck,11,212,320,10,240,101,2,223,111,LTAdatasets/1505/annotate/1505-2021_03_20_214021.jpg,217.5,106.0,0.6796875,0.44166666666666665,0.034375,0.041666666666666664
1505-2021_03_20_065755.jpg,car,12,215,320,8,240,104,1,227,112,LTAdatasets/1505/annotate/1505-2021_03_20_065755.jpg,221.0,108.0,0.690625,0.45,0.0375,0.03333333333333333
1505-2021_03_20_204018.jpg,car,20,195,320,12,240,103,1,215,115,LTAdatasets/1505/annotate/1505-2021_03_20_204018.jpg,205.0,109.0,0.640625,0.45416666666666666,0.0625,0.05
1505-2021_03_20_181011.jpg,car,58,156,320,38,240,114,1,214,152,LTAdatasets/1505/annotate/1505-2021_03_20_181011.jpg,185.0,133.0,0.578125,0.5541666666666667,0.18125,0.15833333333333333
1505-2021_03_20_181011.jpg,car,17,200,320,16,240,100,1,217,116,LTAdatasets/1505/annotate/1505-2021_03_20_181011.jpg,208.5,108.0,0.6515625,0.45,0.053125,0.06666666666666667
1505-2021_03_20_181011.jpg,car,10,217,320,11,240,101,1,227,112,LTAdatasets/1505/annotate/1505-2021_03_20_181011.jpg,222.0,106.5,0.69375,0.44375,0.03125,0.04583333333333333
1505-2021_03_20_184613.jpg,van,8,201,320,10,240,100,3,209,110,LTAdatasets/1505/annotate/1505-2021_03_20_184613.jpg,205.0,105.0,0.640625,0.4375,0.025,0.041666666666666664
1505-2021_03_20_210940.jpg,car,19,223,320,11,240,105,1,242,116,LTAdatasets/1505/annotate/1505-2021_03_20_210940.jpg,232.5,110.5,0.7265625,0.46041666666666664,0.059375,0.04583333333333333
1505-2021_03_20_210940.jpg,car,18,197,320,10,240,102,1,215,112,LTAdatasets/1505/annotate/1505-2021_03_20_210940.jpg,206.0,107.0,0.64375,0.44583333333333336,0.05625,0.041666666666666664
1505-2021_03_20_182752.jpg,car,14,215,320,13,240,100,1,229,113,LTAdatasets/1505/annotate/1505-2021_03_20_182752.jpg,222.0,106.5,0.69375,0.44375,0.04375,0.05416666666666667
1505-2021_03_20_095505.jpg,lorry_truck,14,214,320,12,240,99,2,228,111,LTAdatasets/1505/annotate/1505-2021_03_20_095505.jpg,221.0,105.0,0.690625,0.4375,0.04375,0.05
1505-2021_03_20_092803.jpg,car,14,219,320,15,240,100,1,233,115,LTAdatasets/1505/annotate/1505-2021_03_20_092803.jpg,226.0,107.5,0.70625,0.4479166666666667,0.04375,0.0625
1505-2021_03_20_181851.jpg,van,9,213,320,10,240,101,3,222,111,LTAdatasets/1505/annotate/1505-2021_03_20_181851.jpg,217.5,106.0,0.6796875,0.44166666666666665,0.028125,0.041666666666666664
1505-2021_03_20_193935.jpg,bike,9,222,320,14,240,103,4,231,117,LTAdatasets/1505/annotate/1505-2021_03_20_193935.jpg,226.5,110.0,0.7078125,0.4583333333333333,0.028125,0.058333333333333334
1505-2021_03_20_220943.jpg,bike,25,176,320,46,240,117,4,201,163,LTAdatasets/1505/annotate/1505-2021_03_20_220943.jpg,188.5,140.0,0.5890625,0.5833333333333334,0.078125,0.19166666666666668
1505-2021_03_20_074318.jpg,lorry_truck,34,203,320,42,240,86,2,237,128,LTAdatasets/1505/annotate/1505-2021_03_20_074318.jpg,220.0,107.0,0.6875,0.44583333333333336,0.10625,0.175
3702-2021_03_20_090402.jpg,car,22,172,640,15,360,78,1,194,93,LTAdatasets/3702/annotate/3702-2021_03_20_090402.jpg,183.0,85.5,0.2859375,0.2375,0.034375,0.041666666666666664
3702-2021_03_20_202437.jpg,car,59,83,640,43,360,211,1,142,254,LTAdatasets/3702/annotate/3702-2021_03_20_202437.jpg,112.5,232.5,0.17578125,0.6458333333333334,0.0921875,0.11944444444444445
3702-2021_03_20_202437.jpg,car,12,222,640,14,360,41,1,234,55,LTAdatasets/3702/annotate/3702-2021_03_20_202437.jpg,228.0,48.0,0.35625,0.13333333333333333,0.01875,0.03888888888888889
3702-2021_03_20_183952.jpg,car,37,267,640,23,360,128,1,304,151,LTAdatasets/3702/annotate/3702-2021_03_20_183952.jpg,285.5,139.5,0.44609375,0.3875,0.0578125,0.06388888888888888
3702-2021_03_20_183952.jpg,bike,10,149,640,18,360,83,4,159,101,LTAdatasets/3702/annotate/3702-2021_03_20_183952.jpg,154.0,92.0,0.240625,0.25555555555555554,0.015625,0.05
3702-2021_03_20_183952.jpg,car,15,225,640,17,360,55,1,240,72,LTAdatasets/3702/annotate/3702-2021_03_20_183952.jpg,232.5,63.5,0.36328125,0.1763888888888889,0.0234375,0.04722222222222222
3702-2021_03_20_183952.jpg,car,13,251,640,13,360,55,1,264,68,LTAdatasets/3702/annotate/3702-2021_03_20_183952.jpg,257.5,61.5,0.40234375,0.17083333333333334,0.0203125,0.03611111111111111
3702-2021_03_20_183952.jpg,car,12,348,640,13,360,58,1,360,71,LTAdatasets/3702/annotate/3702-2021_03_20_183952.jpg,354.0,64.5,0.553125,0.17916666666666667,0.01875,0.03611111111111111
3702-2021_03_20_183952.jpg,car,12,198,640,11,360,49,1,210,60,LTAdatasets/3702/annotate/3702-2021_03_20_183952.jpg,204.0,54.5,0.31875,0.15138888888888888,0.01875,0.030555555555555555
3702-2021_03_20_075138.jpg,lorry_truck,20,156,640,23,360,55,2,176,78,LTAdatasets/3702/annotate/3702-2021_03_20_075138.jpg,166.0,66.5,0.259375,0.18472222222222223,0.03125,0.06388888888888888
3702-2021_03_20_200637.jpg,car,22,262,640,10,360,71,1,284,81,LTAdatasets/3702/annotate/3702-2021_03_20_200637.jpg,273.0,76.0,0.4265625,0.2111111111111111,0.034375,0.027777777777777776
3702-2021_03_20_200637.jpg,car,16,180,640,12,360,56,1,196,68,LTAdatasets/3702/annotate/3702-2021_03_20_200637.jpg,188.0,62.0,0.29375,0.17222222222222222,0.025,0.03333333333333333
3702-2021_03_20_200637.jpg,car,19,221,640,12,360,50,1,240,62,LTAdatasets/3702/annotate/3702-2021_03_20_200637.jpg,230.5,56.0,0.36015625,0.15555555555555556,0.0296875,0.03333333333333333
3702-2021_03_20_081920.jpg,lorry_truck,21,177,640,32,360,66,2,198,98,LTAdatasets/3702/annotate/3702-2021_03_20_081920.jpg,187.5,82.0,0.29296875,0.22777777777777777,0.0328125,0.08888888888888889
3702-2021_03_20_081920.jpg,bike,14,199,640,11,360,51,4,213,62,LTAdatasets/3702/annotate/3702-2021_03_20_081920.jpg,206.0,56.5,0.321875,0.15694444444444444,0.021875,0.030555555555555555
3702-2021_03_20_085141.jpg,car,14,184,640,14,360,56,1,198,70,LTAdatasets/3702/annotate/3702-2021_03_20_085141.jpg,191.0,63.0,0.2984375,0.175,0.021875,0.03888888888888889
3702-2021_03_20_085141.jpg,car,10,163,640,10,360,56,1,173,66,LTAdatasets/3702/annotate/3702-2021_03_20_085141.jpg,168.0,61.0,0.2625,0.16944444444444445,0.015625,0.027777777777777776
3702-2021_03_20_085141.jpg,car,14,180,640,11,360,44,1,194,55,LTAdatasets/3702/annotate/3702-2021_03_20_085141.jpg,187.0,49.5,0.2921875,0.1375,0.021875,0.030555555555555555
3702-2021_03_20_095205.jpg,car,64,359,640,52,360,178,1,423,230,LTAdatasets/3702/annotate/3702-2021_03_20_095205.jpg,391.0,204.0,0.6109375,0.5666666666666667,0.1,0.14444444444444443
3702-2021_03_20_095205.jpg,lorry_truck,32,254,640,29,360,99,2,286,128,LTAdatasets/3702/annotate/3702-2021_03_20_095205.jpg,270.0,113.5,0.421875,0.31527777777777777,0.05,0.08055555555555556
3702-2021_03_20_075518.jpg,lorry_truck,24,167,640,26,360,80,2,191,106,LTAdatasets/3702/annotate/3702-2021_03_20_075518.jpg,179.0,93.0,0.2796875,0.25833333333333336,0.0375,0.07222222222222222
3702-2021_03_20_075518.jpg,car,14,185,640,11,360,44,1,199,55,LTAdatasets/3702/annotate/3702-2021_03_20_075518.jpg,192.0,49.5,0.3,0.1375,0.021875,0.030555555555555555
3702-2021_03_20_085822.jpg,car,18,149,640,22,360,86,1,167,108,LTAdatasets/3702/annotate/3702-2021_03_20_085822.jpg,158.0,97.0,0.246875,0.26944444444444443,0.028125,0.06111111111111111
3702-2021_03_20_190634.jpg,car,35,278,640,29,360,136,1,313,165,LTAdatasets/3702/annotate/3702-2021_03_20_190634.jpg,295.5,150.5,0.46171875,0.41805555555555557,0.0546875,0.08055555555555556
3702-2021_03_20_190634.jpg,bike,16,137,640,19,360,98,4,153,117,LTAdatasets/3702/annotate/3702-2021_03_20_190634.jpg,145.0,107.5,0.2265625,0.2986111111111111,0.025,0.05277777777777778
3702-2021_03_20_190634.jpg,car,14,189,640,15,360,58,1,203,73,LTAdatasets/3702/annotate/3702-2021_03_20_190634.jpg,196.0,65.5,0.30625,0.18194444444444444,0.021875,0.041666666666666664
3702-2021_03_20_085501.jpg,van,90,345,640,81,360,242,3,435,323,LTAdatasets/3702/annotate/3702-2021_03_20_085501.jpg,390.0,282.5,0.609375,0.7847222222222222,0.140625,0.225
3702-2021_03_20_193115.jpg,lorry_truck,57,95,640,80,360,163,2,152,243,LTAdatasets/3702/annotate/3702-2021_03_20_193115.jpg,123.5,203.0,0.19296875,0.5638888888888889,0.0890625,0.2222222222222222
3702-2021_03_20_193115.jpg,bike,11,206,640,23,360,117,4,217,140,LTAdatasets/3702/annotate/3702-2021_03_20_193115.jpg,211.5,128.5,0.33046875,0.35694444444444445,0.0171875,0.06388888888888888
3702-2021_03_20_073717.jpg,car,12,167,640,9,360,57,1,179,66,LTAdatasets/3702/annotate/3702-2021_03_20_073717.jpg,173.0,61.5,0.2703125,0.17083333333333334,0.01875,0.025
3702-2021_03_20_183412.jpg,car,17,236,640,12,360,75,1,253,87,LTAdatasets/3702/annotate/3702-2021_03_20_183412.jpg,244.5,81.0,0.38203125,0.225,0.0265625,0.03333333333333333
3702-2021_03_20_183412.jpg,bike,9,180,640,11,360,62,4,189,73,LTAdatasets/3702/annotate/3702-2021_03_20_183412.jpg,184.5,67.5,0.28828125,0.1875,0.0140625,0.030555555555555555
3702-2021_03_20_073417.jpg,car,21,244,640,20,360,82,1,265,102,LTAdatasets/3702/annotate/3702-2021_03_20_073417.jpg,254.5,92.0,0.39765625,0.25555555555555554,0.0328125,0.05555555555555555
3702-2021_03_20_073417.jpg,car,23,168,640,16,360,83,1,191,99,LTAdatasets/3702/annotate/3702-2021_03_20_073417.jpg,179.5,91.0,0.28046875,0.25277777777777777,0.0359375,0.044444444444444446
3702-2021_03_20_073417.jpg,car,17,226,640,12,360,53,1,243,65,LTAdatasets/3702/annotate/3702-2021_03_20_073417.jpg,234.5,59.0,0.36640625,0.1638888888888889,0.0265625,0.03333333333333333
3702-2021_03_20_082440.jpg,car,25,158,640,26,360,114,1,183,140,LTAdatasets/3702/annotate/3702-2021_03_20_082440.jpg,170.5,127.0,0.26640625,0.3527777777777778,0.0390625,0.07222222222222222
3702-2021_03_20_192515.jpg,car,22,133,640,21,360,105,1,155,126,LTAdatasets/3702/annotate/3702-2021_03_20_192515.jpg,144.0,115.5,0.225,0.32083333333333336,0.034375,0.058333333333333334
3702-2021_03_20_191614.jpg,car,32,177,640,32,360,81,1,209,113,LTAdatasets/3702/annotate/3702-2021_03_20_191614.jpg,193.0,97.0,0.3015625,0.26944444444444443,0.05,0.08888888888888889
3702-2021_03_20_191614.jpg,car,44,1,640,76,360,278,1,45,354,LTAdatasets/3702/annotate/3702-2021_03_20_191614.jpg,23.0,316.0,0.0359375,0.8777777777777778,0.06875,0.2111111111111111
3702-2021_03_20_191614.jpg,bus,17,158,640,15,360,63,5,175,78,LTAdatasets/3702/annotate/3702-2021_03_20_191614.jpg,166.5,70.5,0.26015625,0.19583333333333333,0.0265625,0.041666666666666664
3702-2021_03_20_203658.jpg,car,83,350,640,77,360,247,1,433,324,LTAdatasets/3702/annotate/3702-2021_03_20_203658.jpg,391.5,285.5,0.61171875,0.7930555555555555,0.1296875,0.21388888888888888
3702-2021_03_20_203658.jpg,car,32,185,640,36,360,126,1,217,162,LTAdatasets/3702/annotate/3702-2021_03_20_203658.jpg,201.0,144.0,0.3140625,0.4,0.05,0.1
3702-2021_03_20_203658.jpg,car,22,228,640,14,360,62,1,250,76,LTAdatasets/3702/annotate/3702-2021_03_20_203658.jpg,239.0,69.0,0.3734375,0.19166666666666668,0.034375,0.03888888888888889
3702-2021_03_20_203658.jpg,car,11,185,640,16,360,50,1,196,66,LTAdatasets/3702/annotate/3702-2021_03_20_203658.jpg,190.5,58.0,0.29765625,0.16111111111111112,0.0171875,0.044444444444444446
3702-2021_03_20_192735.jpg,car,44,140,640,37,360,137,1,184,174,LTAdatasets/3702/annotate/3702-2021_03_20_192735.jpg,162.0,155.5,0.253125,0.43194444444444446,0.06875,0.10277777777777777
3702-2021_03_20_192735.jpg,car,16,183,640,18,360,57,1,199,75,LTAdatasets/3702/annotate/3702-2021_03_20_192735.jpg,191.0,66.0,0.2984375,0.18333333333333332,0.025,0.05
3702-2021_03_20_192735.jpg,car,17,233,640,9,360,46,1,250,55,LTAdatasets/3702/annotate/3702-2021_03_20_192735.jpg,241.5,50.5,0.37734375,0.14027777777777778,0.0265625,0.025
3702-2021_03_20_195136.jpg,bus,48,93,640,56,360,115,5,141,171,LTAdatasets/3702/annotate/3702-2021_03_20_195136.jpg,117.0,143.0,0.1828125,0.3972222222222222,0.075,0.15555555555555556
3702-2021_03_20_195136.jpg,car,84,7,640,68,360,292,1,91,360,LTAdatasets/3702/annotate/3702-2021_03_20_195136.jpg,49.0,326.0,0.0765625,0.9055555555555556,0.13125,0.18888888888888888
3702-2021_03_20_195136.jpg,bus,17,166,640,17,360,39,5,183,56,LTAdatasets/3702/annotate/3702-2021_03_20_195136.jpg,174.5,47.5,0.27265625,0.13194444444444445,0.0265625,0.04722222222222222
3702-2021_03_20_185453.jpg,car,28,196,640,32,360,135,1,224,167,LTAdatasets/3702/annotate/3702-2021_03_20_185453.jpg,210.0,151.0,0.328125,0.41944444444444445,0.04375,0.08888888888888889
3702-2021_03_20_185453.jpg,car,25,163,640,24,360,102,1,188,126,LTAdatasets/3702/annotate/3702-2021_03_20_185453.jpg,175.5,114.0,0.27421875,0.31666666666666665,0.0390625,0.06666666666666667
3702-2021_03_20_195736.jpg,car,39,342,640,31,360,148,1,381,179,LTAdatasets/3702/annotate/3702-2021_03_20_195736.jpg,361.5,163.5,0.56484375,0.45416666666666666,0.0609375,0.08611111111111111
3702-2021_03_20_184913.jpg,car,83,370,640,80,360,255,1,453,335,LTAdatasets/3702/annotate/3702-2021_03_20_184913.jpg,411.5,295.0,0.64296875,0.8194444444444444,0.1296875,0.2222222222222222
3702-2021_03_20_184913.jpg,van,16,165,640,23,360,77,3,181,100,LTAdatasets/3702/annotate/3702-2021_03_20_184913.jpg,173.0,88.5,0.2703125,0.24583333333333332,0.025,0.06388888888888888
3702-2021_03_20_184913.jpg,car,64,30,640,78,360,255,1,94,333,LTAdatasets/3702/annotate/3702-2021_03_20_184913.jpg,62.0,294.0,0.096875,0.8166666666666667,0.1,0.21666666666666667
3702-2021_03_20_184913.jpg,bus,39,191,640,60,360,78,5,230,138,LTAdatasets/3702/annotate/3702-2021_03_20_184913.jpg,210.5,108.0,0.32890625,0.3,0.0609375,0.16666666666666666
3702-2021_03_20_184913.jpg,car,17,184,640,16,360,57,1,201,73,LTAdatasets/3702/annotate/3702-2021_03_20_184913.jpg,192.5,65.0,0.30078125,0.18055555555555555,0.0265625,0.044444444444444446
3702-2021_03_20_184913.jpg,bike,11,226,640,12,360,52,4,237,64,LTAdatasets/3702/annotate/3702-2021_03_20_184913.jpg,231.5,58.0,0.36171875,0.16111111111111112,0.0171875,0.03333333333333333
3702-2021_03_20_074318.jpg,bike,10,183,640,16,360,73,4,193,89,LTAdatasets/3702/annotate/3702-2021_03_20_074318.jpg,188.0,81.0,0.29375,0.225,0.015625,0.044444444444444446
3702-2021_03_20_074318.jpg,bike,10,167,640,12,360,54,4,177,66,LTAdatasets/3702/annotate/3702-2021_03_20_074318.jpg,172.0,60.0,0.26875,0.16666666666666666,0.015625,0.03333333333333333
3702-2021_03_20_092803.jpg,bike,12,234,640,14,360,81,4,246,95,LTAdatasets/3702/annotate/3702-2021_03_20_092803.jpg,240.0,88.0,0.375,0.24444444444444444,0.01875,0.03888888888888889
3702-2021_03_20_191914.jpg,car,29,166,640,27,360,113,1,195,140,LTAdatasets/3702/annotate/3702-2021_03_20_191914.jpg,180.5,126.5,0.28203125,0.35138888888888886,0.0453125,0.075
3702-2021_03_20_191914.jpg,car,32,262,640,28,360,107,1,294,135,LTAdatasets/3702/annotate/3702-2021_03_20_191914.jpg,278.0,121.0,0.434375,0.33611111111111114,0.05,0.07777777777777778
3702-2021_03_20_191914.jpg,bus,57,66,640,54,360,138,5,123,192,LTAdatasets/3702/annotate/3702-2021_03_20_191914.jpg,94.5,165.0,0.14765625,0.4583333333333333,0.0890625,0.15
3702-2021_03_20_204018.jpg,car,56,99,640,52,360,184,1,155,236,LTAdatasets/3702/annotate/3702-2021_03_20_204018.jpg,127.0,210.0,0.1984375,0.5833333333333334,0.0875,0.14444444444444443
3702-2021_03_20_192214.jpg,van,20,184,640,21,360,73,3,204,94,LTAdatasets/3702/annotate/3702-2021_03_20_192214.jpg,194.0,83.5,0.303125,0.23194444444444445,0.03125,0.058333333333333334
3702-2021_03_20_192214.jpg,bike,11,161,640,17,360,59,4,172,76,LTAdatasets/3702/annotate/3702-2021_03_20_192214.jpg,166.5,67.5,0.26015625,0.1875,0.0171875,0.04722222222222222
3702-2021_03_20_192214.jpg,car,19,198,640,9,360,50,1,217,59,LTAdatasets/3702/annotate/3702-2021_03_20_192214.jpg,207.5,54.5,0.32421875,0.15138888888888888,0.0296875,0.025
3702-2021_03_20_192214.jpg,car,79,99,640,60,360,300,1,178,360,LTAdatasets/3702/annotate/3702-2021_03_20_192214.jpg,138.5,330.0,0.21640625,0.9166666666666666,0.1234375,0.16666666666666666
3702-2021_03_20_192214.jpg,car,64,2,640,55,360,225,1,66,280,LTAdatasets/3702/annotate/3702-2021_03_20_192214.jpg,34.0,252.5,0.053125,0.7013888888888888,0.1,0.1527777777777778
3702-2021_03_20_182151.jpg,bus,137,290,640,152,360,143,5,427,295,LTAdatasets/3702/annotate/3702-2021_03_20_182151.jpg,358.5,219.0,0.56015625,0.6083333333333333,0.2140625,0.4222222222222222
3702-2021_03_20_182151.jpg,car,26,146,640,30,360,121,1,172,151,LTAdatasets/3702/annotate/3702-2021_03_20_182151.jpg,159.0,136.0,0.2484375,0.37777777777777777,0.040625,0.08333333333333333
3702-2021_03_20_092543.jpg,bike,21,52,640,37,360,189,4,73,226,LTAdatasets/3702/annotate/3702-2021_03_20_092543.jpg,62.5,207.5,0.09765625,0.5763888888888888,0.0328125,0.10277777777777777
3702-2021_03_20_190113.jpg,car,33,146,640,28,360,134,1,179,162,LTAdatasets/3702/annotate/3702-2021_03_20_190113.jpg,162.5,148.0,0.25390625,0.4111111111111111,0.0515625,0.07777777777777778
3702-2021_03_20_190113.jpg,car,30,277,640,24,360,126,1,307,150,LTAdatasets/3702/annotate/3702-2021_03_20_190113.jpg,292.0,138.0,0.45625,0.38333333333333336,0.046875,0.06666666666666667
3702-2021_03_20_190113.jpg,car,26,199,640,23,360,124,1,225,147,LTAdatasets/3702/annotate/3702-2021_03_20_190113.jpg,212.0,135.5,0.33125,0.3763888888888889,0.040625,0.06388888888888888
3702-2021_03_20_190113.jpg,car,16,172,640,19,360,86,1,188,105,LTAdatasets/3702/annotate/3702-2021_03_20_190113.jpg,180.0,95.5,0.28125,0.2652777777777778,0.025,0.05277777777777778
3702-2021_03_20_190113.jpg,car,14,184,640,14,360,65,1,198,79,LTAdatasets/3702/annotate/3702-2021_03_20_190113.jpg,191.0,72.0,0.2984375,0.2,0.021875,0.03888888888888889
3702-2021_03_20_190113.jpg,car,17,228,640,12,360,59,1,245,71,LTAdatasets/3702/annotate/3702-2021_03_20_190113.jpg,236.5,65.0,0.36953125,0.18055555555555555,0.0265625,0.03333333333333333
3702-2021_03_20_190113.jpg,car,17,255,640,12,360,65,1,272,77,LTAdatasets/3702/annotate/3702-2021_03_20_190113.jpg,263.5,71.0,0.41171875,0.19722222222222222,0.0265625,0.03333333333333333
3702-2021_03_20_074618.jpg,car,71,97,640,58,360,302,1,168,360,LTAdatasets/3702/annotate/3702-2021_03_20_074618.jpg,132.5,331.0,0.20703125,0.9194444444444444,0.1109375,0.16111111111111112
3702-2021_03_20_090702.jpg,bike,16,158,640,20,360,72,4,174,92,LTAdatasets/3702/annotate/3702-2021_03_20_090702.jpg,166.0,82.0,0.259375,0.22777777777777777,0.025,0.05555555555555555
3702-2021_03_20_094024.jpg,car,44,128,640,36,360,157,1,172,193,LTAdatasets/3702/annotate/3702-2021_03_20_094024.jpg,150.0,175.0,0.234375,0.4861111111111111,0.06875,0.1
3702-2021_03_20_200416.jpg,car,30,192,640,33,360,141,1,222,174,LTAdatasets/3702/annotate/3702-2021_03_20_200416.jpg,207.0,157.5,0.3234375,0.4375,0.046875,0.09166666666666666
3702-2021_03_20_073037.jpg,car,14,231,640,10,360,49,1,245,59,LTAdatasets/3702/annotate/3702-2021_03_20_073037.jpg,238.0,54.0,0.371875,0.15,0.021875,0.027777777777777776
3702-2021_03_20_080419.jpg,car,43,88,640,33,360,157,1,131,190,LTAdatasets/3702/annotate/3702-2021_03_20_080419.jpg,109.5,173.5,0.17109375,0.48194444444444445,0.0671875,0.09166666666666666
3702-2021_03_20_080119.jpg,car,14,182,640,11,360,49,1,196,60,LTAdatasets/3702/annotate/3702-2021_03_20_080119.jpg,189.0,54.5,0.2953125,0.15138888888888888,0.021875,0.030555555555555555
3702-2021_03_20_182752.jpg,car,16,277,640,14,360,79,1,293,93,LTAdatasets/3702/annotate/3702-2021_03_20_182752.jpg,285.0,86.0,0.4453125,0.2388888888888889,0.025,0.03888888888888889
3702-2021_03_20_182752.jpg,bus,41,242,640,60,360,76,5,283,136,LTAdatasets/3702/annotate/3702-2021_03_20_182752.jpg,262.5,106.0,0.41015625,0.29444444444444445,0.0640625,0.16666666666666666
3702-2021_03_20_182752.jpg,car,17,165,640,14,360,69,1,182,83,LTAdatasets/3702/annotate/3702-2021_03_20_182752.jpg,173.5,76.0,0.27109375,0.2111111111111111,0.0265625,0.03888888888888889
3702-2021_03_20_182752.jpg,car,15,200,640,10,360,60,1,215,70,LTAdatasets/3702/annotate/3702-2021_03_20_182752.jpg,207.5,65.0,0.32421875,0.18055555555555555,0.0234375,0.027777777777777776
3702-2021_03_20_182752.jpg,car,12,233,640,9,360,49,1,245,58,LTAdatasets/3702/annotate/3702-2021_03_20_182752.jpg,239.0,53.5,0.3734375,0.1486111111111111,0.01875,0.025
3702-2021_03_20_080939.jpg,bus,112,36,640,143,360,179,5,148,322,LTAdatasets/3702/annotate/3702-2021_03_20_080939.jpg,92.0,250.5,0.14375,0.6958333333333333,0.175,0.3972222222222222
3702-2021_03_20_201317.jpg,car,15,183,640,15,360,58,1,198,73,LTAdatasets/3702/annotate/3702-2021_03_20_201317.jpg,190.5,65.5,0.29765625,0.18194444444444444,0.0234375,0.041666666666666664
3702-2021_03_20_180110.jpg,car,58,322,640,44,360,199,1,380,243,LTAdatasets/3702/annotate/3702-2021_03_20_180110.jpg,351.0,221.0,0.5484375,0.6138888888888889,0.090625,0.12222222222222222
3702-2021_03_20_180110.jpg,car,30,135,640,29,360,99,1,165,128,LTAdatasets/3702/annotate/3702-2021_03_20_180110.jpg,150.0,113.5,0.234375,0.31527777777777777,0.046875,0.08055555555555556
3702-2021_03_20_084001.jpg,car,17,205,640,15,360,56,1,222,71,LTAdatasets/3702/annotate/3702-2021_03_20_084001.jpg,213.5,63.5,0.33359375,0.1763888888888889,0.0265625,0.041666666666666664
3702-2021_03_20_084001.jpg,car,14,184,640,14,360,62,1,198,76,LTAdatasets/3702/annotate/3702-2021_03_20_084001.jpg,191.0,69.0,0.2984375,0.19166666666666668,0.021875,0.03888888888888889
3702-2021_03_20_194315.jpg,car,66,336,640,60,360,225,1,402,285,LTAdatasets/3702/annotate/3702-2021_03_20_194315.jpg,369.0,255.0,0.5765625,0.7083333333333334,0.103125,0.16666666666666666
3702-2021_03_20_194315.jpg,car,12,191,640,14,360,56,1,203,70,LTAdatasets/3702/annotate/3702-2021_03_20_194315.jpg,197.0,63.0,0.3078125,0.175,0.01875,0.03888888888888889
3702-2021_03_20_074918.jpg,car,14,185,640,15,360,60,1,199,75,LTAdatasets/3702/annotate/3702-2021_03_20_074918.jpg,192.0,67.5,0.3,0.1875,0.021875,0.041666666666666664
3702-2021_03_20_075818.jpg,car,30,185,640,31,360,138,1,215,169,LTAdatasets/3702/annotate/3702-2021_03_20_075818.jpg,200.0,153.5,0.3125,0.4263888888888889,0.046875,0.08611111111111111
3702-2021_03_20_075818.jpg,lorry_truck,24,134,640,27,360,96,2,158,123,LTAdatasets/3702/annotate/3702-2021_03_20_075818.jpg,146.0,109.5,0.228125,0.30416666666666664,0.0375,0.075
3702-2021_03_20_075818.jpg,bike,17,174,640,18,360,95,4,191,113,LTAdatasets/3702/annotate/3702-2021_03_20_075818.jpg,182.5,104.0,0.28515625,0.28888888888888886,0.0265625,0.05
3702-2021_03_20_075818.jpg,car,14,205,640,14,360,66,1,219,80,LTAdatasets/3702/annotate/3702-2021_03_20_075818.jpg,212.0,73.0,0.33125,0.20277777777777778,0.021875,0.03888888888888889
3702-2021_03_20_075818.jpg,bus,17,160,640,19,360,48,5,177,67,LTAdatasets/3702/annotate/3702-2021_03_20_075818.jpg,168.5,57.5,0.26328125,0.1597222222222222,0.0265625,0.05277777777777778
3702-2021_03_20_083340.jpg,car,25,198,640,18,360,90,1,223,108,LTAdatasets/3702/annotate/3702-2021_03_20_083340.jpg,210.5,99.0,0.32890625,0.275,0.0390625,0.05
3702-2021_03_20_191014.jpg,car,40,291,640,29,360,153,1,331,182,LTAdatasets/3702/annotate/3702-2021_03_20_191014.jpg,311.0,167.5,0.4859375,0.4652777777777778,0.0625,0.08055555555555556
3702-2021_03_20_191014.jpg,lorry_truck,52,70,640,53,360,138,2,122,191,LTAdatasets/3702/annotate/3702-2021_03_20_191014.jpg,96.0,164.5,0.15,0.45694444444444443,0.08125,0.14722222222222223
3702-2021_03_20_190413.jpg,car,39,144,640,31,360,152,1,183,183,LTAdatasets/3702/annotate/3702-2021_03_20_190413.jpg,163.5,167.5,0.25546875,0.4652777777777778,0.0609375,0.08611111111111111
3702-2021_03_20_190413.jpg,car,15,202,640,17,360,61,1,217,78,LTAdatasets/3702/annotate/3702-2021_03_20_190413.jpg,209.5,69.5,0.32734375,0.19305555555555556,0.0234375,0.04722222222222222
3702-2021_03_20_190413.jpg,bus,47,0,640,110,360,224,5,47,334,LTAdatasets/3702/annotate/3702-2021_03_20_190413.jpg,23.5,279.0,0.03671875,0.775,0.0734375,0.3055555555555556
3702-2021_03_20_082740.jpg,lorry_truck,135,358,640,104,360,256,2,493,360,LTAdatasets/3702/annotate/3702-2021_03_20_082740.jpg,425.5,308.0,0.66484375,0.8555555555555555,0.2109375,0.28888888888888886
3702-2021_03_20_082740.jpg,car,60,506,640,33,360,284,1,566,317,LTAdatasets/3702/annotate/3702-2021_03_20_082740.jpg,536.0,300.5,0.8375,0.8347222222222223,0.09375,0.09166666666666666
3702-2021_03_20_181011.jpg,car,28,149,640,32,360,131,1,177,163,LTAdatasets/3702/annotate/3702-2021_03_20_181011.jpg,163.0,147.0,0.2546875,0.4083333333333333,0.04375,0.08888888888888889
3702-2021_03_20_181011.jpg,car,18,159,640,15,360,58,1,177,73,LTAdatasets/3702/annotate/3702-2021_03_20_181011.jpg,168.0,65.5,0.2625,0.18194444444444444,0.028125,0.041666666666666664
3702-2021_03_20_184613.jpg,car,28,313,640,26,360,119,1,341,145,LTAdatasets/3702/annotate/3702-2021_03_20_184613.jpg,327.0,132.0,0.5109375,0.36666666666666664,0.04375,0.07222222222222222
3702-2021_03_20_200116.jpg,car,30,263,640,29,360,107,1,293,136,LTAdatasets/3702/annotate/3702-2021_03_20_200116.jpg,278.0,121.5,0.434375,0.3375,0.046875,0.08055555555555556
3702-2021_03_20_200116.jpg,car,23,276,640,19,360,80,1,299,99,LTAdatasets/3702/annotate/3702-2021_03_20_200116.jpg,287.5,89.5,0.44921875,0.24861111111111112,0.0359375,0.05277777777777778
3702-2021_03_20_200116.jpg,bike,10,181,640,15,360,43,4,191,58,LTAdatasets/3702/annotate/3702-2021_03_20_200116.jpg,186.0,50.5,0.290625,0.14027777777777778,0.015625,0.041666666666666664
3702-2021_03_20_200116.jpg,car,9,223,640,8,360,45,1,232,53,LTAdatasets/3702/annotate/3702-2021_03_20_200116.jpg,227.5,49.0,0.35546875,0.1361111111111111,0.0140625,0.022222222222222223
3702-2021_03_20_073937.jpg,car,22,171,640,15,360,89,1,193,104,LTAdatasets/3702/annotate/3702-2021_03_20_073937.jpg,182.0,96.5,0.284375,0.26805555555555555,0.034375,0.041666666666666664
3702-2021_03_20_073937.jpg,lorry_truck,22,241,640,21,360,62,2,263,83,LTAdatasets/3702/annotate/3702-2021_03_20_073937.jpg,252.0,72.5,0.39375,0.2013888888888889,0.034375,0.058333333333333334
3702-2021_03_20_193935.jpg,car,99,472,640,85,360,275,1,571,360,LTAdatasets/3702/annotate/3702-2021_03_20_193935.jpg,521.5,317.5,0.81484375,0.8819444444444444,0.1546875,0.2361111111111111
3702-2021_03_20_193935.jpg,car,22,202,640,20,360,82,1,224,102,LTAdatasets/3702/annotate/3702-2021_03_20_193935.jpg,213.0,92.0,0.3328125,0.25555555555555554,0.034375,0.05555555555555555
3702-2021_03_20_194916.jpg,car,22,187,640,13,360,79,1,209,92,LTAdatasets/3702/annotate/3702-2021_03_20_194916.jpg,198.0,85.5,0.309375,0.2375,0.034375,0.03611111111111111
3702-2021_03_20_194916.jpg,car,51,302,640,50,360,180,1,353,230,LTAdatasets/3702/annotate/3702-2021_03_20_194916.jpg,327.5,205.0,0.51171875,0.5694444444444444,0.0796875,0.1388888888888889
3702-2021_03_20_082220.jpg,car,69,25,640,86,360,270,1,94,356,LTAdatasets/3702/annotate/3702-2021_03_20_082220.jpg,59.5,313.0,0.09296875,0.8694444444444445,0.1078125,0.2388888888888889
3702-2021_03_20_082220.jpg,lorry_truck,26,242,640,32,360,74,2,268,106,LTAdatasets/3702/annotate/3702-2021_03_20_082220.jpg,255.0,90.0,0.3984375,0.25,0.040625,0.08888888888888889
3702-2021_03_20_082220.jpg,lorry_truck,20,141,640,27,360,90,2,161,117,LTAdatasets/3702/annotate/3702-2021_03_20_082220.jpg,151.0,103.5,0.2359375,0.2875,0.03125,0.075
3702-2021_03_20_084601.jpg,lorry_truck,16,185,640,22,360,47,2,201,69,LTAdatasets/3702/annotate/3702-2021_03_20_084601.jpg,193.0,58.0,0.3015625,0.16111111111111112,0.025,0.06111111111111111
3702-2021_03_20_084601.jpg,van,12,164,640,12,360,53,3,176,65,LTAdatasets/3702/annotate/3702-2021_03_20_084601.jpg,170.0,59.0,0.265625,0.1638888888888889,0.01875,0.03333333333333333
3702-2021_03_20_095505.jpg,car,13,203,640,12,360,59,1,216,71,LTAdatasets/3702/annotate/3702-2021_03_20_095505.jpg,209.5,65.0,0.32734375,0.18055555555555555,0.0203125,0.03333333333333333
3702-2021_03_20_193415.jpg,car,79,384,640,66,360,294,1,463,360,LTAdatasets/3702/annotate/3702-2021_03_20_193415.jpg,423.5,327.0,0.66171875,0.9083333333333333,0.1234375,0.18333333333333332
3702-2021_03_20_193415.jpg,lorry_truck,17,151,640,29,360,76,2,168,105,LTAdatasets/3702/annotate/3702-2021_03_20_193415.jpg,159.5,90.5,0.24921875,0.2513888888888889,0.0265625,0.08055555555555556
3702-2021_03_20_193415.jpg,lorry_truck,19,183,640,16,360,50,2,202,66,LTAdatasets/3702/annotate/3702-2021_03_20_193415.jpg,192.5,58.0,0.30078125,0.16111111111111112,0.0296875,0.044444444444444446
3702-2021_03_20_181851.jpg,car,29,107,640,23,360,134,1,136,157,LTAdatasets/3702/annotate/3702-2021_03_20_181851.jpg,121.5,145.5,0.18984375,0.4041666666666667,0.0453125,0.06388888888888888
3702-2021_03_20_181851.jpg,lorry_truck,24,249,640,21,360,84,2,273,105,LTAdatasets/3702/annotate/3702-2021_03_20_181851.jpg,261.0,94.5,0.4078125,0.2625,0.0375,0.058333333333333334
3702-2021_03_20_181851.jpg,car,16,204,640,13,360,69,1,220,82,LTAdatasets/3702/annotate/3702-2021_03_20_181851.jpg,212.0,75.5,0.33125,0.20972222222222223,0.025,0.03611111111111111
3702-2021_03_20_203058.jpg,car,25,141,640,23,360,87,1,166,110,LTAdatasets/3702/annotate/3702-2021_03_20_203058.jpg,153.5,98.5,0.23984375,0.27361111111111114,0.0390625,0.06388888888888888
3702-2021_03_20_203058.jpg,car,19,175,640,20,360,105,1,194,125,LTAdatasets/3702/annotate/3702-2021_03_20_203058.jpg,184.5,115.0,0.28828125,0.3194444444444444,0.0296875,0.05555555555555555
3702-2021_03_20_203058.jpg,car,63,2,640,55,360,305,1,65,360,LTAdatasets/3702/annotate/3702-2021_03_20_203058.jpg,33.5,332.5,0.05234375,0.9236111111111112,0.0984375,0.1527777777777778
3702-2021_03_20_185153.jpg,car,31,176,640,34,360,154,1,207,188,LTAdatasets/3702/annotate/3702-2021_03_20_185153.jpg,191.5,171.0,0.29921875,0.475,0.0484375,0.09444444444444444
3702-2021_03_20_185153.jpg,car,19,203,640,15,360,89,1,222,104,LTAdatasets/3702/annotate/3702-2021_03_20_185153.jpg,212.5,96.5,0.33203125,0.26805555555555555,0.0296875,0.041666666666666664
3702-2021_03_20_185153.jpg,bike,12,181,640,19,360,65,4,193,84,LTAdatasets/3702/annotate/3702-2021_03_20_185153.jpg,187.0,74.5,0.2921875,0.20694444444444443,0.01875,0.05277777777777778
3702-2021_03_20_083640.jpg,car,9,185,640,7,360,39,1,194,46,LTAdatasets/3702/annotate/3702-2021_03_20_083640.jpg,189.5,42.5,0.29609375,0.11805555555555555,0.0140625,0.019444444444444445
3702-2021_03_20_201617.jpg,car,35,144,640,25,360,136,1,179,161,LTAdatasets/3702/annotate/3702-2021_03_20_201617.jpg,161.5,148.5,0.25234375,0.4125,0.0546875,0.06944444444444445
3702-2021_03_20_201617.jpg,car,13,165,640,10,360,65,1,178,75,LTAdatasets/3702/annotate/3702-2021_03_20_201617.jpg,171.5,70.0,0.26796875,0.19444444444444445,0.0203125,0.027777777777777776
3702-2021_03_20_203358.jpg,car,26,132,640,26,360,99,1,158,125,LTAdatasets/3702/annotate/3702-2021_03_20_203358.jpg,145.0,112.0,0.2265625,0.3111111111111111,0.040625,0.07222222222222222
3702-2021_03_20_200937.jpg,bike,29,36,640,34,360,229,4,65,263,LTAdatasets/3702/annotate/3702-2021_03_20_200937.jpg,50.5,246.0,0.07890625,0.6833333333333333,0.0453125,0.09444444444444444
3702-2021_03_20_180410.jpg,car,50,124,640,47,360,179,1,174,226,LTAdatasets/3702/annotate/3702-2021_03_20_180410.jpg,149.0,202.5,0.2328125,0.5625,0.078125,0.13055555555555556
3702-2021_03_20_180410.jpg,car,16,227,640,16,360,61,1,243,77,LTAdatasets/3702/annotate/3702-2021_03_20_180410.jpg,235.0,69.0,0.3671875,0.19166666666666668,0.025,0.044444444444444446
3702-2021_03_20_183112.jpg,car,54,300,640,39,360,177,1,354,216,LTAdatasets/3702/annotate/3702-2021_03_20_183112.jpg,327.0,196.5,0.5109375,0.5458333333333333,0.084375,0.10833333333333334
3702-2021_03_20_185753.jpg,car,15,270,640,17,360,74,1,285,91,LTAdatasets/3702/annotate/3702-2021_03_20_185753.jpg,277.5,82.5,0.43359375,0.22916666666666666,0.0234375,0.04722222222222222
3702-2021_03_20_185753.jpg,bus,17,162,640,19,360,43,5,179,62,LTAdatasets/3702/annotate/3702-2021_03_20_185753.jpg,170.5,52.5,0.26640625,0.14583333333333334,0.0265625,0.05277777777777778
3702-2021_03_20_191234.jpg,car,34,146,640,28,360,129,1,180,157,LTAdatasets/3702/annotate/3702-2021_03_20_191234.jpg,163.0,143.0,0.2546875,0.3972222222222222,0.053125,0.07777777777777778
3702-2021_03_20_191234.jpg,car,19,246,640,18,360,84,1,265,102,LTAdatasets/3702/annotate/3702-2021_03_20_191234.jpg,255.5,93.0,0.39921875,0.25833333333333336,0.0296875,0.05
3702-2021_03_20_093424.jpg,car,14,202,640,11,360,50,1,216,61,LTAdatasets/3702/annotate/3702-2021_03_20_093424.jpg,209.0,55.5,0.3265625,0.15416666666666667,0.021875,0.030555555555555555
3702-2021_03_20_093424.jpg,car,14,166,640,10,360,55,1,180,65,LTAdatasets/3702/annotate/3702-2021_03_20_093424.jpg,173.0,60.0,0.2703125,0.16666666666666666,0.021875,0.027777777777777776
3702-2021_03_20_201917.jpg,car,36,305,640,28,360,115,1,341,143,LTAdatasets/3702/annotate/3702-2021_03_20_201917.jpg,323.0,129.0,0.5046875,0.35833333333333334,0.05625,0.07777777777777778
3702-2021_03_20_201917.jpg,car,20,265,640,14,360,71,1,285,85,LTAdatasets/3702/annotate/3702-2021_03_20_201917.jpg,275.0,78.0,0.4296875,0.21666666666666667,0.03125,0.03888888888888889
3702-2021_03_20_201917.jpg,car,18,205,640,16,360,60,1,223,76,LTAdatasets/3702/annotate/3702-2021_03_20_201917.jpg,214.0,68.0,0.334375,0.18888888888888888,0.028125,0.044444444444444446
3702-2021_03_20_201917.jpg,car,14,183,640,10,360,55,1,197,65,LTAdatasets/3702/annotate/3702-2021_03_20_201917.jpg,190.0,60.0,0.296875,0.16666666666666666,0.021875,0.027777777777777776
3702-2021_03_20_201917.jpg,bike,9,259,640,19,360,88,4,268,107,LTAdatasets/3702/annotate/3702-2021_03_20_201917.jpg,263.5,97.5,0.41171875,0.2708333333333333,0.0140625,0.05277777777777778
8704-2021_03_20_083640.jpg,car,33,148,640,24,360,130,1,181,154,LTAdatasets/8704/annotate/8704-2021_03_20_083640.jpg,164.5,142.0,0.25703125,0.39444444444444443,0.0515625,0.06666666666666667
8704-2021_03_20_083640.jpg,bike,13,116,640,15,360,68,4,129,83,LTAdatasets/8704/annotate/8704-2021_03_20_083640.jpg,122.5,75.5,0.19140625,0.20972222222222223,0.0203125,0.041666666666666664
8704-2021_03_20_083640.jpg,lorry_truck,15,57,640,15,360,74,2,72,89,LTAdatasets/8704/annotate/8704-2021_03_20_083640.jpg,64.5,81.5,0.10078125,0.2263888888888889,0.0234375,0.041666666666666664
8704-2021_03_20_083640.jpg,car,21,0,640,33,360,180,1,21,213,LTAdatasets/8704/annotate/8704-2021_03_20_083640.jpg,10.5,196.5,0.01640625,0.5458333333333333,0.0328125,0.09166666666666666
8704-2021_03_20_093424.jpg,van,49,178,640,32,360,166,3,227,198,LTAdatasets/8704/annotate/8704-2021_03_20_093424.jpg,202.5,182.0,0.31640625,0.5055555555555555,0.0765625,0.08888888888888889
8704-2021_03_20_093424.jpg,van,22,12,640,25,360,127,3,34,152,LTAdatasets/8704/annotate/8704-2021_03_20_093424.jpg,23.0,139.5,0.0359375,0.3875,0.034375,0.06944444444444445
8704-2021_03_20_093424.jpg,car,15,42,640,15,360,105,1,57,120,LTAdatasets/8704/annotate/8704-2021_03_20_093424.jpg,49.5,112.5,0.07734375,0.3125,0.0234375,0.041666666666666664
8704-2021_03_20_093424.jpg,lorry_truck,14,53,640,15,360,78,2,67,93,LTAdatasets/8704/annotate/8704-2021_03_20_093424.jpg,60.0,85.5,0.09375,0.2375,0.021875,0.041666666666666664
8704-2021_03_20_093424.jpg,lorry_truck,15,103,640,18,360,79,2,118,97,LTAdatasets/8704/annotate/8704-2021_03_20_093424.jpg,110.5,88.0,0.17265625,0.24444444444444444,0.0234375,0.05
8704-2021_03_20_093424.jpg,car,15,0,640,35,360,198,1,15,233,LTAdatasets/8704/annotate/8704-2021_03_20_093424.jpg,7.5,215.5,0.01171875,0.5986111111111111,0.0234375,0.09722222222222222
8704-2021_03_20_093424.jpg,car,16,62,640,9,360,70,1,78,79,LTAdatasets/8704/annotate/8704-2021_03_20_093424.jpg,70.0,74.5,0.109375,0.20694444444444443,0.025,0.025
8704-2021_03_20_095205.jpg,car,17,0,640,31,360,187,1,17,218,LTAdatasets/8704/annotate/8704-2021_03_20_095205.jpg,8.5,202.5,0.01328125,0.5625,0.0265625,0.08611111111111111
8704-2021_03_20_095205.jpg,van,17,38,640,18,360,100,3,55,118,LTAdatasets/8704/annotate/8704-2021_03_20_095205.jpg,46.5,109.0,0.07265625,0.30277777777777776,0.0265625,0.05
8704-2021_03_20_095205.jpg,car,11,54,640,13,360,82,1,65,95,LTAdatasets/8704/annotate/8704-2021_03_20_095205.jpg,59.5,88.5,0.09296875,0.24583333333333332,0.0171875,0.03611111111111111
8704-2021_03_20_203358.jpg,car,36,214,640,26,360,142,1,250,168,LTAdatasets/8704/annotate/8704-2021_03_20_203358.jpg,232.0,155.0,0.3625,0.4305555555555556,0.05625,0.07222222222222222
8704-2021_03_20_203358.jpg,van,16,47,640,16,360,84,3,63,100,LTAdatasets/8704/annotate/8704-2021_03_20_203358.jpg,55.0,92.0,0.0859375,0.25555555555555554,0.025,0.044444444444444446
8704-2021_03_20_203358.jpg,car,12,144,640,10,360,67,1,156,77,LTAdatasets/8704/annotate/8704-2021_03_20_203358.jpg,150.0,72.0,0.234375,0.2,0.01875,0.027777777777777776
8704-2021_03_20_203358.jpg,car,12,123,640,10,360,61,1,135,71,LTAdatasets/8704/annotate/8704-2021_03_20_203358.jpg,129.0,66.0,0.2015625,0.18333333333333332,0.01875,0.027777777777777776
8704-2021_03_20_203358.jpg,van,11,81,640,12,360,60,3,92,72,LTAdatasets/8704/annotate/8704-2021_03_20_203358.jpg,86.5,66.0,0.13515625,0.18333333333333332,0.0171875,0.03333333333333333
8704-2021_03_20_073037.jpg,lorry_truck,26,110,640,33,360,99,2,136,132,LTAdatasets/8704/annotate/8704-2021_03_20_073037.jpg,123.0,115.5,0.1921875,0.32083333333333336,0.040625,0.09166666666666666
8704-2021_03_20_073037.jpg,lorry_truck,16,103,640,12,360,68,2,119,80,LTAdatasets/8704/annotate/8704-2021_03_20_073037.jpg,111.0,74.0,0.1734375,0.20555555555555555,0.025,0.03333333333333333
8704-2021_03_20_073037.jpg,van,15,45,640,17,360,84,3,60,101,LTAdatasets/8704/annotate/8704-2021_03_20_073037.jpg,52.5,92.5,0.08203125,0.2569444444444444,0.0234375,0.04722222222222222
8704-2021_03_20_073717.jpg,car,17,134,640,15,360,86,1,151,101,LTAdatasets/8704/annotate/8704-2021_03_20_073717.jpg,142.5,93.5,0.22265625,0.25972222222222224,0.0265625,0.041666666666666664
8704-2021_03_20_073717.jpg,car,16,58,640,11,360,69,1,74,80,LTAdatasets/8704/annotate/8704-2021_03_20_073717.jpg,66.0,74.5,0.103125,0.20694444444444443,0.025,0.030555555555555555
8704-2021_03_20_073717.jpg,bike,14,27,640,18,360,119,4,41,137,LTAdatasets/8704/annotate/8704-2021_03_20_073717.jpg,34.0,128.0,0.053125,0.35555555555555557,0.021875,0.05
8704-2021_03_20_192735.jpg,van,25,75,640,30,360,129,3,100,159,LTAdatasets/8704/annotate/8704-2021_03_20_192735.jpg,87.5,144.0,0.13671875,0.4,0.0390625,0.08333333333333333
8704-2021_03_20_192735.jpg,bike,14,123,640,21,360,121,4,137,142,LTAdatasets/8704/annotate/8704-2021_03_20_192735.jpg,130.0,131.5,0.203125,0.36527777777777776,0.021875,0.058333333333333334
8704-2021_03_20_192735.jpg,car,23,23,640,18,360,122,1,46,140,LTAdatasets/8704/annotate/8704-2021_03_20_192735.jpg,34.5,131.0,0.05390625,0.3638888888888889,0.0359375,0.05
8704-2021_03_20_192735.jpg,car,18,45,640,14,360,86,1,63,100,LTAdatasets/8704/annotate/8704-2021_03_20_192735.jpg,54.0,93.0,0.084375,0.25833333333333336,0.028125,0.03888888888888889
8704-2021_03_20_192735.jpg,car,15,54,640,11,360,74,1,69,85,LTAdatasets/8704/annotate/8704-2021_03_20_192735.jpg,61.5,79.5,0.09609375,0.22083333333333333,0.0234375,0.030555555555555555
8704-2021_03_20_190113.jpg,car,20,34,640,16,360,102,1,54,118,LTAdatasets/8704/annotate/8704-2021_03_20_190113.jpg,44.0,110.0,0.06875,0.3055555555555556,0.03125,0.044444444444444446
8704-2021_03_20_190113.jpg,car,13,122,640,14,360,53,1,135,67,LTAdatasets/8704/annotate/8704-2021_03_20_190113.jpg,128.5,60.0,0.20078125,0.16666666666666666,0.0203125,0.03888888888888889
8704-2021_03_20_185153.jpg,car,81,293,640,53,360,298,1,374,351,LTAdatasets/8704/annotate/8704-2021_03_20_185153.jpg,333.5,324.5,0.52109375,0.9013888888888889,0.1265625,0.14722222222222223
8704-2021_03_20_185153.jpg,bike,33,238,640,27,360,333,4,271,360,LTAdatasets/8704/annotate/8704-2021_03_20_185153.jpg,254.5,346.5,0.39765625,0.9625,0.0515625,0.075
8704-2021_03_20_185153.jpg,car,18,133,640,15,360,93,1,151,108,LTAdatasets/8704/annotate/8704-2021_03_20_185153.jpg,142.0,100.5,0.221875,0.2791666666666667,0.028125,0.041666666666666664
8704-2021_03_20_185153.jpg,lorry_truck,19,72,640,20,360,67,2,91,87,LTAdatasets/8704/annotate/8704-2021_03_20_185153.jpg,81.5,77.0,0.12734375,0.21388888888888888,0.0296875,0.05555555555555555
8704-2021_03_20_185153.jpg,car,23,20,640,16,360,135,1,43,151,LTAdatasets/8704/annotate/8704-2021_03_20_185153.jpg,31.5,143.0,0.04921875,0.3972222222222222,0.0359375,0.044444444444444446
8704-2021_03_20_081539.jpg,lorry_truck,70,274,640,82,360,250,2,344,332,LTAdatasets/8704/annotate/8704-2021_03_20_081539.jpg,309.0,291.0,0.4828125,0.8083333333333333,0.109375,0.22777777777777777
8704-2021_03_20_081539.jpg,car,22,5,640,24,360,150,1,27,174,LTAdatasets/8704/annotate/8704-2021_03_20_081539.jpg,16.0,162.0,0.025,0.45,0.034375,0.06666666666666667
8704-2021_03_20_081539.jpg,car,21,33,640,15,360,110,1,54,125,LTAdatasets/8704/annotate/8704-2021_03_20_081539.jpg,43.5,117.5,0.06796875,0.3263888888888889,0.0328125,0.041666666666666664
8704-2021_03_20_081539.jpg,car,14,54,640,12,360,80,1,68,92,LTAdatasets/8704/annotate/8704-2021_03_20_081539.jpg,61.0,86.0,0.0953125,0.2388888888888889,0.021875,0.03333333333333333
8704-2021_03_20_081539.jpg,car,12,67,640,11,360,62,1,79,73,LTAdatasets/8704/annotate/8704-2021_03_20_081539.jpg,73.0,67.5,0.1140625,0.1875,0.01875,0.030555555555555555
8704-2021_03_20_185753.jpg,van,28,425,640,18,360,106,3,453,124,LTAdatasets/8704/annotate/8704-2021_03_20_185753.jpg,439.0,115.0,0.6859375,0.3194444444444444,0.04375,0.05
8704-2021_03_20_185753.jpg,car,27,91,640,33,360,181,1,118,214,LTAdatasets/8704/annotate/8704-2021_03_20_185753.jpg,104.5,197.5,0.16328125,0.5486111111111112,0.0421875,0.09166666666666666
8704-2021_03_20_185753.jpg,car,20,31,640,15,360,109,1,51,124,LTAdatasets/8704/annotate/8704-2021_03_20_185753.jpg,41.0,116.5,0.0640625,0.3236111111111111,0.03125,0.041666666666666664
8704-2021_03_20_185753.jpg,car,13,50,640,16,360,79,1,63,95,LTAdatasets/8704/annotate/8704-2021_03_20_185753.jpg,56.5,87.0,0.08828125,0.24166666666666667,0.0203125,0.044444444444444446
8704-2021_03_20_185753.jpg,car,11,83,640,10,360,59,1,94,69,LTAdatasets/8704/annotate/8704-2021_03_20_185753.jpg,88.5,64.0,0.13828125,0.17777777777777778,0.0171875,0.027777777777777776
8704-2021_03_20_185753.jpg,lorry_truck,12,118,640,10,360,41,2,130,51,LTAdatasets/8704/annotate/8704-2021_03_20_185753.jpg,124.0,46.0,0.19375,0.12777777777777777,0.01875,0.027777777777777776
8704-2021_03_20_185753.jpg,car,10,73,640,9,360,50,1,83,59,LTAdatasets/8704/annotate/8704-2021_03_20_185753.jpg,78.0,54.5,0.121875,0.15138888888888888,0.015625,0.025
8704-2021_03_20_185753.jpg,car,24,595,640,15,360,175,1,619,190,LTAdatasets/8704/annotate/8704-2021_03_20_185753.jpg,607.0,182.5,0.9484375,0.5069444444444444,0.0375,0.041666666666666664
8704-2021_03_20_181551.jpg,car,31,423,640,21,360,107,1,454,128,LTAdatasets/8704/annotate/8704-2021_03_20_181551.jpg,438.5,117.5,0.68515625,0.3263888888888889,0.0484375,0.058333333333333334
8704-2021_03_20_181551.jpg,lorry_truck,22,26,640,30,360,97,2,48,127,LTAdatasets/8704/annotate/8704-2021_03_20_181551.jpg,37.0,112.0,0.0578125,0.3111111111111111,0.034375,0.08333333333333333
8704-2021_03_20_181551.jpg,car,23,4,640,23,360,153,1,27,176,LTAdatasets/8704/annotate/8704-2021_03_20_181551.jpg,15.5,164.5,0.02421875,0.45694444444444443,0.0359375,0.06388888888888888
8704-2021_03_20_181551.jpg,car,20,109,640,18,360,87,1,129,105,LTAdatasets/8704/annotate/8704-2021_03_20_181551.jpg,119.0,96.0,0.1859375,0.26666666666666666,0.03125,0.05
8704-2021_03_20_193115.jpg,car,52,233,640,46,360,213,1,285,259,LTAdatasets/8704/annotate/8704-2021_03_20_193115.jpg,259.0,236.0,0.4046875,0.6555555555555556,0.08125,0.12777777777777777
8704-2021_03_20_193115.jpg,bike,25,157,640,31,360,207,4,182,238,LTAdatasets/8704/annotate/8704-2021_03_20_193115.jpg,169.5,222.5,0.26484375,0.6180555555555556,0.0390625,0.08611111111111111
8704-2021_03_20_193115.jpg,lorry_truck,66,96,640,88,360,265,2,162,353,LTAdatasets/8704/annotate/8704-2021_03_20_193115.jpg,129.0,309.0,0.2015625,0.8583333333333333,0.103125,0.24444444444444444
8704-2021_03_20_193115.jpg,car,15,33,640,16,360,108,1,48,124,LTAdatasets/8704/annotate/8704-2021_03_20_193115.jpg,40.5,116.0,0.06328125,0.32222222222222224,0.0234375,0.044444444444444446
8704-2021_03_20_193115.jpg,car,15,46,640,12,360,83,1,61,95,LTAdatasets/8704/annotate/8704-2021_03_20_193115.jpg,53.5,89.0,0.08359375,0.24722222222222223,0.0234375,0.03333333333333333
8704-2021_03_20_193115.jpg,car,12,92,640,11,360,64,1,104,75,LTAdatasets/8704/annotate/8704-2021_03_20_193115.jpg,98.0,69.5,0.153125,0.19305555555555556,0.01875,0.030555555555555555
8704-2021_03_20_190634.jpg,lorry_truck,69,246,640,72,360,231,2,315,303,LTAdatasets/8704/annotate/8704-2021_03_20_190634.jpg,280.5,267.0,0.43828125,0.7416666666666667,0.1078125,0.2
8704-2021_03_20_190634.jpg,lorry_truck,33,113,640,39,360,116,2,146,155,LTAdatasets/8704/annotate/8704-2021_03_20_190634.jpg,129.5,135.5,0.20234375,0.3763888888888889,0.0515625,0.10833333333333334
8704-2021_03_20_190634.jpg,lorry_truck,17,129,640,17,360,80,2,146,97,LTAdatasets/8704/annotate/8704-2021_03_20_190634.jpg,137.5,88.5,0.21484375,0.24583333333333332,0.0265625,0.04722222222222222
8704-2021_03_20_190634.jpg,car,20,16,640,22,360,130,1,36,152,LTAdatasets/8704/annotate/8704-2021_03_20_190634.jpg,26.0,141.0,0.040625,0.39166666666666666,0.03125,0.06111111111111111
8704-2021_03_20_092803.jpg,lorry_truck,58,190,640,67,360,155,2,248,222,LTAdatasets/8704/annotate/8704-2021_03_20_092803.jpg,219.0,188.5,0.3421875,0.5236111111111111,0.090625,0.18611111111111112
8704-2021_03_20_092803.jpg,van,47,143,640,59,360,207,3,190,266,LTAdatasets/8704/annotate/8704-2021_03_20_092803.jpg,166.5,236.5,0.26015625,0.6569444444444444,0.0734375,0.1638888888888889
8704-2021_03_20_092803.jpg,lorry_truck,37,104,640,47,360,94,2,141,141,LTAdatasets/8704/annotate/8704-2021_03_20_092803.jpg,122.5,117.5,0.19140625,0.3263888888888889,0.0578125,0.13055555555555556
8704-2021_03_20_092803.jpg,lorry_truck,22,72,640,28,360,122,2,94,150,LTAdatasets/8704/annotate/8704-2021_03_20_092803.jpg,83.0,136.0,0.1296875,0.37777777777777777,0.034375,0.07777777777777778
8704-2021_03_20_092803.jpg,car,21,409,640,20,360,104,1,430,124,LTAdatasets/8704/annotate/8704-2021_03_20_092803.jpg,419.5,114.0,0.65546875,0.31666666666666665,0.0328125,0.05555555555555555
8704-2021_03_20_092543.jpg,car,43,218,640,31,360,207,1,261,238,LTAdatasets/8704/annotate/8704-2021_03_20_092543.jpg,239.5,222.5,0.37421875,0.6180555555555556,0.0671875,0.08611111111111111
8704-2021_03_20_092543.jpg,car,50,332,640,40,360,240,1,382,280,LTAdatasets/8704/annotate/8704-2021_03_20_092543.jpg,357.0,260.0,0.5578125,0.7222222222222222,0.078125,0.1111111111111111
8704-2021_03_20_092543.jpg,lorry_truck,69,138,640,89,360,175,2,207,264,LTAdatasets/8704/annotate/8704-2021_03_20_092543.jpg,172.5,219.5,0.26953125,0.6097222222222223,0.1078125,0.24722222222222223
8704-2021_03_20_092543.jpg,lorry_truck,27,97,640,31,360,70,2,124,101,LTAdatasets/8704/annotate/8704-2021_03_20_092543.jpg,110.5,85.5,0.17265625,0.2375,0.0421875,0.08611111111111111
8704-2021_03_20_195136.jpg,lorry_truck,74,235,640,75,360,223,2,309,298,LTAdatasets/8704/annotate/8704-2021_03_20_195136.jpg,272.0,260.5,0.425,0.7236111111111111,0.115625,0.20833333333333334
8704-2021_03_20_085822.jpg,lorry_truck,50,119,640,60,360,142,2,169,202,LTAdatasets/8704/annotate/8704-2021_03_20_085822.jpg,144.0,172.0,0.225,0.4777777777777778,0.078125,0.16666666666666666
8704-2021_03_20_085822.jpg,lorry_truck,18,119,640,16,360,89,2,137,105,LTAdatasets/8704/annotate/8704-2021_03_20_085822.jpg,128.0,97.0,0.2,0.26944444444444443,0.028125,0.044444444444444446
8704-2021_03_20_085822.jpg,lorry_truck,15,119,640,15,360,71,2,134,86,LTAdatasets/8704/annotate/8704-2021_03_20_085822.jpg,126.5,78.5,0.19765625,0.21805555555555556,0.0234375,0.041666666666666664
8704-2021_03_20_085822.jpg,lorry_truck,20,45,640,19,360,80,2,65,99,LTAdatasets/8704/annotate/8704-2021_03_20_085822.jpg,55.0,89.5,0.0859375,0.24861111111111112,0.03125,0.05277777777777778
8704-2021_03_20_085822.jpg,car,27,6,640,23,360,137,1,33,160,LTAdatasets/8704/annotate/8704-2021_03_20_085822.jpg,19.5,148.5,0.03046875,0.4125,0.0421875,0.06388888888888888
8704-2021_03_20_082440.jpg,car,50,297,640,39,360,217,1,347,256,LTAdatasets/8704/annotate/8704-2021_03_20_082440.jpg,322.0,236.5,0.503125,0.6569444444444444,0.078125,0.10833333333333334
8704-2021_03_20_082440.jpg,car,40,185,640,29,360,171,1,225,200,LTAdatasets/8704/annotate/8704-2021_03_20_082440.jpg,205.0,185.5,0.3203125,0.5152777777777777,0.0625,0.08055555555555556
8704-2021_03_20_082440.jpg,car,23,11,640,18,360,148,1,34,166,LTAdatasets/8704/annotate/8704-2021_03_20_082440.jpg,22.5,157.0,0.03515625,0.4361111111111111,0.0359375,0.05
8704-2021_03_20_082440.jpg,car,22,131,640,14,360,90,1,153,104,LTAdatasets/8704/annotate/8704-2021_03_20_082440.jpg,142.0,97.0,0.221875,0.26944444444444443,0.034375,0.03888888888888889
8704-2021_03_20_082440.jpg,bike,11,160,640,12,360,85,4,171,97,LTAdatasets/8704/annotate/8704-2021_03_20_082440.jpg,165.5,91.0,0.25859375,0.25277777777777777,0.0171875,0.03333333333333333
8704-2021_03_20_082440.jpg,bike,12,143,640,16,360,64,4,155,80,LTAdatasets/8704/annotate/8704-2021_03_20_082440.jpg,149.0,72.0,0.2328125,0.2,0.01875,0.044444444444444446
8704-2021_03_20_082440.jpg,bike,16,73,640,16,360,108,4,89,124,LTAdatasets/8704/annotate/8704-2021_03_20_082440.jpg,81.0,116.0,0.1265625,0.32222222222222224,0.025,0.044444444444444446
8704-2021_03_20_073417.jpg,bus,48,122,640,87,360,121,5,170,208,LTAdatasets/8704/annotate/8704-2021_03_20_073417.jpg,146.0,164.5,0.228125,0.45694444444444443,0.075,0.24166666666666667
8704-2021_03_20_073417.jpg,van,42,214,640,37,360,194,3,256,231,LTAdatasets/8704/annotate/8704-2021_03_20_073417.jpg,235.0,212.5,0.3671875,0.5902777777777778,0.065625,0.10277777777777777
8704-2021_03_20_073417.jpg,car,18,148,640,16,360,79,1,166,95,LTAdatasets/8704/annotate/8704-2021_03_20_073417.jpg,157.0,87.0,0.2453125,0.24166666666666667,0.028125,0.044444444444444446
8704-2021_03_20_073417.jpg,lorry_truck,16,104,640,19,360,72,2,120,91,LTAdatasets/8704/annotate/8704-2021_03_20_073417.jpg,112.0,81.5,0.175,0.2263888888888889,0.025,0.05277777777777778
8704-2021_03_20_073417.jpg,car,17,56,640,12,360,73,1,73,85,LTAdatasets/8704/annotate/8704-2021_03_20_073417.jpg,64.5,79.0,0.10078125,0.21944444444444444,0.0265625,0.03333333333333333
8704-2021_03_20_073417.jpg,car,23,30,640,17,360,108,1,53,125,LTAdatasets/8704/annotate/8704-2021_03_20_073417.jpg,41.5,116.5,0.06484375,0.3236111111111111,0.0359375,0.04722222222222222
8704-2021_03_20_073417.jpg,car,22,13,640,22,360,147,1,35,169,LTAdatasets/8704/annotate/8704-2021_03_20_073417.jpg,24.0,158.0,0.0375,0.4388888888888889,0.034375,0.06111111111111111
8704-2021_03_20_080719.jpg,bike,14,208,640,18,360,144,4,222,162,LTAdatasets/8704/annotate/8704-2021_03_20_080719.jpg,215.0,153.0,0.3359375,0.425,0.021875,0.05
8704-2021_03_20_080719.jpg,car,24,162,640,15,360,96,1,186,111,LTAdatasets/8704/annotate/8704-2021_03_20_080719.jpg,174.0,103.5,0.271875,0.2875,0.0375,0.041666666666666664
8704-2021_03_20_080719.jpg,car,20,34,640,16,360,98,1,54,114,LTAdatasets/8704/annotate/8704-2021_03_20_080719.jpg,44.0,106.0,0.06875,0.29444444444444445,0.03125,0.044444444444444446
8704-2021_03_20_202217.jpg,car,34,126,640,27,360,161,1,160,188,LTAdatasets/8704/annotate/8704-2021_03_20_202217.jpg,143.0,174.5,0.2234375,0.4847222222222222,0.053125,0.075
8704-2021_03_20_202217.jpg,car,31,186,640,21,360,119,1,217,140,LTAdatasets/8704/annotate/8704-2021_03_20_202217.jpg,201.5,129.5,0.31484375,0.3597222222222222,0.0484375,0.058333333333333334
8704-2021_03_20_202217.jpg,bike,14,145,640,16,360,105,4,159,121,LTAdatasets/8704/annotate/8704-2021_03_20_202217.jpg,152.0,113.0,0.2375,0.3138888888888889,0.021875,0.044444444444444446
8704-2021_03_20_202217.jpg,car,19,130,640,10,360,85,1,149,95,LTAdatasets/8704/annotate/8704-2021_03_20_202217.jpg,139.5,90.0,0.21796875,0.25,0.0296875,0.027777777777777776
8704-2021_03_20_202217.jpg,car,15,148,640,12,360,76,1,163,88,LTAdatasets/8704/annotate/8704-2021_03_20_202217.jpg,155.5,82.0,0.24296875,0.22777777777777777,0.0234375,0.03333333333333333
8704-2021_03_20_202217.jpg,bike,10,121,640,10,360,71,4,131,81,LTAdatasets/8704/annotate/8704-2021_03_20_202217.jpg,126.0,76.0,0.196875,0.2111111111111111,0.015625,0.027777777777777776
8704-2021_03_20_202217.jpg,car,20,29,640,14,360,107,1,49,121,LTAdatasets/8704/annotate/8704-2021_03_20_202217.jpg,39.0,114.0,0.0609375,0.31666666666666665,0.03125,0.03888888888888889
8704-2021_03_20_094305.jpg,van,60,250,640,65,360,252,3,310,317,LTAdatasets/8704/annotate/8704-2021_03_20_094305.jpg,280.0,284.5,0.4375,0.7902777777777777,0.09375,0.18055555555555555
8704-2021_03_20_094305.jpg,lorry_truck,17,54,640,16,360,68,2,71,84,LTAdatasets/8704/annotate/8704-2021_03_20_094305.jpg,62.5,76.0,0.09765625,0.2111111111111111,0.0265625,0.044444444444444446
8704-2021_03_20_080939.jpg,car,24,102,640,20,360,134,1,126,154,LTAdatasets/8704/annotate/8704-2021_03_20_080939.jpg,114.0,144.0,0.178125,0.4,0.0375,0.05555555555555555
8704-2021_03_20_080939.jpg,lorry_truck,14,104,640,22,360,78,2,118,100,LTAdatasets/8704/annotate/8704-2021_03_20_080939.jpg,111.0,89.0,0.1734375,0.24722222222222223,0.021875,0.06111111111111111
8704-2021_03_20_093724.jpg,car,24,2,640,30,360,162,1,26,192,LTAdatasets/8704/annotate/8704-2021_03_20_093724.jpg,14.0,177.0,0.021875,0.49166666666666664,0.0375,0.08333333333333333
8704-2021_03_20_093724.jpg,car,15,57,640,14,360,74,1,72,88,LTAdatasets/8704/annotate/8704-2021_03_20_093724.jpg,64.5,81.0,0.10078125,0.225,0.0234375,0.03888888888888889
8704-2021_03_20_080119.jpg,car,89,269,640,63,360,280,1,358,343,LTAdatasets/8704/annotate/8704-2021_03_20_080119.jpg,313.5,311.5,0.48984375,0.8652777777777778,0.1390625,0.175
8704-2021_03_20_080119.jpg,lorry_truck,38,175,640,37,360,146,2,213,183,LTAdatasets/8704/annotate/8704-2021_03_20_080119.jpg,194.0,164.5,0.303125,0.45694444444444443,0.059375,0.10277777777777777
8704-2021_03_20_080119.jpg,car,24,132,640,16,360,107,1,156,123,LTAdatasets/8704/annotate/8704-2021_03_20_080119.jpg,144.0,115.0,0.225,0.3194444444444444,0.0375,0.044444444444444446
8704-2021_03_20_080119.jpg,car,18,36,640,18,360,99,1,54,117,LTAdatasets/8704/annotate/8704-2021_03_20_080119.jpg,45.0,108.0,0.0703125,0.3,0.028125,0.05
8704-2021_03_20_080119.jpg,van,14,55,640,12,360,75,3,69,87,LTAdatasets/8704/annotate/8704-2021_03_20_080119.jpg,62.0,81.0,0.096875,0.225,0.021875,0.03333333333333333
8704-2021_03_20_080119.jpg,car,18,0,640,27,360,161,1,18,188,LTAdatasets/8704/annotate/8704-2021_03_20_080119.jpg,9.0,174.5,0.0140625,0.4847222222222222,0.028125,0.075
8704-2021_03_20_193415.jpg,lorry_truck,45,176,640,42,360,159,2,221,201,LTAdatasets/8704/annotate/8704-2021_03_20_193415.jpg,198.5,180.0,0.31015625,0.5,0.0703125,0.11666666666666667
8704-2021_03_20_193415.jpg,car,21,30,640,19,360,111,1,51,130,LTAdatasets/8704/annotate/8704-2021_03_20_193415.jpg,40.5,120.5,0.06328125,0.3347222222222222,0.0328125,0.05277777777777778
8704-2021_03_20_193415.jpg,car,16,43,640,13,360,87,1,59,100,LTAdatasets/8704/annotate/8704-2021_03_20_193415.jpg,51.0,93.5,0.0796875,0.25972222222222224,0.025,0.03611111111111111
8704-2021_03_20_185453.jpg,car,14,140,640,9,360,60,1,154,69,LTAdatasets/8704/annotate/8704-2021_03_20_185453.jpg,147.0,64.5,0.2296875,0.17916666666666667,0.021875,0.025
8704-2021_03_20_202758.jpg,car,30,205,640,23,360,131,1,235,154,LTAdatasets/8704/annotate/8704-2021_03_20_202758.jpg,220.0,142.5,0.34375,0.3958333333333333,0.046875,0.06388888888888888
8704-2021_03_20_202758.jpg,car,26,79,640,22,360,121,1,105,143,LTAdatasets/8704/annotate/8704-2021_03_20_202758.jpg,92.0,132.0,0.14375,0.36666666666666664,0.040625,0.06111111111111111
8704-2021_03_20_202758.jpg,car,15,38,640,14,360,95,1,53,109,LTAdatasets/8704/annotate/8704-2021_03_20_202758.jpg,45.5,102.0,0.07109375,0.2833333333333333,0.0234375,0.03888888888888889
8704-2021_03_20_202758.jpg,bike,12,129,640,12,360,73,4,141,85,LTAdatasets/8704/annotate/8704-2021_03_20_202758.jpg,135.0,79.0,0.2109375,0.21944444444444444,0.01875,0.03333333333333333
8704-2021_03_20_202758.jpg,car,15,58,640,16,360,67,1,73,83,LTAdatasets/8704/annotate/8704-2021_03_20_202758.jpg,65.5,75.0,0.10234375,0.20833333333333334,0.0234375,0.044444444444444446
8704-2021_03_20_075818.jpg,bike,20,74,640,22,360,178,4,94,200,LTAdatasets/8704/annotate/8704-2021_03_20_075818.jpg,84.0,189.0,0.13125,0.525,0.03125,0.06111111111111111
8704-2021_03_20_075818.jpg,lorry_truck,22,34,640,31,360,86,2,56,117,LTAdatasets/8704/annotate/8704-2021_03_20_075818.jpg,45.0,101.5,0.0703125,0.28194444444444444,0.034375,0.08611111111111111
8704-2021_03_20_084901.jpg,car,39,244,640,30,360,183,1,283,213,LTAdatasets/8704/annotate/8704-2021_03_20_084901.jpg,263.5,198.0,0.41171875,0.55,0.0609375,0.08333333333333333
8704-2021_03_20_084901.jpg,car,28,10,640,23,360,139,1,38,162,LTAdatasets/8704/annotate/8704-2021_03_20_084901.jpg,24.0,150.5,0.0375,0.41805555555555557,0.04375,0.06388888888888888
8704-2021_03_20_084901.jpg,car,17,39,640,18,360,100,1,56,118,LTAdatasets/8704/annotate/8704-2021_03_20_084901.jpg,47.5,109.0,0.07421875,0.30277777777777776,0.0265625,0.05
8704-2021_03_20_084901.jpg,bike,12,60,640,14,360,76,4,72,90,LTAdatasets/8704/annotate/8704-2021_03_20_084901.jpg,66.0,83.0,0.103125,0.23055555555555557,0.01875,0.03888888888888889
8704-2021_03_20_084901.jpg,lorry_truck,16,78,640,18,360,62,2,94,80,LTAdatasets/8704/annotate/8704-2021_03_20_084901.jpg,86.0,71.0,0.134375,0.19722222222222222,0.025,0.05
8704-2021_03_20_194916.jpg,bike,31,268,640,34,360,261,4,299,295,LTAdatasets/8704/annotate/8704-2021_03_20_194916.jpg,283.5,278.0,0.44296875,0.7722222222222223,0.0484375,0.09444444444444444
8704-2021_03_20_194916.jpg,lorry_truck,29,67,640,33,360,114,2,96,147,LTAdatasets/8704/annotate/8704-2021_03_20_194916.jpg,81.5,130.5,0.12734375,0.3625,0.0453125,0.09166666666666666
8704-2021_03_20_194916.jpg,lorry_truck,23,72,640,23,360,73,2,95,96,LTAdatasets/8704/annotate/8704-2021_03_20_194916.jpg,83.5,84.5,0.13046875,0.23472222222222222,0.0359375,0.06388888888888888
8704-2021_03_20_194916.jpg,car,17,34,640,17,360,110,1,51,127,LTAdatasets/8704/annotate/8704-2021_03_20_194916.jpg,42.5,118.5,0.06640625,0.32916666666666666,0.0265625,0.04722222222222222
8704-2021_03_20_194916.jpg,car,11,58,640,8,360,71,1,69,79,LTAdatasets/8704/annotate/8704-2021_03_20_194916.jpg,63.5,75.0,0.09921875,0.20833333333333334,0.0171875,0.022222222222222223
8704-2021_03_20_194916.jpg,bus,27,106,640,35,360,77,5,133,112,LTAdatasets/8704/annotate/8704-2021_03_20_194916.jpg,119.5,94.5,0.18671875,0.2625,0.0421875,0.09722222222222222
8704-2021_03_20_183712.jpg,car,42,252,640,29,360,180,1,294,209,LTAdatasets/8704/annotate/8704-2021_03_20_183712.jpg,273.0,194.5,0.4265625,0.5402777777777777,0.065625,0.08055555555555556
8704-2021_03_20_183712.jpg,car,32,82,640,26,360,152,1,114,178,LTAdatasets/8704/annotate/8704-2021_03_20_183712.jpg,98.0,165.0,0.153125,0.4583333333333333,0.05,0.07222222222222222
8704-2021_03_20_183712.jpg,car,19,153,640,20,360,78,1,172,98,LTAdatasets/8704/annotate/8704-2021_03_20_183712.jpg,162.5,88.0,0.25390625,0.24444444444444444,0.0296875,0.05555555555555555
8704-2021_03_20_183712.jpg,car,16,41,640,18,360,96,1,57,114,LTAdatasets/8704/annotate/8704-2021_03_20_183712.jpg,49.0,105.0,0.0765625,0.2916666666666667,0.025,0.05
8704-2021_03_20_183712.jpg,car,15,55,640,12,360,73,1,70,85,LTAdatasets/8704/annotate/8704-2021_03_20_183712.jpg,62.5,79.0,0.09765625,0.21944444444444444,0.0234375,0.03333333333333333
8704-2021_03_20_183712.jpg,lorry_truck,20,98,640,20,360,55,2,118,75,LTAdatasets/8704/annotate/8704-2021_03_20_183712.jpg,108.0,65.0,0.16875,0.18055555555555555,0.03125,0.05555555555555555
8704-2021_03_20_183712.jpg,car,26,408,640,17,360,104,1,434,121,LTAdatasets/8704/annotate/8704-2021_03_20_183712.jpg,421.0,112.5,0.6578125,0.3125,0.040625,0.04722222222222222
8704-2021_03_20_074318.jpg,car,26,143,640,17,360,105,1,169,122,LTAdatasets/8704/annotate/8704-2021_03_20_074318.jpg,156.0,113.5,0.24375,0.31527777777777777,0.040625,0.04722222222222222
8704-2021_03_20_074318.jpg,car,21,19,640,18,360,129,1,40,147,LTAdatasets/8704/annotate/8704-2021_03_20_074318.jpg,29.5,138.0,0.04609375,0.38333333333333336,0.0328125,0.05
8704-2021_03_20_074318.jpg,lorry_truck,17,99,640,22,360,60,2,116,82,LTAdatasets/8704/annotate/8704-2021_03_20_074318.jpg,107.5,71.0,0.16796875,0.19722222222222222,0.0265625,0.06111111111111111
8704-2021_03_20_074318.jpg,van,15,123,640,14,360,67,3,138,81,LTAdatasets/8704/annotate/8704-2021_03_20_074318.jpg,130.5,74.0,0.20390625,0.20555555555555555,0.0234375,0.03888888888888889
8704-2021_03_20_182151.jpg,van,62,250,640,60,360,245,3,312,305,LTAdatasets/8704/annotate/8704-2021_03_20_182151.jpg,281.0,275.0,0.4390625,0.7638888888888888,0.096875,0.16666666666666666
8704-2021_03_20_182151.jpg,bike,12,140,640,14,360,89,4,152,103,LTAdatasets/8704/annotate/8704-2021_03_20_182151.jpg,146.0,96.0,0.228125,0.26666666666666666,0.01875,0.03888888888888889
8704-2021_03_20_182151.jpg,car,12,104,640,14,360,57,1,116,71,LTAdatasets/8704/annotate/8704-2021_03_20_182151.jpg,110.0,64.0,0.171875,0.17777777777777778,0.01875,0.03888888888888889
8704-2021_03_20_184913.jpg,car,26,13,640,27,360,141,1,39,168,LTAdatasets/8704/annotate/8704-2021_03_20_184913.jpg,26.0,154.5,0.040625,0.42916666666666664,0.040625,0.075
8704-2021_03_20_184913.jpg,car,15,123,640,13,360,67,1,138,80,LTAdatasets/8704/annotate/8704-2021_03_20_184913.jpg,130.5,73.5,0.20390625,0.20416666666666666,0.0234375,0.03611111111111111
8704-2021_03_20_184913.jpg,car,18,150,640,11,360,76,1,168,87,LTAdatasets/8704/annotate/8704-2021_03_20_184913.jpg,159.0,81.5,0.2484375,0.2263888888888889,0.028125,0.030555555555555555
8704-2021_03_20_184913.jpg,lorry_truck,25,405,640,23,360,110,2,430,133,LTAdatasets/8704/annotate/8704-2021_03_20_184913.jpg,417.5,121.5,0.65234375,0.3375,0.0390625,0.06388888888888888
8704-2021_03_20_084601.jpg,lorry_truck,32,110,640,36,360,109,2,142,145,LTAdatasets/8704/annotate/8704-2021_03_20_084601.jpg,126.0,127.0,0.196875,0.3527777777777778,0.05,0.1
8704-2021_03_20_084601.jpg,lorry_truck,17,78,640,14,360,83,2,95,97,LTAdatasets/8704/annotate/8704-2021_03_20_084601.jpg,86.5,90.0,0.13515625,0.25,0.0265625,0.03888888888888889
8704-2021_03_20_084601.jpg,van,17,136,640,14,360,86,3,153,100,LTAdatasets/8704/annotate/8704-2021_03_20_084601.jpg,144.5,93.0,0.22578125,0.25833333333333336,0.0265625,0.03888888888888889
8704-2021_03_20_084601.jpg,bike,11,155,640,13,360,85,4,166,98,LTAdatasets/8704/annotate/8704-2021_03_20_084601.jpg,160.5,91.5,0.25078125,0.25416666666666665,0.0171875,0.03611111111111111
8704-2021_03_20_084601.jpg,bike,12,45,640,17,360,108,4,57,125,LTAdatasets/8704/annotate/8704-2021_03_20_084601.jpg,51.0,116.5,0.0796875,0.3236111111111111,0.01875,0.04722222222222222
8704-2021_03_20_084601.jpg,bus,23,98,640,27,360,59,5,121,86,LTAdatasets/8704/annotate/8704-2021_03_20_084601.jpg,109.5,72.5,0.17109375,0.2013888888888889,0.0359375,0.075
8704-2021_03_20_084601.jpg,car,24,409,640,16,360,107,1,433,123,LTAdatasets/8704/annotate/8704-2021_03_20_084601.jpg,421.0,115.0,0.6578125,0.3194444444444444,0.0375,0.044444444444444446
8704-2021_03_20_180110.jpg,bike,13,45,640,17,360,98,4,58,115,LTAdatasets/8704/annotate/8704-2021_03_20_180110.jpg,51.5,106.5,0.08046875,0.29583333333333334,0.0203125,0.04722222222222222
8704-2021_03_20_180110.jpg,lorry_truck,17,74,640,20,360,79,2,91,99,LTAdatasets/8704/annotate/8704-2021_03_20_180110.jpg,82.5,89.0,0.12890625,0.24722222222222223,0.0265625,0.05555555555555555
8704-2021_03_20_180110.jpg,lorry_truck,16,102,640,18,360,48,2,118,66,LTAdatasets/8704/annotate/8704-2021_03_20_180110.jpg,110.0,57.0,0.171875,0.15833333333333333,0.025,0.05
8704-2021_03_20_180110.jpg,car,15,57,640,15,360,67,1,72,82,LTAdatasets/8704/annotate/8704-2021_03_20_180110.jpg,64.5,74.5,0.10078125,0.20694444444444443,0.0234375,0.041666666666666664
8704-2021_03_20_085141.jpg,van,24,132,640,28,360,106,3,156,134,LTAdatasets/8704/annotate/8704-2021_03_20_085141.jpg,144.0,120.0,0.225,0.3333333333333333,0.0375,0.07777777777777778
8704-2021_03_20_085141.jpg,car,23,30,640,17,360,107,1,53,124,LTAdatasets/8704/annotate/8704-2021_03_20_085141.jpg,41.5,115.5,0.06484375,0.32083333333333336,0.0359375,0.04722222222222222
8704-2021_03_20_085141.jpg,car,19,0,640,32,360,175,1,19,207,LTAdatasets/8704/annotate/8704-2021_03_20_085141.jpg,9.5,191.0,0.01484375,0.5305555555555556,0.0296875,0.08888888888888889
8704-2021_03_20_085141.jpg,car,14,50,640,13,360,81,1,64,94,LTAdatasets/8704/annotate/8704-2021_03_20_085141.jpg,57.0,87.5,0.0890625,0.24305555555555555,0.021875,0.03611111111111111
8704-2021_03_20_085141.jpg,lorry_truck,18,100,640,21,360,79,2,118,100,LTAdatasets/8704/annotate/8704-2021_03_20_085141.jpg,109.0,89.5,0.1703125,0.24861111111111112,0.028125,0.058333333333333334
8704-2021_03_20_091903.jpg,bus,27,99,640,37,360,71,5,126,108,LTAdatasets/8704/annotate/8704-2021_03_20_091903.jpg,112.5,89.5,0.17578125,0.24861111111111112,0.0421875,0.10277777777777777
8704-2021_03_20_091903.jpg,car,18,36,640,17,360,99,1,54,116,LTAdatasets/8704/annotate/8704-2021_03_20_091903.jpg,45.0,107.5,0.0703125,0.2986111111111111,0.028125,0.04722222222222222
8704-2021_03_20_091903.jpg,car,12,68,640,8,360,64,1,80,72,LTAdatasets/8704/annotate/8704-2021_03_20_091903.jpg,74.0,68.0,0.115625,0.18888888888888888,0.01875,0.022222222222222223
8704-2021_03_20_182451.jpg,car,17,133,640,18,360,89,1,150,107,LTAdatasets/8704/annotate/8704-2021_03_20_182451.jpg,141.5,98.0,0.22109375,0.2722222222222222,0.0265625,0.05
8704-2021_03_20_182451.jpg,car,16,144,640,10,360,65,1,160,75,LTAdatasets/8704/annotate/8704-2021_03_20_182451.jpg,152.0,70.0,0.2375,0.19444444444444445,0.025,0.027777777777777776
8704-2021_03_20_182451.jpg,lorry_truck,20,96,640,21,360,54,2,116,75,LTAdatasets/8704/annotate/8704-2021_03_20_182451.jpg,106.0,64.5,0.165625,0.17916666666666667,0.03125,0.058333333333333334
8704-2021_03_20_182451.jpg,van,12,122,640,14,360,57,3,134,71,LTAdatasets/8704/annotate/8704-2021_03_20_182451.jpg,128.0,64.0,0.2,0.17777777777777778,0.01875,0.03888888888888889
8704-2021_03_20_181851.jpg,car,83,300,640,58,360,302,1,383,360,LTAdatasets/8704/annotate/8704-2021_03_20_181851.jpg,341.5,331.0,0.53359375,0.9194444444444444,0.1296875,0.16111111111111112
8704-2021_03_20_181851.jpg,car,36,240,640,26,360,169,1,276,195,LTAdatasets/8704/annotate/8704-2021_03_20_181851.jpg,258.0,182.0,0.403125,0.5055555555555555,0.05625,0.07222222222222222
8704-2021_03_20_181851.jpg,bike,15,163,640,20,360,125,4,178,145,LTAdatasets/8704/annotate/8704-2021_03_20_181851.jpg,170.5,135.0,0.26640625,0.375,0.0234375,0.05555555555555555
8704-2021_03_20_181851.jpg,lorry_truck,24,103,640,35,360,85,2,127,120,LTAdatasets/8704/annotate/8704-2021_03_20_181851.jpg,115.0,102.5,0.1796875,0.2847222222222222,0.0375,0.09722222222222222
8704-2021_03_20_181851.jpg,van,20,136,640,20,360,89,3,156,109,LTAdatasets/8704/annotate/8704-2021_03_20_181851.jpg,146.0,99.0,0.228125,0.275,0.03125,0.05555555555555555
8704-2021_03_20_181851.jpg,car,16,40,640,16,360,98,1,56,114,LTAdatasets/8704/annotate/8704-2021_03_20_181851.jpg,48.0,106.0,0.075,0.29444444444444445,0.025,0.044444444444444446
8704-2021_03_20_181851.jpg,van,23,15,640,21,360,129,3,38,150,LTAdatasets/8704/annotate/8704-2021_03_20_181851.jpg,26.5,139.5,0.04140625,0.3875,0.0359375,0.058333333333333334
8704-2021_03_20_181851.jpg,car,17,50,640,14,360,77,1,67,91,LTAdatasets/8704/annotate/8704-2021_03_20_181851.jpg,58.5,84.0,0.09140625,0.23333333333333334,0.0265625,0.03888888888888889
8704-2021_03_20_181851.jpg,car,14,126,640,12,360,70,1,140,82,LTAdatasets/8704/annotate/8704-2021_03_20_181851.jpg,133.0,76.0,0.2078125,0.2111111111111111,0.021875,0.03333333333333333
8704-2021_03_20_075138.jpg,lorry_truck,25,122,640,25,360,76,2,147,101,LTAdatasets/8704/annotate/8704-2021_03_20_075138.jpg,134.5,88.5,0.21015625,0.24583333333333332,0.0390625,0.06944444444444445
8704-2021_03_20_075138.jpg,car,17,32,640,15,360,105,1,49,120,LTAdatasets/8704/annotate/8704-2021_03_20_075138.jpg,40.5,112.5,0.06328125,0.3125,0.0265625,0.041666666666666664
8704-2021_03_20_075138.jpg,car,15,53,640,13,360,83,1,68,96,LTAdatasets/8704/annotate/8704-2021_03_20_075138.jpg,60.5,89.5,0.09453125,0.24861111111111112,0.0234375,0.03611111111111111
8704-2021_03_20_075138.jpg,car,22,22,640,16,360,129,1,44,145,LTAdatasets/8704/annotate/8704-2021_03_20_075138.jpg,33.0,137.0,0.0515625,0.38055555555555554,0.034375,0.044444444444444446
8704-2021_03_20_094024.jpg,lorry_truck,85,141,640,103,360,179,2,226,282,LTAdatasets/8704/annotate/8704-2021_03_20_094024.jpg,183.5,230.5,0.28671875,0.6402777777777777,0.1328125,0.2861111111111111
8704-2021_03_20_094024.jpg,car,27,127,640,26,360,109,1,154,135,LTAdatasets/8704/annotate/8704-2021_03_20_094024.jpg,140.5,122.0,0.21953125,0.3388888888888889,0.0421875,0.07222222222222222
8704-2021_03_20_094024.jpg,car,17,160,640,12,360,94,1,177,106,LTAdatasets/8704/annotate/8704-2021_03_20_094024.jpg,168.5,100.0,0.26328125,0.2777777777777778,0.0265625,0.03333333333333333
8704-2021_03_20_094024.jpg,car,15,124,640,14,360,82,1,139,96,LTAdatasets/8704/annotate/8704-2021_03_20_094024.jpg,131.5,89.0,0.20546875,0.24722222222222223,0.0234375,0.03888888888888889
8704-2021_03_20_094024.jpg,car,15,55,640,12,360,79,1,70,91,LTAdatasets/8704/annotate/8704-2021_03_20_094024.jpg,62.5,85.0,0.09765625,0.2361111111111111,0.0234375,0.03333333333333333
8704-2021_03_20_094024.jpg,car,22,21,640,17,360,127,1,43,144,LTAdatasets/8704/annotate/8704-2021_03_20_094024.jpg,32.0,135.5,0.05,0.3763888888888889,0.034375,0.04722222222222222
8704-2021_03_20_094904.jpg,car,48,119,640,51,360,248,1,167,299,LTAdatasets/8704/annotate/8704-2021_03_20_094904.jpg,143.0,273.5,0.2234375,0.7597222222222222,0.075,0.14166666666666666
8704-2021_03_20_094904.jpg,bike,14,9,640,27,360,162,4,23,189,LTAdatasets/8704/annotate/8704-2021_03_20_094904.jpg,16.0,175.5,0.025,0.4875,0.021875,0.075
8704-2021_03_20_182752.jpg,car,53,227,640,42,360,232,1,280,274,LTAdatasets/8704/annotate/8704-2021_03_20_182752.jpg,253.5,253.0,0.39609375,0.7027777777777777,0.0828125,0.11666666666666667
8704-2021_03_20_182752.jpg,car,20,29,640,17,360,114,1,49,131,LTAdatasets/8704/annotate/8704-2021_03_20_182752.jpg,39.0,122.5,0.0609375,0.3402777777777778,0.03125,0.04722222222222222
8704-2021_03_20_182752.jpg,car,14,46,640,14,360,89,1,60,103,LTAdatasets/8704/annotate/8704-2021_03_20_182752.jpg,53.0,96.0,0.0828125,0.26666666666666666,0.021875,0.03888888888888889
8704-2021_03_20_182752.jpg,car,18,104,640,15,360,91,1,122,106,LTAdatasets/8704/annotate/8704-2021_03_20_182752.jpg,113.0,98.5,0.1765625,0.27361111111111114,0.028125,0.041666666666666664
8704-2021_03_20_182752.jpg,bike,14,137,640,16,360,72,4,151,88,LTAdatasets/8704/annotate/8704-2021_03_20_182752.jpg,144.0,80.0,0.225,0.2222222222222222,0.021875,0.044444444444444446
8704-2021_03_20_182752.jpg,car,12,59,640,10,360,67,1,71,77,LTAdatasets/8704/annotate/8704-2021_03_20_182752.jpg,65.0,72.0,0.1015625,0.2,0.01875,0.027777777777777776
8704-2021_03_20_191914.jpg,lorry_truck,28,9,640,35,360,116,2,37,151,LTAdatasets/8704/annotate/8704-2021_03_20_191914.jpg,23.0,133.5,0.0359375,0.37083333333333335,0.04375,0.09722222222222222
8704-2021_03_20_191914.jpg,car,15,53,640,14,360,78,1,68,92,LTAdatasets/8704/annotate/8704-2021_03_20_191914.jpg,60.5,85.0,0.09453125,0.2361111111111111,0.0234375,0.03888888888888889
8704-2021_03_20_191914.jpg,car,10,62,640,9,360,68,1,72,77,LTAdatasets/8704/annotate/8704-2021_03_20_191914.jpg,67.0,72.5,0.1046875,0.2013888888888889,0.015625,0.025
8704-2021_03_20_191914.jpg,van,15,125,640,14,360,68,3,140,82,LTAdatasets/8704/annotate/8704-2021_03_20_191914.jpg,132.5,75.0,0.20703125,0.20833333333333334,0.0234375,0.03888888888888889
8704-2021_03_20_090702.jpg,bike,17,73,640,28,360,192,4,90,220,LTAdatasets/8704/annotate/8704-2021_03_20_090702.jpg,81.5,206.0,0.12734375,0.5722222222222222,0.0265625,0.07777777777777778
8704-2021_03_20_090702.jpg,car,22,130,640,14,360,96,1,152,110,LTAdatasets/8704/annotate/8704-2021_03_20_090702.jpg,141.0,103.0,0.2203125,0.2861111111111111,0.034375,0.03888888888888889
8704-2021_03_20_090702.jpg,car,14,46,640,15,360,93,1,60,108,LTAdatasets/8704/annotate/8704-2021_03_20_090702.jpg,53.0,100.5,0.0828125,0.2791666666666667,0.021875,0.041666666666666664
8704-2021_03_20_090702.jpg,car,20,17,640,18,360,136,1,37,154,LTAdatasets/8704/annotate/8704-2021_03_20_090702.jpg,27.0,145.0,0.0421875,0.4027777777777778,0.03125,0.05
8704-2021_03_20_090702.jpg,car,16,56,640,12,360,74,1,72,86,LTAdatasets/8704/annotate/8704-2021_03_20_090702.jpg,64.0,80.0,0.1,0.2222222222222222,0.025,0.03333333333333333
8704-2021_03_20_090702.jpg,van,16,124,640,16,360,76,3,140,92,LTAdatasets/8704/annotate/8704-2021_03_20_090702.jpg,132.0,84.0,0.20625,0.23333333333333334,0.025,0.044444444444444446
8704-2021_03_20_080419.jpg,bus,22,98,640,35,360,68,5,120,103,LTAdatasets/8704/annotate/8704-2021_03_20_080419.jpg,109.0,85.5,0.1703125,0.2375,0.034375,0.09722222222222222
8704-2021_03_20_080419.jpg,car,20,75,640,22,360,113,1,95,135,LTAdatasets/8704/annotate/8704-2021_03_20_080419.jpg,85.0,124.0,0.1328125,0.34444444444444444,0.03125,0.06111111111111111
8704-2021_03_20_080419.jpg,car,19,36,640,18,360,103,1,55,121,LTAdatasets/8704/annotate/8704-2021_03_20_080419.jpg,45.5,112.0,0.07109375,0.3111111111111111,0.0296875,0.05
8704-2021_03_20_202437.jpg,car,20,145,640,13,360,74,1,165,87,LTAdatasets/8704/annotate/8704-2021_03_20_202437.jpg,155.0,80.5,0.2421875,0.22361111111111112,0.03125,0.03611111111111111
8704-2021_03_20_202437.jpg,car,12,118,640,11,360,55,1,130,66,LTAdatasets/8704/annotate/8704-2021_03_20_202437.jpg,124.0,60.5,0.19375,0.16805555555555557,0.01875,0.030555555555555555
8704-2021_03_20_202437.jpg,car,12,137,640,8,360,56,1,149,64,LTAdatasets/8704/annotate/8704-2021_03_20_202437.jpg,143.0,60.0,0.2234375,0.16666666666666666,0.01875,0.022222222222222223
8704-2021_03_20_200937.jpg,car,20,130,640,17,360,81,1,150,98,LTAdatasets/8704/annotate/8704-2021_03_20_200937.jpg,140.0,89.5,0.21875,0.24861111111111112,0.03125,0.04722222222222222
8704-2021_03_20_200937.jpg,bus,23,98,640,31,360,66,5,121,97,LTAdatasets/8704/annotate/8704-2021_03_20_200937.jpg,109.5,81.5,0.17109375,0.2263888888888889,0.0359375,0.08611111111111111
8704-2021_03_20_200937.jpg,car,16,48,640,17,360,81,1,64,98,LTAdatasets/8704/annotate/8704-2021_03_20_200937.jpg,56.0,89.5,0.0875,0.24861111111111112,0.025,0.04722222222222222
8704-2021_03_20_200937.jpg,car,12,66,640,11,360,58,1,78,69,LTAdatasets/8704/annotate/8704-2021_03_20_200937.jpg,72.0,63.5,0.1125,0.1763888888888889,0.01875,0.030555555555555555
8704-2021_03_20_201317.jpg,car,20,26,640,23,360,117,1,46,140,LTAdatasets/8704/annotate/8704-2021_03_20_201317.jpg,36.0,128.5,0.05625,0.35694444444444445,0.03125,0.06388888888888888
8704-2021_03_20_201317.jpg,bus,16,55,640,15,360,69,5,71,84,LTAdatasets/8704/annotate/8704-2021_03_20_201317.jpg,63.0,76.5,0.0984375,0.2125,0.025,0.041666666666666664
8704-2021_03_20_192515.jpg,van,56,96,640,79,360,261,3,152,340,LTAdatasets/8704/annotate/8704-2021_03_20_192515.jpg,124.0,300.5,0.19375,0.8347222222222223,0.0875,0.21944444444444444
8704-2021_03_20_192515.jpg,car,27,114,640,21,360,128,1,141,149,LTAdatasets/8704/annotate/8704-2021_03_20_192515.jpg,127.5,138.5,0.19921875,0.38472222222222224,0.0421875,0.058333333333333334
8704-2021_03_20_192515.jpg,car,18,134,640,20,360,79,1,152,99,LTAdatasets/8704/annotate/8704-2021_03_20_192515.jpg,143.0,89.0,0.2234375,0.24722222222222223,0.028125,0.05555555555555555
8704-2021_03_20_192515.jpg,bike,14,170,640,17,360,93,4,184,110,LTAdatasets/8704/annotate/8704-2021_03_20_192515.jpg,177.0,101.5,0.2765625,0.28194444444444444,0.021875,0.04722222222222222
8704-2021_03_20_192515.jpg,bike,17,197,640,22,360,125,4,214,147,LTAdatasets/8704/annotate/8704-2021_03_20_192515.jpg,205.5,136.0,0.32109375,0.37777777777777777,0.0265625,0.06111111111111111
8704-2021_03_20_192515.jpg,bike,12,29,640,14,360,108,4,41,122,LTAdatasets/8704/annotate/8704-2021_03_20_192515.jpg,35.0,115.0,0.0546875,0.3194444444444444,0.01875,0.03888888888888889
8704-2021_03_20_192515.jpg,lorry_truck,21,102,640,20,360,80,2,123,100,LTAdatasets/8704/annotate/8704-2021_03_20_192515.jpg,112.5,90.0,0.17578125,0.25,0.0328125,0.05555555555555555
8704-2021_03_20_192515.jpg,van,24,5,640,33,360,134,3,29,167,LTAdatasets/8704/annotate/8704-2021_03_20_192515.jpg,17.0,150.5,0.0265625,0.41805555555555557,0.0375,0.09166666666666666
8704-2021_03_20_190413.jpg,car,20,39,640,15,360,98,1,59,113,LTAdatasets/8704/annotate/8704-2021_03_20_190413.jpg,49.0,105.5,0.0765625,0.29305555555555557,0.03125,0.041666666666666664
8704-2021_03_20_190413.jpg,car,14,81,640,14,360,73,1,95,87,LTAdatasets/8704/annotate/8704-2021_03_20_190413.jpg,88.0,80.0,0.1375,0.2222222222222222,0.021875,0.03888888888888889
8704-2021_03_20_190413.jpg,bike,9,59,640,9,360,66,4,68,75,LTAdatasets/8704/annotate/8704-2021_03_20_190413.jpg,63.5,70.5,0.09921875,0.19583333333333333,0.0140625,0.025
8704-2021_03_20_194616.jpg,lorry_truck,31,75,640,40,360,114,2,106,154,LTAdatasets/8704/annotate/8704-2021_03_20_194616.jpg,90.5,134.0,0.14140625,0.37222222222222223,0.0484375,0.1111111111111111
8704-2021_03_20_194616.jpg,lorry_truck,16,79,640,14,360,66,2,95,80,LTAdatasets/8704/annotate/8704-2021_03_20_194616.jpg,87.0,73.0,0.1359375,0.20277777777777778,0.025,0.03888888888888889
8704-2021_03_20_083340.jpg,lorry_truck,52,135,640,53,360,175,2,187,228,LTAdatasets/8704/annotate/8704-2021_03_20_083340.jpg,161.0,201.5,0.2515625,0.5597222222222222,0.08125,0.14722222222222223
8704-2021_03_20_083340.jpg,lorry_truck,30,114,640,61,360,98,2,144,159,LTAdatasets/8704/annotate/8704-2021_03_20_083340.jpg,129.0,128.5,0.2015625,0.35694444444444445,0.046875,0.16944444444444445
8704-2021_03_20_083340.jpg,van,67,250,640,64,360,234,3,317,298,LTAdatasets/8704/annotate/8704-2021_03_20_083340.jpg,283.5,266.0,0.44296875,0.7388888888888889,0.1046875,0.17777777777777778
8704-2021_03_20_083340.jpg,van,15,92,640,18,360,90,3,107,108,LTAdatasets/8704/annotate/8704-2021_03_20_083340.jpg,99.5,99.0,0.15546875,0.275,0.0234375,0.05
8704-2021_03_20_083340.jpg,lorry_truck,15,75,640,21,360,79,2,90,100,LTAdatasets/8704/annotate/8704-2021_03_20_083340.jpg,82.5,89.5,0.12890625,0.24861111111111112,0.0234375,0.058333333333333334
8704-2021_03_20_083340.jpg,car,21,150,640,15,360,80,1,171,95,LTAdatasets/8704/annotate/8704-2021_03_20_083340.jpg,160.5,87.5,0.25078125,0.24305555555555555,0.0328125,0.041666666666666664
8704-2021_03_20_180710.jpg,car,21,112,640,18,360,103,1,133,121,LTAdatasets/8704/annotate/8704-2021_03_20_180710.jpg,122.5,112.0,0.19140625,0.3111111111111111,0.0328125,0.05
8704-2021_03_20_180710.jpg,car,17,47,640,16,360,82,1,64,98,LTAdatasets/8704/annotate/8704-2021_03_20_180710.jpg,55.5,90.0,0.08671875,0.25,0.0265625,0.044444444444444446
8704-2021_03_20_180710.jpg,lorry_truck,15,122,640,17,360,62,2,137,79,LTAdatasets/8704/annotate/8704-2021_03_20_180710.jpg,129.5,70.5,0.20234375,0.19583333333333333,0.0234375,0.04722222222222222
8704-2021_03_20_180710.jpg,car,12,143,640,11,360,60,1,155,71,LTAdatasets/8704/annotate/8704-2021_03_20_180710.jpg,149.0,65.5,0.2328125,0.18194444444444444,0.01875,0.030555555555555555
8704-2021_03_20_180710.jpg,lorry_truck,17,98,640,26,360,55,2,115,81,LTAdatasets/8704/annotate/8704-2021_03_20_180710.jpg,106.5,68.0,0.16640625,0.18888888888888888,0.0265625,0.07222222222222222
8704-2021_03_20_193635.jpg,lorry_truck,24,134,640,22,360,89,2,158,111,LTAdatasets/8704/annotate/8704-2021_03_20_193635.jpg,146.0,100.0,0.228125,0.2777777777777778,0.0375,0.06111111111111111
8704-2021_03_20_193635.jpg,car,30,122,640,24,360,143,1,152,167,LTAdatasets/8704/annotate/8704-2021_03_20_193635.jpg,137.0,155.0,0.2140625,0.4305555555555556,0.046875,0.06666666666666667
8704-2021_03_20_193635.jpg,car,25,75,640,21,360,125,1,100,146,LTAdatasets/8704/annotate/8704-2021_03_20_193635.jpg,87.5,135.5,0.13671875,0.3763888888888889,0.0390625,0.058333333333333334
8704-2021_03_20_094605.jpg,van,81,277,640,71,360,276,3,358,347,LTAdatasets/8704/annotate/8704-2021_03_20_094605.jpg,317.5,311.5,0.49609375,0.8652777777777778,0.1265625,0.19722222222222222
8704-2021_03_20_094605.jpg,car,27,87,640,29,360,172,1,114,201,LTAdatasets/8704/annotate/8704-2021_03_20_094605.jpg,100.5,186.5,0.15703125,0.5180555555555556,0.0421875,0.08055555555555556
8704-2021_03_20_094605.jpg,car,27,16,640,21,360,146,1,43,167,LTAdatasets/8704/annotate/8704-2021_03_20_094605.jpg,29.5,156.5,0.04609375,0.43472222222222223,0.0421875,0.058333333333333334
8704-2021_03_20_094605.jpg,car,8,124,640,9,360,65,1,132,74,LTAdatasets/8704/annotate/8704-2021_03_20_094605.jpg,128.0,69.5,0.2,0.19305555555555556,0.0125,0.025
8704-2021_03_20_094605.jpg,lorry_truck,15,77,640,24,360,60,2,92,84,LTAdatasets/8704/annotate/8704-2021_03_20_094605.jpg,84.5,72.0,0.13203125,0.2,0.0234375,0.06666666666666667
8704-2021_03_20_094605.jpg,lorry_truck,14,115,640,14,360,76,2,129,90,LTAdatasets/8704/annotate/8704-2021_03_20_094605.jpg,122.0,83.0,0.190625,0.23055555555555557,0.021875,0.03888888888888889
8704-2021_03_20_180410.jpg,car,20,31,640,16,360,114,1,51,130,LTAdatasets/8704/annotate/8704-2021_03_20_180410.jpg,41.0,122.0,0.0640625,0.3388888888888889,0.03125,0.044444444444444446
8704-2021_03_20_180410.jpg,car,15,54,640,12,360,77,1,69,89,LTAdatasets/8704/annotate/8704-2021_03_20_180410.jpg,61.5,83.0,0.09609375,0.23055555555555557,0.0234375,0.03333333333333333
8704-2021_03_20_200637.jpg,car,21,134,640,15,360,87,1,155,102,LTAdatasets/8704/annotate/8704-2021_03_20_200637.jpg,144.5,94.5,0.22578125,0.2625,0.0328125,0.041666666666666664
8704-2021_03_20_200637.jpg,car,13,54,640,12,360,80,1,67,92,LTAdatasets/8704/annotate/8704-2021_03_20_200637.jpg,60.5,86.0,0.09453125,0.2388888888888889,0.0203125,0.03333333333333333
8704-2021_03_20_200637.jpg,bus,23,62,640,20,360,52,5,85,72,LTAdatasets/8704/annotate/8704-2021_03_20_200637.jpg,73.5,62.0,0.11484375,0.17222222222222222,0.0359375,0.05555555555555555
8704-2021_03_20_200637.jpg,lorry_truck,17,41,640,21,360,96,2,58,117,LTAdatasets/8704/annotate/8704-2021_03_20_200637.jpg,49.5,106.5,0.07734375,0.29583333333333334,0.0265625,0.058333333333333334
8704-2021_03_20_200637.jpg,car,18,19,640,22,360,126,1,37,148,LTAdatasets/8704/annotate/8704-2021_03_20_200637.jpg,28.0,137.0,0.04375,0.38055555555555554,0.028125,0.06111111111111111
8704-2021_03_20_091623.jpg,van,54,251,640,48,360,243,3,305,291,LTAdatasets/8704/annotate/8704-2021_03_20_091623.jpg,278.0,267.0,0.434375,0.7416666666666667,0.084375,0.13333333333333333
8704-2021_03_20_091623.jpg,lorry_truck,26,100,640,36,360,74,2,126,110,LTAdatasets/8704/annotate/8704-2021_03_20_091623.jpg,113.0,92.0,0.1765625,0.25555555555555554,0.040625,0.1
8704-2021_03_20_091623.jpg,lorry_truck,5,60,640,1,360,89,2,65,90,LTAdatasets/8704/annotate/8704-2021_03_20_091623.jpg,62.5,89.5,0.09765625,0.24861111111111112,0.0078125,0.002777777777777778
8704-2021_03_20_091623.jpg,car,15,136,640,17,360,89,1,151,106,LTAdatasets/8704/annotate/8704-2021_03_20_091623.jpg,143.5,97.5,0.22421875,0.2708333333333333,0.0234375,0.04722222222222222
8704-2021_03_20_091623.jpg,car,19,20,640,23,360,136,1,39,159,LTAdatasets/8704/annotate/8704-2021_03_20_091623.jpg,29.5,147.5,0.04609375,0.4097222222222222,0.0296875,0.06388888888888888
8704-2021_03_20_091623.jpg,van,16,44,640,15,360,92,3,60,107,LTAdatasets/8704/annotate/8704-2021_03_20_091623.jpg,52.0,99.5,0.08125,0.2763888888888889,0.025,0.041666666666666664
8704-2021_03_20_091623.jpg,car,17,56,640,12,360,72,1,73,84,LTAdatasets/8704/annotate/8704-2021_03_20_091623.jpg,64.5,78.0,0.10078125,0.21666666666666667,0.0265625,0.03333333333333333
8704-2021_03_20_091623.jpg,bike,12,135,640,15,360,58,4,147,73,LTAdatasets/8704/annotate/8704-2021_03_20_091623.jpg,141.0,65.5,0.2203125,0.18194444444444444,0.01875,0.041666666666666664
8704-2021_03_20_081920.jpg,lorry_truck,38,103,640,52,360,98,2,141,150,LTAdatasets/8704/annotate/8704-2021_03_20_081920.jpg,122.0,124.0,0.190625,0.34444444444444444,0.059375,0.14444444444444443
8704-2021_03_20_081920.jpg,bus,112,157,640,136,360,211,5,269,347,LTAdatasets/8704/annotate/8704-2021_03_20_081920.jpg,213.0,279.0,0.3328125,0.775,0.175,0.37777777777777777
8704-2021_03_20_091002.jpg,lorry_truck,20,74,640,39,360,62,2,94,101,LTAdatasets/8704/annotate/8704-2021_03_20_091002.jpg,84.0,81.5,0.13125,0.2263888888888889,0.03125,0.10833333333333334
8704-2021_03_20_091002.jpg,lorry_truck,22,119,640,30,360,123,2,141,153,LTAdatasets/8704/annotate/8704-2021_03_20_091002.jpg,130.0,138.0,0.203125,0.38333333333333336,0.034375,0.08333333333333333
8704-2021_03_20_091002.jpg,bike,12,126,640,14,360,85,4,138,99,LTAdatasets/8704/annotate/8704-2021_03_20_091002.jpg,132.0,92.0,0.20625,0.25555555555555554,0.01875,0.03888888888888889
8704-2021_03_20_091002.jpg,car,46,107,640,61,360,296,1,153,357,LTAdatasets/8704/annotate/8704-2021_03_20_091002.jpg,130.0,326.5,0.203125,0.9069444444444444,0.071875,0.16944444444444445
8704-2021_03_20_091002.jpg,car,17,1,640,33,360,162,1,18,195,LTAdatasets/8704/annotate/8704-2021_03_20_091002.jpg,9.5,178.5,0.01484375,0.49583333333333335,0.0265625,0.09166666666666666
8704-2021_03_20_083120.jpg,bike,18,261,640,28,360,173,4,279,201,LTAdatasets/8704/annotate/8704-2021_03_20_083120.jpg,270.0,187.0,0.421875,0.5194444444444445,0.028125,0.07777777777777778
8704-2021_03_20_083120.jpg,car,25,172,640,21,360,103,1,197,124,LTAdatasets/8704/annotate/8704-2021_03_20_083120.jpg,184.5,113.5,0.28828125,0.31527777777777777,0.0390625,0.058333333333333334
8704-2021_03_20_081319.jpg,car,42,90,640,41,360,214,1,132,255,LTAdatasets/8704/annotate/8704-2021_03_20_081319.jpg,111.0,234.5,0.1734375,0.6513888888888889,0.065625,0.11388888888888889
8704-2021_03_20_081319.jpg,lorry_truck,16,135,640,20,360,91,2,151,111,LTAdatasets/8704/annotate/8704-2021_03_20_081319.jpg,143.0,101.0,0.2234375,0.28055555555555556,0.025,0.05555555555555555
8704-2021_03_20_081319.jpg,lorry_truck,67,213,640,66,360,185,2,280,251,LTAdatasets/8704/annotate/8704-2021_03_20_081319.jpg,246.5,218.0,0.38515625,0.6055555555555555,0.1046875,0.18333333333333332
8704-2021_03_20_081319.jpg,lorry_truck,27,106,640,34,360,96,2,133,130,LTAdatasets/8704/annotate/8704-2021_03_20_081319.jpg,119.5,113.0,0.18671875,0.3138888888888889,0.0421875,0.09444444444444444
8704-2021_03_20_081319.jpg,lorry_truck,31,65,640,34,360,116,2,96,150,LTAdatasets/8704/annotate/8704-2021_03_20_081319.jpg,80.5,133.0,0.12578125,0.36944444444444446,0.0484375,0.09444444444444444
8704-2021_03_20_081319.jpg,lorry_truck,15,124,640,16,360,67,2,139,83,LTAdatasets/8704/annotate/8704-2021_03_20_081319.jpg,131.5,75.0,0.20546875,0.20833333333333334,0.0234375,0.044444444444444446
8704-2021_03_20_091302.jpg,lorry_truck,14,101,640,19,360,52,2,115,71,LTAdatasets/8704/annotate/8704-2021_03_20_091302.jpg,108.0,61.5,0.16875,0.17083333333333334,0.021875,0.05277777777777778
8704-2021_03_20_091302.jpg,bike,10,124,640,16,360,56,4,134,72,LTAdatasets/8704/annotate/8704-2021_03_20_091302.jpg,129.0,64.0,0.2015625,0.17777777777777778,0.015625,0.044444444444444446
8704-2021_03_20_203058.jpg,car,22,20,640,23,360,135,1,42,158,LTAdatasets/8704/annotate/8704-2021_03_20_203058.jpg,31.0,146.5,0.0484375,0.40694444444444444,0.034375,0.06388888888888888
8704-2021_03_20_203058.jpg,car,20,41,640,15,360,95,1,61,110,LTAdatasets/8704/annotate/8704-2021_03_20_203058.jpg,51.0,102.5,0.0796875,0.2847222222222222,0.03125,0.041666666666666664
8704-2021_03_20_203058.jpg,car,16,52,640,13,360,73,1,68,86,LTAdatasets/8704/annotate/8704-2021_03_20_203058.jpg,60.0,79.5,0.09375,0.22083333333333333,0.025,0.03611111111111111
8704-2021_03_20_191614.jpg,lorry_truck,68,153,640,75,360,188,2,221,263,LTAdatasets/8704/annotate/8704-2021_03_20_191614.jpg,187.0,225.5,0.2921875,0.6263888888888889,0.10625,0.20833333333333334
8704-2021_03_20_191614.jpg,car,22,20,640,23,360,134,1,42,157,LTAdatasets/8704/annotate/8704-2021_03_20_191614.jpg,31.0,145.5,0.0484375,0.4041666666666667,0.034375,0.06388888888888888
8704-2021_03_20_191614.jpg,car,33,30,640,18,360,101,1,63,119,LTAdatasets/8704/annotate/8704-2021_03_20_191614.jpg,46.5,110.0,0.07265625,0.3055555555555556,0.0515625,0.05
8704-2021_03_20_084001.jpg,bike,17,156,640,21,360,117,4,173,138,LTAdatasets/8704/annotate/8704-2021_03_20_084001.jpg,164.5,127.5,0.25703125,0.3541666666666667,0.0265625,0.058333333333333334
8704-2021_03_20_084001.jpg,car,20,24,640,20,360,127,1,44,147,LTAdatasets/8704/annotate/8704-2021_03_20_084001.jpg,34.0,137.0,0.053125,0.38055555555555554,0.03125,0.05555555555555555
8704-2021_03_20_084001.jpg,van,21,36,640,17,360,95,3,57,112,LTAdatasets/8704/annotate/8704-2021_03_20_084001.jpg,46.5,103.5,0.07265625,0.2875,0.0328125,0.04722222222222222
8704-2021_03_20_084001.jpg,car,16,59,640,11,360,80,1,75,91,LTAdatasets/8704/annotate/8704-2021_03_20_084001.jpg,67.0,85.5,0.1046875,0.2375,0.025,0.030555555555555555
8704-2021_03_20_194315.jpg,car,64,154,640,64,360,296,1,218,360,LTAdatasets/8704/annotate/8704-2021_03_20_194315.jpg,186.0,328.0,0.290625,0.9111111111111111,0.1,0.17777777777777778
8704-2021_03_20_194315.jpg,car,14,123,640,9,360,58,1,137,67,LTAdatasets/8704/annotate/8704-2021_03_20_194315.jpg,130.0,62.5,0.203125,0.1736111111111111,0.021875,0.025
8704-2021_03_20_194315.jpg,car,13,99,640,10,360,66,1,112,76,LTAdatasets/8704/annotate/8704-2021_03_20_194315.jpg,105.5,71.0,0.16484375,0.19722222222222222,0.0203125,0.027777777777777776
8704-2021_03_20_183112.jpg,lorry_truck,45,126,640,54,360,176,2,171,230,LTAdatasets/8704/annotate/8704-2021_03_20_183112.jpg,148.5,203.0,0.23203125,0.5638888888888889,0.0703125,0.15
8704-2021_03_20_183112.jpg,car,62,312,640,42,360,244,1,374,286,LTAdatasets/8704/annotate/8704-2021_03_20_183112.jpg,343.0,265.0,0.5359375,0.7361111111111112,0.096875,0.11666666666666667
8704-2021_03_20_183112.jpg,lorry_truck,30,72,640,41,360,119,2,102,160,LTAdatasets/8704/annotate/8704-2021_03_20_183112.jpg,87.0,139.5,0.1359375,0.3875,0.046875,0.11388888888888889
8704-2021_03_20_183112.jpg,lorry_truck,27,107,640,28,360,97,2,134,125,LTAdatasets/8704/annotate/8704-2021_03_20_183112.jpg,120.5,111.0,0.18828125,0.30833333333333335,0.0421875,0.07777777777777778
8704-2021_03_20_183112.jpg,car,11,128,640,14,360,68,1,139,82,LTAdatasets/8704/annotate/8704-2021_03_20_183112.jpg,133.5,75.0,0.20859375,0.20833333333333334,0.0171875,0.03888888888888889
8704-2021_03_20_183112.jpg,car,12,42,640,12,360,91,1,54,103,LTAdatasets/8704/annotate/8704-2021_03_20_183112.jpg,48.0,97.0,0.075,0.26944444444444443,0.01875,0.03333333333333333
8704-2021_03_20_183112.jpg,lorry_truck,17,99,640,17,360,57,2,116,74,LTAdatasets/8704/annotate/8704-2021_03_20_183112.jpg,107.5,65.5,0.16796875,0.18194444444444444,0.0265625,0.04722222222222222
8704-2021_03_20_201917.jpg,car,50,236,640,40,360,224,1,286,264,LTAdatasets/8704/annotate/8704-2021_03_20_201917.jpg,261.0,244.0,0.4078125,0.6777777777777778,0.078125,0.1111111111111111
8704-2021_03_20_201917.jpg,car,19,78,640,18,360,104,1,97,122,LTAdatasets/8704/annotate/8704-2021_03_20_201917.jpg,87.5,113.0,0.13671875,0.3138888888888889,0.0296875,0.05
8704-2021_03_20_201917.jpg,bike,12,132,640,16,360,87,4,144,103,LTAdatasets/8704/annotate/8704-2021_03_20_201917.jpg,138.0,95.0,0.215625,0.2638888888888889,0.01875,0.044444444444444446
8704-2021_03_20_201917.jpg,car,15,120,640,10,360,60,1,135,70,LTAdatasets/8704/annotate/8704-2021_03_20_201917.jpg,127.5,65.0,0.19921875,0.18055555555555555,0.0234375,0.027777777777777776
8704-2021_03_20_193935.jpg,car,26,180,640,24,360,105,1,206,129,LTAdatasets/8704/annotate/8704-2021_03_20_193935.jpg,193.0,117.0,0.3015625,0.325,0.040625,0.06666666666666667
8704-2021_03_20_193935.jpg,car,12,123,640,11,360,64,1,135,75,LTAdatasets/8704/annotate/8704-2021_03_20_193935.jpg,129.0,69.5,0.2015625,0.19305555555555556,0.01875,0.030555555555555555
8704-2021_03_20_200416.jpg,bike,21,230,640,27,360,168,4,251,195,LTAdatasets/8704/annotate/8704-2021_03_20_200416.jpg,240.5,181.5,0.37578125,0.5041666666666667,0.0328125,0.075
8704-2021_03_20_200416.jpg,bike,15,131,640,17,360,149,4,146,166,LTAdatasets/8704/annotate/8704-2021_03_20_200416.jpg,138.5,157.5,0.21640625,0.4375,0.0234375,0.04722222222222222
8704-2021_03_20_200416.jpg,car,22,195,640,17,360,121,1,217,138,LTAdatasets/8704/annotate/8704-2021_03_20_200416.jpg,206.0,129.5,0.321875,0.3597222222222222,0.034375,0.04722222222222222
8704-2021_03_20_200416.jpg,car,24,74,640,20,360,125,1,98,145,LTAdatasets/8704/annotate/8704-2021_03_20_200416.jpg,86.0,135.0,0.134375,0.375,0.0375,0.05555555555555555
8704-2021_03_20_200416.jpg,car,31,86,640,38,360,166,1,117,204,LTAdatasets/8704/annotate/8704-2021_03_20_200416.jpg,101.5,185.0,0.15859375,0.5138888888888888,0.0484375,0.10555555555555556
8704-2021_03_20_200416.jpg,van,26,156,640,28,360,122,3,182,150,LTAdatasets/8704/annotate/8704-2021_03_20_200416.jpg,169.0,136.0,0.2640625,0.37777777777777777,0.040625,0.07777777777777778
8704-2021_03_20_200416.jpg,lorry_truck,15,46,640,19,360,85,2,61,104,LTAdatasets/8704/annotate/8704-2021_03_20_200416.jpg,53.5,94.5,0.08359375,0.2625,0.0234375,0.05277777777777778
8704-2021_03_20_181011.jpg,car,45,232,640,39,360,217,1,277,256,LTAdatasets/8704/annotate/8704-2021_03_20_181011.jpg,254.5,236.5,0.39765625,0.6569444444444444,0.0703125,0.10833333333333334
8704-2021_03_20_181011.jpg,lorry_truck,68,205,640,41,360,319,2,273,360,LTAdatasets/8704/annotate/8704-2021_03_20_181011.jpg,239.0,339.5,0.3734375,0.9430555555555555,0.10625,0.11388888888888889
8704-2021_03_20_181011.jpg,lorry_truck,21,99,640,24,360,61,2,120,85,LTAdatasets/8704/annotate/8704-2021_03_20_181011.jpg,109.5,73.0,0.17109375,0.20277777777777778,0.0328125,0.06666666666666667
8704-2021_03_20_181251.jpg,van,21,29,640,18,360,105,3,50,123,LTAdatasets/8704/annotate/8704-2021_03_20_181251.jpg,39.5,114.0,0.06171875,0.31666666666666665,0.0328125,0.05
8704-2021_03_20_181251.jpg,bike,9,77,640,12,360,73,4,86,85,LTAdatasets/8704/annotate/8704-2021_03_20_181251.jpg,81.5,79.0,0.12734375,0.21944444444444444,0.0140625,0.03333333333333333
8704-2021_03_20_181251.jpg,bike,9,93,640,9,360,54,4,102,63,LTAdatasets/8704/annotate/8704-2021_03_20_181251.jpg,97.5,58.5,0.15234375,0.1625,0.0140625,0.025
8704-2021_03_20_095505.jpg,van,18,131,640,16,360,89,3,149,105,LTAdatasets/8704/annotate/8704-2021_03_20_095505.jpg,140.0,97.0,0.21875,0.26944444444444443,0.028125,0.044444444444444446
8704-2021_03_20_095505.jpg,car,20,33,640,21,360,112,1,53,133,LTAdatasets/8704/annotate/8704-2021_03_20_095505.jpg,43.0,122.5,0.0671875,0.3402777777777778,0.03125,0.058333333333333334
8704-2021_03_20_191014.jpg,van,15,102,640,13,360,66,3,117,79,LTAdatasets/8704/annotate/8704-2021_03_20_191014.jpg,109.5,72.5,0.17109375,0.2013888888888889,0.0234375,0.03611111111111111
8704-2021_03_20_184613.jpg,lorry_truck,22,78,640,21,360,98,2,100,119,LTAdatasets/8704/annotate/8704-2021_03_20_184613.jpg,89.0,108.5,0.1390625,0.3013888888888889,0.034375,0.058333333333333334
8704-2021_03_20_184613.jpg,lorry_truck,27,108,640,29,360,91,2,135,120,LTAdatasets/8704/annotate/8704-2021_03_20_184613.jpg,121.5,105.5,0.18984375,0.29305555555555557,0.0421875,0.08055555555555556
8704-2021_03_20_184613.jpg,lorry_truck,39,122,640,43,360,130,2,161,173,LTAdatasets/8704/annotate/8704-2021_03_20_184613.jpg,141.5,151.5,0.22109375,0.42083333333333334,0.0609375,0.11944444444444445
8704-2021_03_20_184613.jpg,lorry_truck,66,161,640,93,360,218,2,227,311,LTAdatasets/8704/annotate/8704-2021_03_20_184613.jpg,194.0,264.5,0.303125,0.7347222222222223,0.103125,0.25833333333333336
8704-2021_03_20_184613.jpg,car,16,29,640,20,360,118,1,45,138,LTAdatasets/8704/annotate/8704-2021_03_20_184613.jpg,37.0,128.0,0.0578125,0.35555555555555557,0.025,0.05555555555555555
8704-2021_03_20_184613.jpg,car,12,53,640,12,360,73,1,65,85,LTAdatasets/8704/annotate/8704-2021_03_20_184613.jpg,59.0,79.0,0.0921875,0.21944444444444444,0.01875,0.03333333333333333
8704-2021_03_20_082740.jpg,car,40,88,640,36,360,226,1,128,262,LTAdatasets/8704/annotate/8704-2021_03_20_082740.jpg,108.0,244.0,0.16875,0.6777777777777778,0.0625,0.1
8704-2021_03_20_082740.jpg,lorry_truck,52,131,640,57,360,150,2,183,207,LTAdatasets/8704/annotate/8704-2021_03_20_082740.jpg,157.0,178.5,0.2453125,0.49583333333333335,0.08125,0.15833333333333333
8704-2021_03_20_082740.jpg,lorry_truck,28,109,640,31,360,103,2,137,134,LTAdatasets/8704/annotate/8704-2021_03_20_082740.jpg,123.0,118.5,0.1921875,0.32916666666666666,0.04375,0.08611111111111111
8704-2021_03_20_082740.jpg,van,27,21,640,22,360,115,3,48,137,LTAdatasets/8704/annotate/8704-2021_03_20_082740.jpg,34.5,126.0,0.05390625,0.35,0.0421875,0.06111111111111111
8704-2021_03_20_192214.jpg,car,53,234,640,45,360,230,1,287,275,LTAdatasets/8704/annotate/8704-2021_03_20_192214.jpg,260.5,252.5,0.40703125,0.7013888888888888,0.0828125,0.125
8704-2021_03_20_192214.jpg,car,35,222,640,29,360,146,1,257,175,LTAdatasets/8704/annotate/8704-2021_03_20_192214.jpg,239.5,160.5,0.37421875,0.44583333333333336,0.0546875,0.08055555555555556
8704-2021_03_20_192214.jpg,car,42,106,640,47,360,254,1,148,301,LTAdatasets/8704/annotate/8704-2021_03_20_192214.jpg,127.0,277.5,0.1984375,0.7708333333333334,0.065625,0.13055555555555556
8704-2021_03_20_192214.jpg,car,24,21,640,23,360,127,1,45,150,LTAdatasets/8704/annotate/8704-2021_03_20_192214.jpg,33.0,138.5,0.0515625,0.38472222222222224,0.0375,0.06388888888888888
8704-2021_03_20_192214.jpg,car,20,39,640,18,360,95,1,59,113,LTAdatasets/8704/annotate/8704-2021_03_20_192214.jpg,49.0,104.0,0.0765625,0.28888888888888886,0.03125,0.05
8704-2021_03_20_192214.jpg,car,12,53,640,14,360,79,1,65,93,LTAdatasets/8704/annotate/8704-2021_03_20_192214.jpg,59.0,86.0,0.0921875,0.2388888888888889,0.01875,0.03888888888888889
8704-2021_03_20_192214.jpg,car,15,125,640,11,360,77,1,140,88,LTAdatasets/8704/annotate/8704-2021_03_20_192214.jpg,132.5,82.5,0.20703125,0.22916666666666666,0.0234375,0.030555555555555555
8704-2021_03_20_192214.jpg,lorry_truck,14,80,640,20,360,64,2,94,84,LTAdatasets/8704/annotate/8704-2021_03_20_192214.jpg,87.0,74.0,0.1359375,0.20555555555555555,0.021875,0.05555555555555555
8704-2021_03_20_090402.jpg,car,35,251,640,26,360,173,1,286,199,LTAdatasets/8704/annotate/8704-2021_03_20_090402.jpg,268.5,186.0,0.41953125,0.5166666666666667,0.0546875,0.07222222222222222
8704-2021_03_20_090402.jpg,van,21,148,640,22,360,116,3,169,138,LTAdatasets/8704/annotate/8704-2021_03_20_090402.jpg,158.5,127.0,0.24765625,0.3527777777777778,0.0328125,0.06111111111111111
8704-2021_03_20_090402.jpg,car,22,172,640,16,360,105,1,194,121,LTAdatasets/8704/annotate/8704-2021_03_20_090402.jpg,183.0,113.0,0.2859375,0.3138888888888889,0.034375,0.044444444444444446
8704-2021_03_20_090402.jpg,car,18,48,640,23,360,82,1,66,105,LTAdatasets/8704/annotate/8704-2021_03_20_090402.jpg,57.0,93.5,0.0890625,0.25972222222222224,0.028125,0.06388888888888888
8704-2021_03_20_090402.jpg,car,19,21,640,20,360,137,1,40,157,LTAdatasets/8704/annotate/8704-2021_03_20_090402.jpg,30.5,147.0,0.04765625,0.4083333333333333,0.0296875,0.05555555555555555
8704-2021_03_20_090402.jpg,lorry_truck,26,98,640,30,360,70,2,124,100,LTAdatasets/8704/annotate/8704-2021_03_20_090402.jpg,111.0,85.0,0.1734375,0.2361111111111111,0.040625,0.08333333333333333
8704-2021_03_20_090402.jpg,lorry_truck,15,59,640,20,360,62,2,74,82,LTAdatasets/8704/annotate/8704-2021_03_20_090402.jpg,66.5,72.0,0.10390625,0.2,0.0234375,0.05555555555555555
8704-2021_03_20_100105.jpg,bus,48,113,640,74,360,122,5,161,196,LTAdatasets/8704/annotate/8704-2021_03_20_100105.jpg,137.0,159.0,0.2140625,0.44166666666666665,0.075,0.20555555555555555
8704-2021_03_20_100105.jpg,lorry_truck,31,97,640,35,360,81,2,128,116,LTAdatasets/8704/annotate/8704-2021_03_20_100105.jpg,112.5,98.5,0.17578125,0.27361111111111114,0.0484375,0.09722222222222222
8704-2021_03_20_100105.jpg,car,80,302,640,55,360,304,1,382,359,LTAdatasets/8704/annotate/8704-2021_03_20_100105.jpg,342.0,331.5,0.534375,0.9208333333333333,0.125,0.1527777777777778
8704-2021_03_20_100105.jpg,car,17,136,640,18,360,89,1,153,107,LTAdatasets/8704/annotate/8704-2021_03_20_100105.jpg,144.5,98.0,0.22578125,0.2722222222222222,0.0265625,0.05
8704-2021_03_20_191234.jpg,lorry_truck,50,214,640,61,360,201,2,264,262,LTAdatasets/8704/annotate/8704-2021_03_20_191234.jpg,239.0,231.5,0.3734375,0.6430555555555556,0.078125,0.16944444444444445
8704-2021_03_20_191234.jpg,bus,35,409,640,28,360,96,5,444,124,LTAdatasets/8704/annotate/8704-2021_03_20_191234.jpg,426.5,110.0,0.66640625,0.3055555555555556,0.0546875,0.07777777777777778
8704-2021_03_20_191234.jpg,car,10,143,640,12,360,62,1,153,74,LTAdatasets/8704/annotate/8704-2021_03_20_191234.jpg,148.0,68.0,0.23125,0.18888888888888888,0.015625,0.03333333333333333
8704-2021_03_20_191234.jpg,bike,8,125,640,13,360,64,4,133,77,LTAdatasets/8704/annotate/8704-2021_03_20_191234.jpg,129.0,70.5,0.2015625,0.19583333333333333,0.0125,0.03611111111111111
8704-2021_03_20_191234.jpg,car,15,77,640,10,360,61,1,92,71,LTAdatasets/8704/annotate/8704-2021_03_20_191234.jpg,84.5,66.0,0.13203125,0.18333333333333332,0.0234375,0.027777777777777776
8704-2021_03_20_082220.jpg,bike,23,99,640,29,360,213,4,122,242,LTAdatasets/8704/annotate/8704-2021_03_20_082220.jpg,110.5,227.5,0.17265625,0.6319444444444444,0.0359375,0.08055555555555556
8704-2021_03_20_082220.jpg,lorry_truck,43,140,640,39,360,179,2,183,218,LTAdatasets/8704/annotate/8704-2021_03_20_082220.jpg,161.5,198.5,0.25234375,0.5513888888888889,0.0671875,0.10833333333333334
8704-2021_03_20_082220.jpg,car,24,15,640,20,360,146,1,39,166,LTAdatasets/8704/annotate/8704-2021_03_20_082220.jpg,27.0,156.0,0.0421875,0.43333333333333335,0.0375,0.05555555555555555
8704-2021_03_20_085501.jpg,bike,15,182,640,22,360,148,4,197,170,LTAdatasets/8704/annotate/8704-2021_03_20_085501.jpg,189.5,159.0,0.29609375,0.44166666666666665,0.0234375,0.06111111111111111
8704-2021_03_20_085501.jpg,van,20,135,640,16,360,91,3,155,107,LTAdatasets/8704/annotate/8704-2021_03_20_085501.jpg,145.0,99.0,0.2265625,0.275,0.03125,0.044444444444444446
8704-2021_03_20_085501.jpg,lorry_truck,17,103,640,16,360,84,2,120,100,LTAdatasets/8704/annotate/8704-2021_03_20_085501.jpg,111.5,92.0,0.17421875,0.25555555555555554,0.0265625,0.044444444444444446
8704-2021_03_20_085501.jpg,van,45,135,640,40,360,174,3,180,214,LTAdatasets/8704/annotate/8704-2021_03_20_085501.jpg,157.5,194.0,0.24609375,0.5388888888888889,0.0703125,0.1111111111111111
8704-2021_03_20_085501.jpg,car,14,37,640,13,360,100,1,51,113,LTAdatasets/8704/annotate/8704-2021_03_20_085501.jpg,44.0,106.5,0.06875,0.29583333333333334,0.021875,0.03611111111111111
8704-2021_03_20_074618.jpg,car,31,202,640,30,360,173,1,233,203,LTAdatasets/8704/annotate/8704-2021_03_20_074618.jpg,217.5,188.0,0.33984375,0.5222222222222223,0.0484375,0.08333333333333333
8704-2021_03_20_074618.jpg,bike,12,23,640,17,360,128,4,35,145,LTAdatasets/8704/annotate/8704-2021_03_20_074618.jpg,29.0,136.5,0.0453125,0.37916666666666665,0.01875,0.04722222222222222
8704-2021_03_20_074618.jpg,bike,14,126,640,14,360,69,4,140,83,LTAdatasets/8704/annotate/8704-2021_03_20_074618.jpg,133.0,76.0,0.2078125,0.2111111111111111,0.021875,0.03888888888888889
8704-2021_03_20_074918.jpg,car,30,127,640,28,360,142,1,157,170,LTAdatasets/8704/annotate/8704-2021_03_20_074918.jpg,142.0,156.0,0.221875,0.43333333333333335,0.046875,0.07777777777777778
8704-2021_03_20_084301.jpg,car,62,514,640,42,360,254,1,576,296,LTAdatasets/8704/annotate/8704-2021_03_20_084301.jpg,545.0,275.0,0.8515625,0.7638888888888888,0.096875,0.11666666666666667
8704-2021_03_20_092143.jpg,car,56,328,640,45,360,249,1,384,294,LTAdatasets/8704/annotate/8704-2021_03_20_092143.jpg,356.0,271.5,0.55625,0.7541666666666667,0.0875,0.125
8704-2021_03_20_092143.jpg,car,33,193,640,32,360,171,1,226,203,LTAdatasets/8704/annotate/8704-2021_03_20_092143.jpg,209.5,187.0,0.32734375,0.5194444444444445,0.0515625,0.08888888888888889
8704-2021_03_20_092143.jpg,lorry_truck,53,119,640,71,360,137,2,172,208,LTAdatasets/8704/annotate/8704-2021_03_20_092143.jpg,145.5,172.5,0.22734375,0.4791666666666667,0.0828125,0.19722222222222222
8704-2021_03_20_092143.jpg,lorry_truck,21,96,640,21,360,48,2,117,69,LTAdatasets/8704/annotate/8704-2021_03_20_092143.jpg,106.5,58.5,0.16640625,0.1625,0.0328125,0.058333333333333334
8704-2021_03_20_075518.jpg,lorry_truck,39,101,640,51,360,87,2,140,138,LTAdatasets/8704/annotate/8704-2021_03_20_075518.jpg,120.5,112.5,0.18828125,0.3125,0.0609375,0.14166666666666666
8704-2021_03_20_075518.jpg,car,19,76,640,19,360,145,1,95,164,LTAdatasets/8704/annotate/8704-2021_03_20_075518.jpg,85.5,154.5,0.13359375,0.42916666666666664,0.0296875,0.05277777777777778
8704-2021_03_20_075518.jpg,lorry_truck,15,103,640,22,360,58,2,118,80,LTAdatasets/8704/annotate/8704-2021_03_20_075518.jpg,110.5,69.0,0.17265625,0.19166666666666668,0.0234375,0.06111111111111111
8704-2021_03_20_195736.jpg,car,19,45,640,17,360,82,1,64,99,LTAdatasets/8704/annotate/8704-2021_03_20_195736.jpg,54.5,90.5,0.08515625,0.2513888888888889,0.0296875,0.04722222222222222
8704-2021_03_20_073937.jpg,bus,28,0,640,63,360,129,5,28,192,LTAdatasets/8704/annotate/8704-2021_03_20_073937.jpg,14.0,160.5,0.021875,0.44583333333333336,0.04375,0.175
8704-2021_03_20_073937.jpg,lorry_truck,16,123,640,17,360,68,2,139,85,LTAdatasets/8704/annotate/8704-2021_03_20_073937.jpg,131.0,76.5,0.2046875,0.2125,0.025,0.04722222222222222
8704-2021_03_20_073937.jpg,car,16,59,640,15,360,70,1,75,85,LTAdatasets/8704/annotate/8704-2021_03_20_073937.jpg,67.0,77.5,0.1046875,0.2152777777777778,0.025,0.041666666666666664
8704-2021_03_20_093103.jpg,lorry_truck,58,74,640,83,360,171,2,132,254,LTAdatasets/8704/annotate/8704-2021_03_20_093103.jpg,103.0,212.5,0.1609375,0.5902777777777778,0.090625,0.23055555555555557
8704-2021_03_20_093103.jpg,car,14,64,640,12,360,65,1,78,77,LTAdatasets/8704/annotate/8704-2021_03_20_093103.jpg,71.0,71.0,0.1109375,0.19722222222222222,0.021875,0.03333333333333333
8704-2021_03_20_183412.jpg,car,38,97,640,39,360,225,1,135,264,LTAdatasets/8704/annotate/8704-2021_03_20_183412.jpg,116.0,244.5,0.18125,0.6791666666666667,0.059375,0.10833333333333334
8704-2021_03_20_183412.jpg,car,12,131,640,12,360,82,1,143,94,LTAdatasets/8704/annotate/8704-2021_03_20_183412.jpg,137.0,88.0,0.2140625,0.24444444444444444,0.01875,0.03333333333333333
8704-2021_03_20_183412.jpg,car,15,43,640,15,360,88,1,58,103,LTAdatasets/8704/annotate/8704-2021_03_20_183412.jpg,50.5,95.5,0.07890625,0.2652777777777778,0.0234375,0.041666666666666664
8704-2021_03_20_183412.jpg,van,30,127,640,41,360,151,3,157,192,LTAdatasets/8704/annotate/8704-2021_03_20_183412.jpg,142.0,171.5,0.221875,0.47638888888888886,0.046875,0.11388888888888889
8704-2021_03_20_183412.jpg,car,9,67,640,10,360,61,1,76,71,LTAdatasets/8704/annotate/8704-2021_03_20_183412.jpg,71.5,66.0,0.11171875,0.18333333333333332,0.0140625,0.027777777777777776
8704-2021_03_20_201617.jpg,bike,15,81,640,14,360,85,4,96,99,LTAdatasets/8704/annotate/8704-2021_03_20_201617.jpg,88.5,92.0,0.13828125,0.25555555555555554,0.0234375,0.03888888888888889
8704-2021_03_20_201617.jpg,car,15,122,640,11,360,74,1,137,85,LTAdatasets/8704/annotate/8704-2021_03_20_201617.jpg,129.5,79.5,0.20234375,0.22083333333333333,0.0234375,0.030555555555555555
8704-2021_03_20_201617.jpg,car,15,39,640,17,360,98,1,54,115,LTAdatasets/8704/annotate/8704-2021_03_20_201617.jpg,46.5,106.5,0.07265625,0.29583333333333334,0.0234375,0.04722222222222222
8704-2021_03_20_090102.jpg,car,41,206,640,28,360,201,1,247,229,LTAdatasets/8704/annotate/8704-2021_03_20_090102.jpg,226.5,215.0,0.35390625,0.5972222222222222,0.0640625,0.07777777777777778
8704-2021_03_20_090102.jpg,car,43,268,640,28,360,200,1,311,228,LTAdatasets/8704/annotate/8704-2021_03_20_090102.jpg,289.5,214.0,0.45234375,0.5944444444444444,0.0671875,0.07777777777777778
8704-2021_03_20_090102.jpg,lorry_truck,117,202,640,73,360,287,2,319,360,LTAdatasets/8704/annotate/8704-2021_03_20_090102.jpg,260.5,323.5,0.40703125,0.8986111111111111,0.1828125,0.20277777777777778
8704-2021_03_20_090102.jpg,lorry_truck,54,121,640,67,360,134,2,175,201,LTAdatasets/8704/annotate/8704-2021_03_20_090102.jpg,148.0,167.5,0.23125,0.4652777777777778,0.084375,0.18611111111111112
8704-2021_03_20_090102.jpg,lorry_truck,26,73,640,46,360,109,2,99,155,LTAdatasets/8704/annotate/8704-2021_03_20_090102.jpg,86.0,132.0,0.134375,0.36666666666666664,0.040625,0.12777777777777777
8704-2021_03_20_090102.jpg,car,19,185,640,20,360,113,1,204,133,LTAdatasets/8704/annotate/8704-2021_03_20_090102.jpg,194.5,123.0,0.30390625,0.3416666666666667,0.0296875,0.05555555555555555
8704-2021_03_20_090102.jpg,car,20,136,640,17,360,95,1,156,112,LTAdatasets/8704/annotate/8704-2021_03_20_090102.jpg,146.0,103.5,0.228125,0.2875,0.03125,0.04722222222222222
8704-2021_03_20_090102.jpg,car,11,141,640,11,360,68,1,152,79,LTAdatasets/8704/annotate/8704-2021_03_20_090102.jpg,146.5,73.5,0.22890625,0.20416666666666666,0.0171875,0.030555555555555555
8704-2021_03_20_183952.jpg,lorry_truck,45,135,640,60,360,160,2,180,220,LTAdatasets/8704/annotate/8704-2021_03_20_183952.jpg,157.5,190.0,0.24609375,0.5277777777777778,0.0703125,0.16666666666666666
8704-2021_03_20_183952.jpg,lorry_truck,37,198,640,50,360,161,2,235,211,LTAdatasets/8704/annotate/8704-2021_03_20_183952.jpg,216.5,186.0,0.33828125,0.5166666666666667,0.0578125,0.1388888888888889
8704-2021_03_20_183952.jpg,bike,24,194,640,42,360,296,4,218,338,LTAdatasets/8704/annotate/8704-2021_03_20_183952.jpg,206.0,317.0,0.321875,0.8805555555555555,0.0375,0.11666666666666667
8704-2021_03_20_183952.jpg,car,21,80,640,24,360,137,1,101,161,LTAdatasets/8704/annotate/8704-2021_03_20_183952.jpg,90.5,149.0,0.14140625,0.41388888888888886,0.0328125,0.06666666666666667
8704-2021_03_20_183952.jpg,lorry_truck,28,148,640,33,360,105,2,176,138,LTAdatasets/8704/annotate/8704-2021_03_20_183952.jpg,162.0,121.5,0.253125,0.3375,0.04375,0.09166666666666666
8704-2021_03_20_183952.jpg,lorry_truck,26,104,640,27,360,84,2,130,111,LTAdatasets/8704/annotate/8704-2021_03_20_183952.jpg,117.0,97.5,0.1828125,0.2708333333333333,0.040625,0.075
8704-2021_03_20_183952.jpg,van,16,81,640,17,360,73,3,97,90,LTAdatasets/8704/annotate/8704-2021_03_20_183952.jpg,89.0,81.5,0.1390625,0.2263888888888889,0.025,0.04722222222222222
8704-2021_03_20_200116.jpg,car,78,381,640,59,360,282,1,459,341,LTAdatasets/8704/annotate/8704-2021_03_20_200116.jpg,420.0,311.5,0.65625,0.8652777777777778,0.121875,0.1638888888888889
8704-2021_03_20_200116.jpg,car,30,172,640,24,360,144,1,202,168,LTAdatasets/8704/annotate/8704-2021_03_20_200116.jpg,187.0,156.0,0.2921875,0.43333333333333335,0.046875,0.06666666666666667
8704-2021_03_20_200116.jpg,car,26,81,640,23,360,154,1,107,177,LTAdatasets/8704/annotate/8704-2021_03_20_200116.jpg,94.0,165.5,0.146875,0.4597222222222222,0.040625,0.06388888888888888
8704-2021_03_20_200116.jpg,car,21,72,640,16,360,97,1,93,113,LTAdatasets/8704/annotate/8704-2021_03_20_200116.jpg,82.5,105.0,0.12890625,0.2916666666666667,0.0328125,0.044444444444444446
8704-2021_03_20_200116.jpg,car,15,43,640,16,360,94,1,58,110,LTAdatasets/8704/annotate/8704-2021_03_20_200116.jpg,50.5,102.0,0.07890625,0.2833333333333333,0.0234375,0.044444444444444446
8704-2021_03_20_200116.jpg,car,24,4,640,29,360,167,1,28,196,LTAdatasets/8704/annotate/8704-2021_03_20_200116.jpg,16.0,181.5,0.025,0.5041666666666667,0.0375,0.08055555555555556
8704-2021_03_20_200116.jpg,car,15,50,640,17,360,75,1,65,92,LTAdatasets/8704/annotate/8704-2021_03_20_200116.jpg,57.5,83.5,0.08984375,0.23194444444444445,0.0234375,0.04722222222222222
8704-2021_03_20_200116.jpg,lorry_truck,38,104,640,41,360,92,2,142,133,LTAdatasets/8704/annotate/8704-2021_03_20_200116.jpg,123.0,112.5,0.1921875,0.3125,0.059375,0.11388888888888889
8704-2021_03_20_200116.jpg,lorry_truck,16,80,640,19,360,52,2,96,71,LTAdatasets/8704/annotate/8704-2021_03_20_200116.jpg,88.0,61.5,0.1375,0.17083333333333334,0.025,0.05277777777777778
8704-2021_03_20_200116.jpg,bus,16,101,640,23,360,52,5,117,75,LTAdatasets/8704/annotate/8704-2021_03_20_200116.jpg,109.0,63.5,0.1703125,0.1763888888888889,0.025,0.06388888888888888
1004-2021_03_20_181851.jpg,car,13,92,320,14,240,175,1,105,189,LTAdatasets/1004/annotate/1004-2021_03_20_181851.jpg,98.5,182.0,0.3078125,0.7583333333333333,0.040625,0.058333333333333334
1004-2021_03_20_181851.jpg,car,23,278,320,25,240,201,1,301,226,LTAdatasets/1004/annotate/1004-2021_03_20_181851.jpg,289.5,213.5,0.9046875,0.8895833333333333,0.071875,0.10416666666666667
1004-2021_03_20_181851.jpg,car,11,270,320,12,240,162,1,281,174,LTAdatasets/1004/annotate/1004-2021_03_20_181851.jpg,275.5,168.0,0.8609375,0.7,0.034375,0.05
1004-2021_03_20_181851.jpg,van,11,244,320,12,240,167,3,255,179,LTAdatasets/1004/annotate/1004-2021_03_20_181851.jpg,249.5,173.0,0.7796875,0.7208333333333333,0.034375,0.05
1004-2021_03_20_181851.jpg,van,18,243,320,30,240,199,3,261,229,LTAdatasets/1004/annotate/1004-2021_03_20_181851.jpg,252.0,214.0,0.7875,0.8916666666666667,0.05625,0.125
1004-2021_03_20_181851.jpg,van,32,4,320,25,240,200,3,36,225,LTAdatasets/1004/annotate/1004-2021_03_20_181851.jpg,20.0,212.5,0.0625,0.8854166666666666,0.1,0.10416666666666667
1004-2021_03_20_181851.jpg,van,7,114,320,9,240,130,3,121,139,LTAdatasets/1004/annotate/1004-2021_03_20_181851.jpg,117.5,134.5,0.3671875,0.5604166666666667,0.021875,0.0375
1004-2021_03_20_181851.jpg,car,7,99,320,9,240,132,1,106,141,LTAdatasets/1004/annotate/1004-2021_03_20_181851.jpg,102.5,136.5,0.3203125,0.56875,0.021875,0.0375
1004-2021_03_20_181851.jpg,car,7,111,320,6,240,139,1,118,145,LTAdatasets/1004/annotate/1004-2021_03_20_181851.jpg,114.5,142.0,0.3578125,0.5916666666666667,0.021875,0.025
1004-2021_03_20_181851.jpg,van,11,244,320,10,240,150,3,255,160,LTAdatasets/1004/annotate/1004-2021_03_20_181851.jpg,249.5,155.0,0.7796875,0.6458333333333334,0.034375,0.041666666666666664
1004-2021_03_20_181851.jpg,car,6,257,320,8,240,143,1,263,151,LTAdatasets/1004/annotate/1004-2021_03_20_181851.jpg,260.0,147.0,0.8125,0.6125,0.01875,0.03333333333333333
1004-2021_03_20_214902.jpg,car,16,269,320,20,240,183,1,285,203,LTAdatasets/1004/annotate/1004-2021_03_20_214902.jpg,277.0,193.0,0.865625,0.8041666666666667,0.05,0.08333333333333333
1004-2021_03_20_214902.jpg,van,18,239,320,24,240,164,3,257,188,LTAdatasets/1004/annotate/1004-2021_03_20_214902.jpg,248.0,176.0,0.775,0.7333333333333333,0.05625,0.1
1004-2021_03_20_214902.jpg,bike,9,95,320,14,240,171,4,104,185,LTAdatasets/1004/annotate/1004-2021_03_20_214902.jpg,99.5,178.0,0.3109375,0.7416666666666667,0.028125,0.058333333333333334
1004-2021_03_20_214902.jpg,car,14,73,320,17,240,164,1,87,181,LTAdatasets/1004/annotate/1004-2021_03_20_214902.jpg,80.0,172.5,0.25,0.71875,0.04375,0.07083333333333333
1004-2021_03_20_214902.jpg,car,9,112,320,8,240,131,1,121,139,LTAdatasets/1004/annotate/1004-2021_03_20_214902.jpg,116.5,135.0,0.3640625,0.5625,0.028125,0.03333333333333333
1004-2021_03_20_214902.jpg,car,8,99,320,7,240,126,1,107,133,LTAdatasets/1004/annotate/1004-2021_03_20_214902.jpg,103.0,129.5,0.321875,0.5395833333333333,0.025,0.029166666666666667
1004-2021_03_20_091903.jpg,van,18,276,320,26,240,184,3,294,210,LTAdatasets/1004/annotate/1004-2021_03_20_091903.jpg,285.0,197.0,0.890625,0.8208333333333333,0.05625,0.10833333333333334
1004-2021_03_20_091903.jpg,van,14,240,320,20,240,167,3,254,187,LTAdatasets/1004/annotate/1004-2021_03_20_091903.jpg,247.0,177.0,0.771875,0.7375,0.04375,0.08333333333333333
1004-2021_03_20_091903.jpg,car,30,280,320,24,240,216,1,310,240,LTAdatasets/1004/annotate/1004-2021_03_20_091903.jpg,295.0,228.0,0.921875,0.95,0.09375,0.1
1004-2021_03_20_091903.jpg,car,26,43,320,18,240,184,1,69,202,LTAdatasets/1004/annotate/1004-2021_03_20_091903.jpg,56.0,193.0,0.175,0.8041666666666667,0.08125,0.075
1004-2021_03_20_091903.jpg,car,11,92,320,11,240,145,1,103,156,LTAdatasets/1004/annotate/1004-2021_03_20_091903.jpg,97.5,150.5,0.3046875,0.6270833333333333,0.034375,0.04583333333333333
1004-2021_03_20_203358.jpg,car,15,239,320,20,240,183,1,254,203,LTAdatasets/1004/annotate/1004-2021_03_20_203358.jpg,246.5,193.0,0.7703125,0.8041666666666667,0.046875,0.08333333333333333
1004-2021_03_20_203358.jpg,car,10,240,320,12,240,142,1,250,154,LTAdatasets/1004/annotate/1004-2021_03_20_203358.jpg,245.0,148.0,0.765625,0.6166666666666667,0.03125,0.05
1004-2021_03_20_203358.jpg,car,27,54,320,27,240,202,1,81,229,LTAdatasets/1004/annotate/1004-2021_03_20_203358.jpg,67.5,215.5,0.2109375,0.8979166666666667,0.084375,0.1125
1004-2021_03_20_203358.jpg,car,7,112,320,8,240,139,1,119,147,LTAdatasets/1004/annotate/1004-2021_03_20_203358.jpg,115.5,143.0,0.3609375,0.5958333333333333,0.021875,0.03333333333333333
1004-2021_03_20_211900.jpg,car,24,78,320,21,240,184,1,102,205,LTAdatasets/1004/annotate/1004-2021_03_20_211900.jpg,90.0,194.5,0.28125,0.8104166666666667,0.075,0.0875
1004-2021_03_20_211900.jpg,van,22,59,320,20,240,166,3,81,186,LTAdatasets/1004/annotate/1004-2021_03_20_211900.jpg,70.0,176.0,0.21875,0.7333333333333333,0.06875,0.08333333333333333
1004-2021_03_20_211900.jpg,car,6,113,320,11,240,142,1,119,153,LTAdatasets/1004/annotate/1004-2021_03_20_211900.jpg,116.0,147.5,0.3625,0.6145833333333334,0.01875,0.04583333333333333
1004-2021_03_20_211900.jpg,car,16,238,320,12,240,165,1,254,177,LTAdatasets/1004/annotate/1004-2021_03_20_211900.jpg,246.0,171.0,0.76875,0.7125,0.05,0.05
1004-2021_03_20_211900.jpg,car,12,256,320,9,240,141,1,268,150,LTAdatasets/1004/annotate/1004-2021_03_20_211900.jpg,262.0,145.5,0.81875,0.60625,0.0375,0.0375
1004-2021_03_20_211900.jpg,car,9,110,320,5,240,132,1,119,137,LTAdatasets/1004/annotate/1004-2021_03_20_211900.jpg,114.5,134.5,0.3578125,0.5604166666666667,0.028125,0.020833333333333332
1004-2021_03_20_193415.jpg,van,16,242,320,23,240,172,3,258,195,LTAdatasets/1004/annotate/1004-2021_03_20_193415.jpg,250.0,183.5,0.78125,0.7645833333333333,0.05,0.09583333333333334
1004-2021_03_20_193415.jpg,car,16,275,320,18,240,189,1,291,207,LTAdatasets/1004/annotate/1004-2021_03_20_193415.jpg,283.0,198.0,0.884375,0.825,0.05,0.075
1004-2021_03_20_193415.jpg,car,14,241,320,8,240,146,1,255,154,LTAdatasets/1004/annotate/1004-2021_03_20_193415.jpg,248.0,150.0,0.775,0.625,0.04375,0.03333333333333333
1004-2021_03_20_193415.jpg,car,14,78,320,12,240,165,1,92,177,LTAdatasets/1004/annotate/1004-2021_03_20_193415.jpg,85.0,171.0,0.265625,0.7125,0.04375,0.05
1004-2021_03_20_193415.jpg,car,8,97,320,8,240,134,1,105,142,LTAdatasets/1004/annotate/1004-2021_03_20_193415.jpg,101.0,138.0,0.315625,0.575,0.025,0.03333333333333333
1004-2021_03_20_193415.jpg,car,10,112,320,9,240,127,1,122,136,LTAdatasets/1004/annotate/1004-2021_03_20_193415.jpg,117.0,131.5,0.365625,0.5479166666666667,0.03125,0.0375
1004-2021_03_20_093424.jpg,car,21,75,320,15,240,168,1,96,183,LTAdatasets/1004/annotate/1004-2021_03_20_093424.jpg,85.5,175.5,0.2671875,0.73125,0.065625,0.0625
1004-2021_03_20_093424.jpg,car,13,245,320,17,240,184,1,258,201,LTAdatasets/1004/annotate/1004-2021_03_20_093424.jpg,251.5,192.5,0.7859375,0.8020833333333334,0.040625,0.07083333333333333
1004-2021_03_20_093424.jpg,car,16,279,320,20,240,193,1,295,213,LTAdatasets/1004/annotate/1004-2021_03_20_093424.jpg,287.0,203.0,0.896875,0.8458333333333333,0.05,0.08333333333333333
1004-2021_03_20_093424.jpg,car,13,265,320,8,240,179,1,278,187,LTAdatasets/1004/annotate/1004-2021_03_20_093424.jpg,271.5,183.0,0.8484375,0.7625,0.040625,0.03333333333333333
1004-2021_03_20_093424.jpg,car,11,241,320,11,240,167,1,252,178,LTAdatasets/1004/annotate/1004-2021_03_20_093424.jpg,246.5,172.5,0.7703125,0.71875,0.034375,0.04583333333333333
1004-2021_03_20_093424.jpg,car,23,233,320,21,240,218,1,256,239,LTAdatasets/1004/annotate/1004-2021_03_20_093424.jpg,244.5,228.5,0.7640625,0.9520833333333333,0.071875,0.0875
1004-2021_03_20_093424.jpg,lorry_truck,8,245,320,14,240,146,2,253,160,LTAdatasets/1004/annotate/1004-2021_03_20_093424.jpg,249.0,153.0,0.778125,0.6375,0.025,0.058333333333333334
1004-2021_03_20_093424.jpg,van,8,99,320,8,240,133,3,107,141,LTAdatasets/1004/annotate/1004-2021_03_20_093424.jpg,103.0,137.0,0.321875,0.5708333333333333,0.025,0.03333333333333333
1004-2021_03_20_093424.jpg,car,9,111,320,7,240,135,1,120,142,LTAdatasets/1004/annotate/1004-2021_03_20_093424.jpg,115.5,138.5,0.3609375,0.5770833333333333,0.028125,0.029166666666666667
1004-2021_03_20_091302.jpg,car,15,73,320,15,240,166,1,88,181,LTAdatasets/1004/annotate/1004-2021_03_20_091302.jpg,80.5,173.5,0.2515625,0.7229166666666667,0.046875,0.0625
1004-2021_03_20_091302.jpg,car,29,4,320,20,240,214,1,33,234,LTAdatasets/1004/annotate/1004-2021_03_20_091302.jpg,18.5,224.0,0.0578125,0.9333333333333333,0.090625,0.08333333333333333
1004-2021_03_20_091302.jpg,van,11,103,320,11,240,160,3,114,171,LTAdatasets/1004/annotate/1004-2021_03_20_091302.jpg,108.5,165.5,0.3390625,0.6895833333333333,0.034375,0.04583333333333333
1004-2021_03_20_091302.jpg,lorry_truck,34,267,320,33,240,183,2,301,216,LTAdatasets/1004/annotate/1004-2021_03_20_091302.jpg,284.0,199.5,0.8875,0.83125,0.10625,0.1375
1004-2021_03_20_091302.jpg,car,25,231,320,32,240,206,1,256,238,LTAdatasets/1004/annotate/1004-2021_03_20_091302.jpg,243.5,222.0,0.7609375,0.925,0.078125,0.13333333333333333
1004-2021_03_20_091302.jpg,lorry_truck,12,84,320,13,240,147,2,96,160,LTAdatasets/1004/annotate/1004-2021_03_20_091302.jpg,90.0,153.5,0.28125,0.6395833333333333,0.0375,0.05416666666666667
1004-2021_03_20_205739.jpg,car,13,241,320,11,240,145,1,254,156,LTAdatasets/1004/annotate/1004-2021_03_20_205739.jpg,247.5,150.5,0.7734375,0.6270833333333333,0.040625,0.04583333333333333
1004-2021_03_20_205739.jpg,bike,11,77,320,23,240,189,4,88,212,LTAdatasets/1004/annotate/1004-2021_03_20_205739.jpg,82.5,200.5,0.2578125,0.8354166666666667,0.034375,0.09583333333333334
1004-2021_03_20_205739.jpg,lorry_truck,18,62,320,22,240,165,2,80,187,LTAdatasets/1004/annotate/1004-2021_03_20_205739.jpg,71.0,176.0,0.221875,0.7333333333333333,0.05625,0.09166666666666666
1004-2021_03_20_084301.jpg,car,27,63,320,19,240,193,1,90,212,LTAdatasets/1004/annotate/1004-2021_03_20_084301.jpg,76.5,202.5,0.2390625,0.84375,0.084375,0.07916666666666666
1004-2021_03_20_084301.jpg,car,10,85,320,9,240,153,1,95,162,LTAdatasets/1004/annotate/1004-2021_03_20_084301.jpg,90.0,157.5,0.28125,0.65625,0.03125,0.0375
1004-2021_03_20_084301.jpg,van,27,240,320,39,240,201,3,267,240,LTAdatasets/1004/annotate/1004-2021_03_20_084301.jpg,253.5,220.5,0.7921875,0.91875,0.084375,0.1625
1004-2021_03_20_084301.jpg,van,20,272,320,26,240,186,3,292,212,LTAdatasets/1004/annotate/1004-2021_03_20_084301.jpg,282.0,199.0,0.88125,0.8291666666666667,0.0625,0.10833333333333334
1004-2021_03_20_084301.jpg,van,14,241,320,21,240,175,3,255,196,LTAdatasets/1004/annotate/1004-2021_03_20_084301.jpg,248.0,185.5,0.775,0.7729166666666667,0.04375,0.0875
1004-2021_03_20_084301.jpg,car,8,259,320,7,240,142,1,267,149,LTAdatasets/1004/annotate/1004-2021_03_20_084301.jpg,263.0,145.5,0.821875,0.60625,0.025,0.029166666666666667
1004-2021_03_20_084301.jpg,car,8,242,320,8,240,141,1,250,149,LTAdatasets/1004/annotate/1004-2021_03_20_084301.jpg,246.0,145.0,0.76875,0.6041666666666666,0.025,0.03333333333333333
1004-2021_03_20_182752.jpg,lorry_truck,37,228,320,43,240,197,2,265,240,LTAdatasets/1004/annotate/1004-2021_03_20_182752.jpg,246.5,218.5,0.7703125,0.9104166666666667,0.115625,0.17916666666666667
1004-2021_03_20_182752.jpg,van,18,234,320,20,240,166,3,252,186,LTAdatasets/1004/annotate/1004-2021_03_20_182752.jpg,243.0,176.0,0.759375,0.7333333333333333,0.05625,0.08333333333333333
1004-2021_03_20_182752.jpg,car,13,268,320,13,240,166,1,281,179,LTAdatasets/1004/annotate/1004-2021_03_20_182752.jpg,274.5,172.5,0.8578125,0.71875,0.040625,0.05416666666666667
1004-2021_03_20_182752.jpg,car,11,112,320,8,240,139,1,123,147,LTAdatasets/1004/annotate/1004-2021_03_20_182752.jpg,117.5,143.0,0.3671875,0.5958333333333333,0.034375,0.03333333333333333
1004-2021_03_20_072817.jpg,bus,60,28,320,57,240,180,5,88,237,LTAdatasets/1004/annotate/1004-2021_03_20_072817.jpg,58.0,208.5,0.18125,0.86875,0.1875,0.2375
1004-2021_03_20_064855.jpg,lorry_truck,11,91,320,11,240,143,2,102,154,LTAdatasets/1004/annotate/1004-2021_03_20_064855.jpg,96.5,148.5,0.3015625,0.61875,0.034375,0.04583333333333333
1004-2021_03_20_083640.jpg,car,14,75,320,12,240,160,1,89,172,LTAdatasets/1004/annotate/1004-2021_03_20_083640.jpg,82.0,166.0,0.25625,0.6916666666666667,0.04375,0.05
1004-2021_03_20_083640.jpg,car,33,6,320,21,240,207,1,39,228,LTAdatasets/1004/annotate/1004-2021_03_20_083640.jpg,22.5,217.5,0.0703125,0.90625,0.103125,0.0875
1004-2021_03_20_083640.jpg,car,5,114,320,6,240,141,1,119,147,LTAdatasets/1004/annotate/1004-2021_03_20_083640.jpg,116.5,144.0,0.3640625,0.6,0.015625,0.025
1004-2021_03_20_083640.jpg,car,8,95,320,8,240,140,1,103,148,LTAdatasets/1004/annotate/1004-2021_03_20_083640.jpg,99.0,144.0,0.309375,0.6,0.025,0.03333333333333333
1004-2021_03_20_083640.jpg,car,8,111,320,8,240,130,1,119,138,LTAdatasets/1004/annotate/1004-2021_03_20_083640.jpg,115.0,134.0,0.359375,0.5583333333333333,0.025,0.03333333333333333
1004-2021_03_20_075818.jpg,car,22,240,320,27,240,200,1,262,227,LTAdatasets/1004/annotate/1004-2021_03_20_075818.jpg,251.0,213.5,0.784375,0.8895833333333333,0.06875,0.1125
1004-2021_03_20_094904.jpg,car,26,232,320,23,240,191,1,258,214,LTAdatasets/1004/annotate/1004-2021_03_20_094904.jpg,245.0,202.5,0.765625,0.84375,0.08125,0.09583333333333334
1004-2021_03_20_094904.jpg,van,17,268,320,20,240,178,3,285,198,LTAdatasets/1004/annotate/1004-2021_03_20_094904.jpg,276.5,188.0,0.8640625,0.7833333333333333,0.053125,0.08333333333333333
1004-2021_03_20_094904.jpg,lorry_truck,17,239,320,18,240,166,2,256,184,LTAdatasets/1004/annotate/1004-2021_03_20_094904.jpg,247.5,175.0,0.7734375,0.7291666666666666,0.053125,0.075
1004-2021_03_20_082740.jpg,lorry_truck,29,40,320,22,240,183,2,69,205,LTAdatasets/1004/annotate/1004-2021_03_20_082740.jpg,54.5,194.0,0.1703125,0.8083333333333333,0.090625,0.09166666666666666
1004-2021_03_20_082740.jpg,car,16,269,320,18,240,179,1,285,197,LTAdatasets/1004/annotate/1004-2021_03_20_082740.jpg,277.0,188.0,0.865625,0.7833333333333333,0.05,0.075
1004-2021_03_20_211300.jpg,car,27,59,320,23,240,203,1,86,226,LTAdatasets/1004/annotate/1004-2021_03_20_211300.jpg,72.5,214.5,0.2265625,0.89375,0.084375,0.09583333333333334
1004-2021_03_20_211300.jpg,van,34,19,320,25,240,192,3,53,217,LTAdatasets/1004/annotate/1004-2021_03_20_211300.jpg,36.0,204.5,0.1125,0.8520833333333333,0.10625,0.10416666666666667
1004-2021_03_20_211300.jpg,car,12,96,320,13,240,169,1,108,182,LTAdatasets/1004/annotate/1004-2021_03_20_211300.jpg,102.0,175.5,0.31875,0.73125,0.0375,0.05416666666666667
1004-2021_03_20_211300.jpg,bike,10,84,320,13,240,155,4,94,168,LTAdatasets/1004/annotate/1004-2021_03_20_211300.jpg,89.0,161.5,0.278125,0.6729166666666667,0.03125,0.05416666666666667
1004-2021_03_20_211300.jpg,car,8,96,320,9,240,141,1,104,150,LTAdatasets/1004/annotate/1004-2021_03_20_211300.jpg,100.0,145.5,0.3125,0.60625,0.025,0.0375
1004-2021_03_20_211300.jpg,car,10,112,320,10,240,134,1,122,144,LTAdatasets/1004/annotate/1004-2021_03_20_211300.jpg,117.0,139.0,0.365625,0.5791666666666667,0.03125,0.041666666666666664
1004-2021_03_20_180710.jpg,car,15,272,320,22,240,185,1,287,207,LTAdatasets/1004/annotate/1004-2021_03_20_180710.jpg,279.5,196.0,0.8734375,0.8166666666666667,0.046875,0.09166666666666666
1004-2021_03_20_180710.jpg,car,20,238,320,23,240,190,1,258,213,LTAdatasets/1004/annotate/1004-2021_03_20_180710.jpg,248.0,201.5,0.775,0.8395833333333333,0.0625,0.09583333333333334
1004-2021_03_20_180710.jpg,car,16,239,320,12,240,171,1,255,183,LTAdatasets/1004/annotate/1004-2021_03_20_180710.jpg,247.0,177.0,0.771875,0.7375,0.05,0.05
1004-2021_03_20_180710.jpg,car,14,81,320,13,240,156,1,95,169,LTAdatasets/1004/annotate/1004-2021_03_20_180710.jpg,88.0,162.5,0.275,0.6770833333333334,0.04375,0.05416666666666667
1004-2021_03_20_180710.jpg,car,7,115,320,10,240,143,1,122,153,LTAdatasets/1004/annotate/1004-2021_03_20_180710.jpg,118.5,148.0,0.3703125,0.6166666666666667,0.021875,0.041666666666666664
1004-2021_03_20_180710.jpg,lorry_truck,9,98,320,9,240,131,2,107,140,LTAdatasets/1004/annotate/1004-2021_03_20_180710.jpg,102.5,135.5,0.3203125,0.5645833333333333,0.028125,0.0375
1004-2021_03_20_080719.jpg,car,15,240,320,18,240,172,1,255,190,LTAdatasets/1004/annotate/1004-2021_03_20_080719.jpg,247.5,181.0,0.7734375,0.7541666666666667,0.046875,0.075
1004-2021_03_20_080719.jpg,car,17,271,320,20,240,184,1,288,204,LTAdatasets/1004/annotate/1004-2021_03_20_080719.jpg,279.5,194.0,0.8734375,0.8083333333333333,0.053125,0.08333333333333333
1004-2021_03_20_181251.jpg,car,23,270,320,20,240,190,1,293,210,LTAdatasets/1004/annotate/1004-2021_03_20_181251.jpg,281.5,200.0,0.8796875,0.8333333333333334,0.071875,0.08333333333333333
1004-2021_03_20_181251.jpg,van,18,240,320,32,240,196,3,258,228,LTAdatasets/1004/annotate/1004-2021_03_20_181251.jpg,249.0,212.0,0.778125,0.8833333333333333,0.05625,0.13333333333333333
1004-2021_03_20_181251.jpg,car,14,242,320,15,240,171,1,256,186,LTAdatasets/1004/annotate/1004-2021_03_20_181251.jpg,249.0,178.5,0.778125,0.74375,0.04375,0.0625
1004-2021_03_20_181251.jpg,car,13,272,320,15,240,164,1,285,179,LTAdatasets/1004/annotate/1004-2021_03_20_181251.jpg,278.5,171.5,0.8703125,0.7145833333333333,0.040625,0.0625
1004-2021_03_20_181251.jpg,car,11,242,320,9,240,149,1,253,158,LTAdatasets/1004/annotate/1004-2021_03_20_181251.jpg,247.5,153.5,0.7734375,0.6395833333333333,0.034375,0.0375
1004-2021_03_20_181251.jpg,van,13,84,320,15,240,151,3,97,166,LTAdatasets/1004/annotate/1004-2021_03_20_181251.jpg,90.5,158.5,0.2828125,0.6604166666666667,0.040625,0.0625
1004-2021_03_20_181251.jpg,car,7,106,320,6,240,134,1,113,140,LTAdatasets/1004/annotate/1004-2021_03_20_181251.jpg,109.5,137.0,0.3421875,0.5708333333333333,0.021875,0.025
1004-2021_03_20_194315.jpg,car,30,50,320,21,240,213,1,80,234,LTAdatasets/1004/annotate/1004-2021_03_20_194315.jpg,65.0,223.5,0.203125,0.93125,0.09375,0.0875
1004-2021_03_20_194315.jpg,van,31,3,320,29,240,208,3,34,237,LTAdatasets/1004/annotate/1004-2021_03_20_194315.jpg,18.5,222.5,0.0578125,0.9270833333333334,0.096875,0.12083333333333333
1004-2021_03_20_194315.jpg,car,18,241,320,20,240,175,1,259,195,LTAdatasets/1004/annotate/1004-2021_03_20_194315.jpg,250.0,185.0,0.78125,0.7708333333333334,0.05625,0.08333333333333333
1004-2021_03_20_194315.jpg,car,15,270,320,13,240,175,1,285,188,LTAdatasets/1004/annotate/1004-2021_03_20_194315.jpg,277.5,181.5,0.8671875,0.75625,0.046875,0.05416666666666667
1004-2021_03_20_194315.jpg,bike,9,266,320,10,240,154,4,275,164,LTAdatasets/1004/annotate/1004-2021_03_20_194315.jpg,270.5,159.0,0.8453125,0.6625,0.028125,0.041666666666666664
1004-2021_03_20_194315.jpg,bike,9,258,320,17,240,223,4,267,240,LTAdatasets/1004/annotate/1004-2021_03_20_194315.jpg,262.5,231.5,0.8203125,0.9645833333333333,0.028125,0.07083333333333333
1004-2021_03_20_194315.jpg,car,15,95,320,13,240,173,1,110,186,LTAdatasets/1004/annotate/1004-2021_03_20_194315.jpg,102.5,179.5,0.3203125,0.7479166666666667,0.046875,0.05416666666666667
1004-2021_03_20_194315.jpg,car,10,112,320,6,240,137,1,122,143,LTAdatasets/1004/annotate/1004-2021_03_20_194315.jpg,117.0,140.0,0.365625,0.5833333333333334,0.03125,0.025
1004-2021_03_20_194315.jpg,car,8,97,320,7,240,139,1,105,146,LTAdatasets/1004/annotate/1004-2021_03_20_194315.jpg,101.0,142.5,0.315625,0.59375,0.025,0.029166666666666667
1004-2021_03_20_081920.jpg,car,20,238,320,17,240,177,1,258,194,LTAdatasets/1004/annotate/1004-2021_03_20_081920.jpg,248.0,185.5,0.775,0.7729166666666667,0.0625,0.07083333333333333
1004-2021_03_20_081920.jpg,car,12,74,320,14,240,163,1,86,177,LTAdatasets/1004/annotate/1004-2021_03_20_081920.jpg,80.0,170.0,0.25,0.7083333333333334,0.0375,0.058333333333333334
1004-2021_03_20_081920.jpg,car,30,6,320,23,240,213,1,36,236,LTAdatasets/1004/annotate/1004-2021_03_20_081920.jpg,21.0,224.5,0.065625,0.9354166666666667,0.09375,0.09583333333333334
1004-2021_03_20_081920.jpg,van,10,93,320,9,240,141,3,103,150,LTAdatasets/1004/annotate/1004-2021_03_20_081920.jpg,98.0,145.5,0.30625,0.60625,0.03125,0.0375
1004-2021_03_20_081920.jpg,car,10,112,320,8,240,134,1,122,142,LTAdatasets/1004/annotate/1004-2021_03_20_081920.jpg,117.0,138.0,0.365625,0.575,0.03125,0.03333333333333333
1004-2021_03_20_065755.jpg,car,13,94,320,10,240,171,1,107,181,LTAdatasets/1004/annotate/1004-2021_03_20_065755.jpg,100.5,176.0,0.3140625,0.7333333333333333,0.040625,0.041666666666666664
1004-2021_03_20_065755.jpg,car,11,95,320,10,240,137,1,106,147,LTAdatasets/1004/annotate/1004-2021_03_20_065755.jpg,100.5,142.0,0.3140625,0.5916666666666667,0.034375,0.041666666666666664
1004-2021_03_20_065755.jpg,car,13,256,320,7,240,145,1,269,152,LTAdatasets/1004/annotate/1004-2021_03_20_065755.jpg,262.5,148.5,0.8203125,0.61875,0.040625,0.029166666666666667
1004-2021_03_20_201317.jpg,car,34,29,320,23,240,193,1,63,216,LTAdatasets/1004/annotate/1004-2021_03_20_201317.jpg,46.0,204.5,0.14375,0.8520833333333333,0.10625,0.09583333333333334
1004-2021_03_20_201317.jpg,car,16,93,320,15,240,169,1,109,184,LTAdatasets/1004/annotate/1004-2021_03_20_201317.jpg,101.0,176.5,0.315625,0.7354166666666667,0.05,0.0625
1004-2021_03_20_201317.jpg,car,24,236,320,22,240,195,1,260,217,LTAdatasets/1004/annotate/1004-2021_03_20_201317.jpg,248.0,206.0,0.775,0.8583333333333333,0.075,0.09166666666666666
1004-2021_03_20_201317.jpg,car,20,271,320,18,240,191,1,291,209,LTAdatasets/1004/annotate/1004-2021_03_20_201317.jpg,281.0,200.0,0.878125,0.8333333333333334,0.0625,0.075
1004-2021_03_20_201317.jpg,car,9,242,320,11,240,142,1,251,153,LTAdatasets/1004/annotate/1004-2021_03_20_201317.jpg,246.5,147.5,0.7703125,0.6145833333333334,0.028125,0.04583333333333333
1004-2021_03_20_201317.jpg,lorry_truck,13,267,320,19,240,145,2,280,164,LTAdatasets/1004/annotate/1004-2021_03_20_201317.jpg,273.5,154.5,0.8546875,0.64375,0.040625,0.07916666666666666
1004-2021_03_20_071836.jpg,lorry_truck,64,34,320,62,240,175,2,98,237,LTAdatasets/1004/annotate/1004-2021_03_20_071836.jpg,66.0,206.0,0.20625,0.8583333333333333,0.2,0.25833333333333336
1004-2021_03_20_071836.jpg,car,19,243,320,22,240,176,1,262,198,LTAdatasets/1004/annotate/1004-2021_03_20_071836.jpg,252.5,187.0,0.7890625,0.7791666666666667,0.059375,0.09166666666666666
1004-2021_03_20_071836.jpg,car,11,243,320,8,240,144,1,254,152,LTAdatasets/1004/annotate/1004-2021_03_20_071836.jpg,248.5,148.0,0.7765625,0.6166666666666667,0.034375,0.03333333333333333
1004-2021_03_20_213341.jpg,car,28,229,320,31,240,209,1,257,240,LTAdatasets/1004/annotate/1004-2021_03_20_213341.jpg,243.0,224.5,0.759375,0.9354166666666667,0.0875,0.12916666666666668
1004-2021_03_20_213341.jpg,car,29,41,320,26,240,214,1,70,240,LTAdatasets/1004/annotate/1004-2021_03_20_213341.jpg,55.5,227.0,0.1734375,0.9458333333333333,0.090625,0.10833333333333334
1004-2021_03_20_213341.jpg,car,15,66,320,16,240,170,1,81,186,LTAdatasets/1004/annotate/1004-2021_03_20_213341.jpg,73.5,178.0,0.2296875,0.7416666666666667,0.046875,0.06666666666666667
1004-2021_03_20_213341.jpg,car,10,111,320,6,240,129,1,121,135,LTAdatasets/1004/annotate/1004-2021_03_20_213341.jpg,116.0,132.0,0.3625,0.55,0.03125,0.025
1004-2021_03_20_213341.jpg,car,8,99,320,6,240,129,1,107,135,LTAdatasets/1004/annotate/1004-2021_03_20_213341.jpg,103.0,132.0,0.321875,0.55,0.025,0.025
1004-2021_03_20_213341.jpg,bike,9,77,320,16,240,187,4,86,203,LTAdatasets/1004/annotate/1004-2021_03_20_213341.jpg,81.5,195.0,0.2546875,0.8125,0.028125,0.06666666666666667
1004-2021_03_20_085141.jpg,lorry_truck,18,273,320,36,240,163,2,291,199,LTAdatasets/1004/annotate/1004-2021_03_20_085141.jpg,282.0,181.0,0.88125,0.7541666666666667,0.05625,0.15
1004-2021_03_20_085141.jpg,car,8,97,320,9,240,135,1,105,144,LTAdatasets/1004/annotate/1004-2021_03_20_085141.jpg,101.0,139.5,0.315625,0.58125,0.025,0.0375
1004-2021_03_20_063654.jpg,lorry_truck,20,69,320,20,240,165,2,89,185,LTAdatasets/1004/annotate/1004-2021_03_20_063654.jpg,79.0,175.0,0.246875,0.7291666666666666,0.0625,0.08333333333333333
1004-2021_03_20_063654.jpg,car,14,272,320,14,240,174,1,286,188,LTAdatasets/1004/annotate/1004-2021_03_20_063654.jpg,279.0,181.0,0.871875,0.7541666666666667,0.04375,0.058333333333333334
1004-2021_03_20_200637.jpg,car,24,237,320,24,240,216,1,261,240,LTAdatasets/1004/annotate/1004-2021_03_20_200637.jpg,249.0,228.0,0.778125,0.95,0.075,0.1
1004-2021_03_20_200637.jpg,bus,24,85,320,37,240,157,5,109,194,LTAdatasets/1004/annotate/1004-2021_03_20_200637.jpg,97.0,175.5,0.303125,0.73125,0.075,0.15416666666666667
1004-2021_03_20_200637.jpg,car,8,111,320,9,240,130,1,119,139,LTAdatasets/1004/annotate/1004-2021_03_20_200637.jpg,115.0,134.5,0.359375,0.5604166666666667,0.025,0.0375
1004-2021_03_20_195136.jpg,van,25,275,320,36,240,197,3,300,233,LTAdatasets/1004/annotate/1004-2021_03_20_195136.jpg,287.5,215.0,0.8984375,0.8958333333333334,0.078125,0.15
1004-2021_03_20_195136.jpg,van,19,240,320,26,240,175,3,259,201,LTAdatasets/1004/annotate/1004-2021_03_20_195136.jpg,249.5,188.0,0.7796875,0.7833333333333333,0.059375,0.10833333333333334
1004-2021_03_20_195136.jpg,car,11,81,320,14,240,158,1,92,172,LTAdatasets/1004/annotate/1004-2021_03_20_195136.jpg,86.5,165.0,0.2703125,0.6875,0.034375,0.058333333333333334
1004-2021_03_20_195136.jpg,car,23,28,320,21,240,197,1,51,218,LTAdatasets/1004/annotate/1004-2021_03_20_195136.jpg,39.5,207.5,0.1234375,0.8645833333333334,0.071875,0.0875
1004-2021_03_20_195136.jpg,car,8,92,320,8,240,145,1,100,153,LTAdatasets/1004/annotate/1004-2021_03_20_195136.jpg,96.0,149.0,0.3,0.6208333333333333,0.025,0.03333333333333333
1004-2021_03_20_202217.jpg,car,21,237,320,26,240,183,1,258,209,LTAdatasets/1004/annotate/1004-2021_03_20_202217.jpg,247.5,196.0,0.7734375,0.8166666666666667,0.065625,0.10833333333333334
1004-2021_03_20_204238.jpg,car,22,65,320,15,240,173,1,87,188,LTAdatasets/1004/annotate/1004-2021_03_20_204238.jpg,76.0,180.5,0.2375,0.7520833333333333,0.06875,0.0625
1004-2021_03_20_204238.jpg,car,35,18,320,21,240,201,1,53,222,LTAdatasets/1004/annotate/1004-2021_03_20_204238.jpg,35.5,211.5,0.1109375,0.88125,0.109375,0.0875
1004-2021_03_20_204238.jpg,car,17,98,320,12,240,161,1,115,173,LTAdatasets/1004/annotate/1004-2021_03_20_204238.jpg,106.5,167.0,0.3328125,0.6958333333333333,0.053125,0.05
1004-2021_03_20_210420.jpg,car,18,87,320,17,240,178,1,105,195,LTAdatasets/1004/annotate/1004-2021_03_20_210420.jpg,96.0,186.5,0.3,0.7770833333333333,0.05625,0.07083333333333333
1004-2021_03_20_210420.jpg,car,29,20,320,21,240,197,1,49,218,LTAdatasets/1004/annotate/1004-2021_03_20_210420.jpg,34.5,207.5,0.1078125,0.8645833333333334,0.090625,0.0875
1004-2021_03_20_210420.jpg,car,34,41,320,18,240,222,1,75,240,LTAdatasets/1004/annotate/1004-2021_03_20_210420.jpg,58.0,231.0,0.18125,0.9625,0.10625,0.075
1004-2021_03_20_210420.jpg,car,8,95,320,10,240,137,1,103,147,LTAdatasets/1004/annotate/1004-2021_03_20_210420.jpg,99.0,142.0,0.309375,0.5916666666666667,0.025,0.041666666666666664
1004-2021_03_20_210420.jpg,car,10,111,320,8,240,135,1,121,143,LTAdatasets/1004/annotate/1004-2021_03_20_210420.jpg,116.0,139.0,0.3625,0.5791666666666667,0.03125,0.03333333333333333
1004-2021_03_20_070416.jpg,car,5,103,320,5,240,126,1,108,131,LTAdatasets/1004/annotate/1004-2021_03_20_070416.jpg,105.5,128.5,0.3296875,0.5354166666666667,0.015625,0.020833333333333332
1004-2021_03_20_084901.jpg,car,18,70,320,13,240,170,1,88,183,LTAdatasets/1004/annotate/1004-2021_03_20_084901.jpg,79.0,176.5,0.246875,0.7354166666666667,0.05625,0.05416666666666667
1004-2021_03_20_084901.jpg,car,26,26,320,20,240,198,1,52,218,LTAdatasets/1004/annotate/1004-2021_03_20_084901.jpg,39.0,208.0,0.121875,0.8666666666666667,0.08125,0.08333333333333333
1004-2021_03_20_084901.jpg,lorry_truck,15,88,320,18,240,135,2,103,153,LTAdatasets/1004/annotate/1004-2021_03_20_084901.jpg,95.5,144.0,0.2984375,0.6,0.046875,0.075
1004-2021_03_20_210720.jpg,car,27,233,320,22,240,217,1,260,239,LTAdatasets/1004/annotate/1004-2021_03_20_210720.jpg,246.5,228.0,0.7703125,0.95,0.084375,0.09166666666666666
1004-2021_03_20_210720.jpg,car,13,96,320,19,240,166,1,109,185,LTAdatasets/1004/annotate/1004-2021_03_20_210720.jpg,102.5,175.5,0.3203125,0.73125,0.040625,0.07916666666666666
1004-2021_03_20_210720.jpg,car,14,75,320,15,240,161,1,89,176,LTAdatasets/1004/annotate/1004-2021_03_20_210720.jpg,82.0,168.5,0.25625,0.7020833333333333,0.04375,0.0625
1004-2021_03_20_204919.jpg,lorry_truck,21,239,320,20,240,177,2,260,197,LTAdatasets/1004/annotate/1004-2021_03_20_204919.jpg,249.5,187.0,0.7796875,0.7791666666666667,0.065625,0.08333333333333333
1004-2021_03_20_204919.jpg,lorry_truck,8,242,320,18,240,147,2,250,165,LTAdatasets/1004/annotate/1004-2021_03_20_204919.jpg,246.0,156.0,0.76875,0.65,0.025,0.075
1004-2021_03_20_204919.jpg,bike,13,260,320,25,240,215,4,273,240,LTAdatasets/1004/annotate/1004-2021_03_20_204919.jpg,266.5,227.5,0.8328125,0.9479166666666666,0.040625,0.10416666666666667
1004-2021_03_20_204919.jpg,car,8,86,320,11,240,152,1,94,163,LTAdatasets/1004/annotate/1004-2021_03_20_204919.jpg,90.0,157.5,0.28125,0.65625,0.025,0.04583333333333333
1004-2021_03_20_204919.jpg,car,14,105,320,9,240,161,1,119,170,LTAdatasets/1004/annotate/1004-2021_03_20_204919.jpg,112.0,165.5,0.35,0.6895833333333333,0.04375,0.0375
1004-2021_03_20_185753.jpg,lorry_truck,24,236,320,46,240,186,2,260,232,LTAdatasets/1004/annotate/1004-2021_03_20_185753.jpg,248.0,209.0,0.775,0.8708333333333333,0.075,0.19166666666666668
1004-2021_03_20_185753.jpg,van,15,275,320,30,240,186,3,290,216,LTAdatasets/1004/annotate/1004-2021_03_20_185753.jpg,282.5,201.0,0.8828125,0.8375,0.046875,0.125
1004-2021_03_20_185753.jpg,car,20,78,320,22,240,188,1,98,210,LTAdatasets/1004/annotate/1004-2021_03_20_185753.jpg,88.0,199.0,0.275,0.8291666666666667,0.0625,0.09166666666666666
1004-2021_03_20_184913.jpg,car,18,236,320,20,240,185,1,254,205,LTAdatasets/1004/annotate/1004-2021_03_20_184913.jpg,245.0,195.0,0.765625,0.8125,0.05625,0.08333333333333333
1004-2021_03_20_184913.jpg,car,20,272,320,20,240,187,1,292,207,LTAdatasets/1004/annotate/1004-2021_03_20_184913.jpg,282.0,197.0,0.88125,0.8208333333333333,0.0625,0.08333333333333333
1004-2021_03_20_184913.jpg,car,13,248,320,22,240,168,1,261,190,LTAdatasets/1004/annotate/1004-2021_03_20_184913.jpg,254.5,179.0,0.7953125,0.7458333333333333,0.040625,0.09166666666666666
1004-2021_03_20_184913.jpg,car,13,92,320,15,240,168,1,105,183,LTAdatasets/1004/annotate/1004-2021_03_20_184913.jpg,98.5,175.5,0.3078125,0.73125,0.040625,0.0625
1004-2021_03_20_184913.jpg,car,24,35,320,17,240,195,1,59,212,LTAdatasets/1004/annotate/1004-2021_03_20_184913.jpg,47.0,203.5,0.146875,0.8479166666666667,0.075,0.07083333333333333
1004-2021_03_20_184913.jpg,bike,12,305,320,18,240,222,4,317,240,LTAdatasets/1004/annotate/1004-2021_03_20_184913.jpg,311.0,231.0,0.971875,0.9625,0.0375,0.075
1004-2021_03_20_090702.jpg,car,22,271,320,22,240,199,1,293,221,LTAdatasets/1004/annotate/1004-2021_03_20_090702.jpg,282.0,210.0,0.88125,0.875,0.06875,0.09166666666666666
1004-2021_03_20_090702.jpg,car,22,236,320,21,240,219,1,258,240,LTAdatasets/1004/annotate/1004-2021_03_20_090702.jpg,247.0,229.5,0.771875,0.95625,0.06875,0.0875
1004-2021_03_20_090702.jpg,car,12,241,320,11,240,149,1,253,160,LTAdatasets/1004/annotate/1004-2021_03_20_090702.jpg,247.0,154.5,0.771875,0.64375,0.0375,0.04583333333333333
1004-2021_03_20_090702.jpg,van,14,242,320,18,240,169,3,256,187,LTAdatasets/1004/annotate/1004-2021_03_20_090702.jpg,249.0,178.0,0.778125,0.7416666666666667,0.04375,0.075
1004-2021_03_20_100705.jpg,car,28,33,320,18,240,188,1,61,206,LTAdatasets/1004/annotate/1004-2021_03_20_100705.jpg,47.0,197.0,0.146875,0.8208333333333333,0.0875,0.075
1004-2021_03_20_100705.jpg,car,26,46,320,14,240,226,1,72,240,LTAdatasets/1004/annotate/1004-2021_03_20_100705.jpg,59.0,233.0,0.184375,0.9708333333333333,0.08125,0.058333333333333334
1004-2021_03_20_205139.jpg,lorry_truck,26,36,320,26,240,185,2,62,211,LTAdatasets/1004/annotate/1004-2021_03_20_205139.jpg,49.0,198.0,0.153125,0.825,0.08125,0.10833333333333334
1004-2021_03_20_205139.jpg,car,11,85,320,11,240,153,1,96,164,LTAdatasets/1004/annotate/1004-2021_03_20_205139.jpg,90.5,158.5,0.2828125,0.6604166666666667,0.034375,0.04583333333333333
1004-2021_03_20_205139.jpg,car,10,112,320,9,240,133,1,122,142,LTAdatasets/1004/annotate/1004-2021_03_20_205139.jpg,117.0,137.5,0.365625,0.5729166666666666,0.03125,0.0375
1004-2021_03_20_215222.jpg,car,23,78,320,16,240,189,1,101,205,LTAdatasets/1004/annotate/1004-2021_03_20_215222.jpg,89.5,197.0,0.2796875,0.8208333333333333,0.071875,0.06666666666666667
1004-2021_03_20_215222.jpg,car,21,51,320,17,240,178,1,72,195,LTAdatasets/1004/annotate/1004-2021_03_20_215222.jpg,61.5,186.5,0.1921875,0.7770833333333333,0.065625,0.07083333333333333
1004-2021_03_20_215222.jpg,car,11,85,320,12,240,151,1,96,163,LTAdatasets/1004/annotate/1004-2021_03_20_215222.jpg,90.5,157.0,0.2828125,0.6541666666666667,0.034375,0.05
1004-2021_03_20_184613.jpg,car,17,236,320,24,240,182,1,253,206,LTAdatasets/1004/annotate/1004-2021_03_20_184613.jpg,244.5,194.0,0.7640625,0.8083333333333333,0.053125,0.1
1004-2021_03_20_183412.jpg,car,19,80,320,17,240,191,1,99,208,LTAdatasets/1004/annotate/1004-2021_03_20_183412.jpg,89.5,199.5,0.2796875,0.83125,0.059375,0.07083333333333333
1004-2021_03_20_183412.jpg,car,21,47,320,17,240,186,1,68,203,LTAdatasets/1004/annotate/1004-2021_03_20_183412.jpg,57.5,194.5,0.1796875,0.8104166666666667,0.065625,0.07083333333333333
1004-2021_03_20_183412.jpg,car,18,238,320,26,240,214,1,256,240,LTAdatasets/1004/annotate/1004-2021_03_20_183412.jpg,247.0,227.0,0.771875,0.9458333333333333,0.05625,0.10833333333333334
1004-2021_03_20_183412.jpg,car,14,244,320,16,240,180,1,258,196,LTAdatasets/1004/annotate/1004-2021_03_20_183412.jpg,251.0,188.0,0.784375,0.7833333333333333,0.04375,0.06666666666666667
1004-2021_03_20_183412.jpg,car,12,272,320,15,240,166,1,284,181,LTAdatasets/1004/annotate/1004-2021_03_20_183412.jpg,278.0,173.5,0.86875,0.7229166666666667,0.0375,0.0625
1004-2021_03_20_183412.jpg,car,5,113,320,8,240,131,1,118,139,LTAdatasets/1004/annotate/1004-2021_03_20_183412.jpg,115.5,135.0,0.3609375,0.5625,0.015625,0.03333333333333333
1004-2021_03_20_183412.jpg,car,8,99,320,6,240,131,1,107,137,LTAdatasets/1004/annotate/1004-2021_03_20_183412.jpg,103.0,134.0,0.321875,0.5583333333333333,0.025,0.025
1004-2021_03_20_183412.jpg,car,12,242,320,10,240,153,1,254,163,LTAdatasets/1004/annotate/1004-2021_03_20_183412.jpg,248.0,158.0,0.775,0.6583333333333333,0.0375,0.041666666666666664
1004-2021_03_20_214302.jpg,car,15,73,320,14,240,167,1,88,181,LTAdatasets/1004/annotate/1004-2021_03_20_214302.jpg,80.5,174.0,0.2515625,0.725,0.046875,0.058333333333333334
1004-2021_03_20_214302.jpg,car,16,244,320,15,240,174,1,260,189,LTAdatasets/1004/annotate/1004-2021_03_20_214302.jpg,252.0,181.5,0.7875,0.75625,0.05,0.0625
1004-2021_03_20_214302.jpg,car,8,243,320,11,240,150,1,251,161,LTAdatasets/1004/annotate/1004-2021_03_20_214302.jpg,247.0,155.5,0.771875,0.6479166666666667,0.025,0.04583333333333333
1004-2021_03_20_214302.jpg,car,7,98,320,7,240,135,1,105,142,LTAdatasets/1004/annotate/1004-2021_03_20_214302.jpg,101.5,138.5,0.3171875,0.5770833333333333,0.021875,0.029166666666666667
1004-2021_03_20_214302.jpg,car,8,113,320,5,240,132,1,121,137,LTAdatasets/1004/annotate/1004-2021_03_20_214302.jpg,117.0,134.5,0.365625,0.5604166666666667,0.025,0.020833333333333332
1004-2021_03_20_192735.jpg,car,22,44,320,19,240,187,1,66,206,LTAdatasets/1004/annotate/1004-2021_03_20_192735.jpg,55.0,196.5,0.171875,0.81875,0.06875,0.07916666666666666
1004-2021_03_20_192735.jpg,bike,13,264,320,21,240,215,4,277,236,LTAdatasets/1004/annotate/1004-2021_03_20_192735.jpg,270.5,225.5,0.8453125,0.9395833333333333,0.040625,0.0875
1004-2021_03_20_192735.jpg,car,17,260,320,16,240,179,1,277,195,LTAdatasets/1004/annotate/1004-2021_03_20_192735.jpg,268.5,187.0,0.8390625,0.7791666666666667,0.053125,0.06666666666666667
1004-2021_03_20_192735.jpg,car,11,99,320,13,240,172,1,110,185,LTAdatasets/1004/annotate/1004-2021_03_20_192735.jpg,104.5,178.5,0.3265625,0.74375,0.034375,0.05416666666666667
1004-2021_03_20_192735.jpg,car,12,82,320,12,240,156,1,94,168,LTAdatasets/1004/annotate/1004-2021_03_20_192735.jpg,88.0,162.0,0.275,0.675,0.0375,0.05
1004-2021_03_20_192735.jpg,bike,6,97,320,9,240,137,4,103,146,LTAdatasets/1004/annotate/1004-2021_03_20_192735.jpg,100.0,141.5,0.3125,0.5895833333333333,0.01875,0.0375
1004-2021_03_20_213701.jpg,van,22,53,320,17,240,178,3,75,195,LTAdatasets/1004/annotate/1004-2021_03_20_213701.jpg,64.0,186.5,0.2,0.7770833333333333,0.06875,0.07083333333333333
1004-2021_03_20_213701.jpg,car,11,85,320,10,240,155,1,96,165,LTAdatasets/1004/annotate/1004-2021_03_20_213701.jpg,90.5,160.0,0.2828125,0.6666666666666666,0.034375,0.041666666666666664
1004-2021_03_20_213701.jpg,car,9,115,320,9,240,145,1,124,154,LTAdatasets/1004/annotate/1004-2021_03_20_213701.jpg,119.5,149.5,0.3734375,0.6229166666666667,0.028125,0.0375
1004-2021_03_20_213701.jpg,bike,13,23,320,20,240,205,4,36,225,LTAdatasets/1004/annotate/1004-2021_03_20_213701.jpg,29.5,215.0,0.0921875,0.8958333333333334,0.040625,0.08333333333333333
1004-2021_03_20_200116.jpg,car,23,237,320,28,240,208,1,260,236,LTAdatasets/1004/annotate/1004-2021_03_20_200116.jpg,248.5,222.0,0.7765625,0.925,0.071875,0.11666666666666667
1004-2021_03_20_200116.jpg,car,13,81,320,12,240,156,1,94,168,LTAdatasets/1004/annotate/1004-2021_03_20_200116.jpg,87.5,162.0,0.2734375,0.675,0.040625,0.05
1004-2021_03_20_200116.jpg,car,15,102,320,8,240,164,1,117,172,LTAdatasets/1004/annotate/1004-2021_03_20_200116.jpg,109.5,168.0,0.3421875,0.7,0.046875,0.03333333333333333
1004-2021_03_20_180410.jpg,car,19,236,320,25,240,198,1,255,223,LTAdatasets/1004/annotate/1004-2021_03_20_180410.jpg,245.5,210.5,0.7671875,0.8770833333333333,0.059375,0.10416666666666667
1004-2021_03_20_180410.jpg,car,23,277,320,27,240,201,1,300,228,LTAdatasets/1004/annotate/1004-2021_03_20_180410.jpg,288.5,214.5,0.9015625,0.89375,0.071875,0.1125
1004-2021_03_20_180410.jpg,lorry_truck,12,272,320,30,240,158,2,284,188,LTAdatasets/1004/annotate/1004-2021_03_20_180410.jpg,278.0,173.0,0.86875,0.7208333333333333,0.0375,0.125
1004-2021_03_20_180410.jpg,car,12,242,320,9,240,145,1,254,154,LTAdatasets/1004/annotate/1004-2021_03_20_180410.jpg,248.0,149.5,0.775,0.6229166666666667,0.0375,0.0375
1004-2021_03_20_061313.jpg,car,8,111,320,9,240,138,1,119,147,LTAdatasets/1004/annotate/1004-2021_03_20_061313.jpg,115.0,142.5,0.359375,0.59375,0.025,0.0375
1004-2021_03_20_074318.jpg,lorry_truck,25,268,320,32,240,183,2,293,215,LTAdatasets/1004/annotate/1004-2021_03_20_074318.jpg,280.5,199.0,0.8765625,0.8291666666666667,0.078125,0.13333333333333333
1004-2021_03_20_074318.jpg,lorry_truck,12,271,320,18,240,164,2,283,182,LTAdatasets/1004/annotate/1004-2021_03_20_074318.jpg,277.0,173.0,0.865625,0.7208333333333333,0.0375,0.075
1004-2021_03_20_064254.jpg,car,16,92,320,15,240,165,1,108,180,LTAdatasets/1004/annotate/1004-2021_03_20_064254.jpg,100.0,172.5,0.3125,0.71875,0.05,0.0625
1004-2021_03_20_203658.jpg,car,16,92,320,17,240,171,1,108,188,LTAdatasets/1004/annotate/1004-2021_03_20_203658.jpg,100.0,179.5,0.3125,0.7479166666666667,0.05,0.07083333333333333
1004-2021_03_20_203658.jpg,lorry_truck,27,40,320,24,240,182,2,67,206,LTAdatasets/1004/annotate/1004-2021_03_20_203658.jpg,53.5,194.0,0.1671875,0.8083333333333333,0.084375,0.1
1004-2021_03_20_203658.jpg,van,9,112,320,6,240,141,3,121,147,LTAdatasets/1004/annotate/1004-2021_03_20_203658.jpg,116.5,144.0,0.3640625,0.6,0.028125,0.025
1004-2021_03_20_203658.jpg,bike,9,93,320,10,240,139,4,102,149,LTAdatasets/1004/annotate/1004-2021_03_20_203658.jpg,97.5,144.0,0.3046875,0.6,0.028125,0.041666666666666664
1004-2021_03_20_093724.jpg,car,16,85,320,15,240,179,1,101,194,LTAdatasets/1004/annotate/1004-2021_03_20_093724.jpg,93.0,186.5,0.290625,0.7770833333333333,0.05,0.0625
1004-2021_03_20_093724.jpg,lorry_truck,26,40,320,24,240,178,2,66,202,LTAdatasets/1004/annotate/1004-2021_03_20_093724.jpg,53.0,190.0,0.165625,0.7916666666666666,0.08125,0.1
1004-2021_03_20_093724.jpg,lorry_truck,15,272,320,26,240,159,2,287,185,LTAdatasets/1004/annotate/1004-2021_03_20_093724.jpg,279.5,172.0,0.8734375,0.7166666666666667,0.046875,0.10833333333333334
1004-2021_03_20_093724.jpg,lorry_truck,28,230,320,55,240,185,2,258,240,LTAdatasets/1004/annotate/1004-2021_03_20_093724.jpg,244.0,212.5,0.7625,0.8854166666666666,0.0875,0.22916666666666666
1004-2021_03_20_093724.jpg,lorry_truck,20,235,320,13,240,168,2,255,181,LTAdatasets/1004/annotate/1004-2021_03_20_093724.jpg,245.0,174.5,0.765625,0.7270833333333333,0.0625,0.05416666666666667
1004-2021_03_20_093724.jpg,lorry_truck,12,242,320,11,240,150,2,254,161,LTAdatasets/1004/annotate/1004-2021_03_20_093724.jpg,248.0,155.5,0.775,0.6479166666666667,0.0375,0.04583333333333333
1004-2021_03_20_093724.jpg,car,18,273,320,24,240,194,1,291,218,LTAdatasets/1004/annotate/1004-2021_03_20_093724.jpg,282.0,206.0,0.88125,0.8583333333333333,0.05625,0.1
1004-2021_03_20_093724.jpg,car,11,89,320,9,240,144,1,100,153,LTAdatasets/1004/annotate/1004-2021_03_20_093724.jpg,94.5,148.5,0.2953125,0.61875,0.034375,0.0375
1004-2021_03_20_190413.jpg,lorry_truck,26,65,320,27,240,190,2,91,217,LTAdatasets/1004/annotate/1004-2021_03_20_190413.jpg,78.0,203.5,0.24375,0.8479166666666667,0.08125,0.1125
1004-2021_03_20_190413.jpg,car,19,271,320,32,240,185,1,290,217,LTAdatasets/1004/annotate/1004-2021_03_20_190413.jpg,280.5,201.0,0.8765625,0.8375,0.059375,0.13333333333333333
1004-2021_03_20_190413.jpg,car,15,242,320,19,240,178,1,257,197,LTAdatasets/1004/annotate/1004-2021_03_20_190413.jpg,249.5,187.5,0.7796875,0.78125,0.046875,0.07916666666666666
1004-2021_03_20_190413.jpg,car,17,238,320,19,240,221,1,255,240,LTAdatasets/1004/annotate/1004-2021_03_20_190413.jpg,246.5,230.5,0.7703125,0.9604166666666667,0.053125,0.07916666666666666
1004-2021_03_20_190413.jpg,car,12,242,320,10,240,148,1,254,158,LTAdatasets/1004/annotate/1004-2021_03_20_190413.jpg,248.0,153.0,0.775,0.6375,0.0375,0.041666666666666664
1004-2021_03_20_190413.jpg,bike,13,19,320,15,240,207,4,32,222,LTAdatasets/1004/annotate/1004-2021_03_20_190413.jpg,25.5,214.5,0.0796875,0.89375,0.040625,0.0625
1004-2021_03_20_074918.jpg,bike,10,282,320,19,240,193,4,292,212,LTAdatasets/1004/annotate/1004-2021_03_20_074918.jpg,287.0,202.5,0.896875,0.84375,0.03125,0.07916666666666666
1004-2021_03_20_074918.jpg,car,16,243,320,20,240,174,1,259,194,LTAdatasets/1004/annotate/1004-2021_03_20_074918.jpg,251.0,184.0,0.784375,0.7666666666666667,0.05,0.08333333333333333
1004-2021_03_20_074918.jpg,car,10,113,320,9,240,138,1,123,147,LTAdatasets/1004/annotate/1004-2021_03_20_074918.jpg,118.0,142.5,0.36875,0.59375,0.03125,0.0375
1004-2021_03_20_074918.jpg,car,10,98,320,6,240,134,1,108,140,LTAdatasets/1004/annotate/1004-2021_03_20_074918.jpg,103.0,137.0,0.321875,0.5708333333333333,0.03125,0.025
1004-2021_03_20_074918.jpg,bike,9,242,320,10,240,144,4,251,154,LTAdatasets/1004/annotate/1004-2021_03_20_074918.jpg,246.5,149.0,0.7703125,0.6208333333333333,0.028125,0.041666666666666664
1004-2021_03_20_212801.jpg,van,36,43,320,37,240,198,3,79,235,LTAdatasets/1004/annotate/1004-2021_03_20_212801.jpg,61.0,216.5,0.190625,0.9020833333333333,0.1125,0.15416666666666667
1004-2021_03_20_212801.jpg,car,17,73,320,13,240,160,1,90,173,LTAdatasets/1004/annotate/1004-2021_03_20_212801.jpg,81.5,166.5,0.2546875,0.69375,0.053125,0.05416666666666667
1004-2021_03_20_212801.jpg,lorry_truck,20,237,320,20,240,143,2,257,163,LTAdatasets/1004/annotate/1004-2021_03_20_212801.jpg,247.0,153.0,0.771875,0.6375,0.0625,0.08333333333333333
1004-2021_03_20_212801.jpg,car,8,114,320,9,240,135,1,122,144,LTAdatasets/1004/annotate/1004-2021_03_20_212801.jpg,118.0,139.5,0.36875,0.58125,0.025,0.0375
1004-2021_03_20_194916.jpg,car,24,277,320,27,240,213,1,301,240,LTAdatasets/1004/annotate/1004-2021_03_20_194916.jpg,289.0,226.5,0.903125,0.94375,0.075,0.1125
1004-2021_03_20_194916.jpg,car,13,244,320,20,240,167,1,257,187,LTAdatasets/1004/annotate/1004-2021_03_20_194916.jpg,250.5,177.0,0.7828125,0.7375,0.040625,0.08333333333333333
1004-2021_03_20_194916.jpg,car,8,111,320,8,240,140,1,119,148,LTAdatasets/1004/annotate/1004-2021_03_20_194916.jpg,115.0,144.0,0.359375,0.6,0.025,0.03333333333333333
1004-2021_03_20_083340.jpg,car,11,87,320,11,240,150,1,98,161,LTAdatasets/1004/annotate/1004-2021_03_20_083340.jpg,92.5,155.5,0.2890625,0.6479166666666667,0.034375,0.04583333333333333
1004-2021_03_20_220643.jpg,bike,9,240,320,18,240,168,4,249,186,LTAdatasets/1004/annotate/1004-2021_03_20_220643.jpg,244.5,177.0,0.7640625,0.7375,0.028125,0.075
1004-2021_03_20_220643.jpg,car,28,37,320,19,240,191,1,65,210,LTAdatasets/1004/annotate/1004-2021_03_20_220643.jpg,51.0,200.5,0.159375,0.8354166666666667,0.0875,0.07916666666666666
1004-2021_03_20_220643.jpg,car,7,92,320,11,240,143,1,99,154,LTAdatasets/1004/annotate/1004-2021_03_20_220643.jpg,95.5,148.5,0.2984375,0.61875,0.021875,0.04583333333333333
1004-2021_03_20_071236.jpg,bike,10,68,320,13,240,163,4,78,176,LTAdatasets/1004/annotate/1004-2021_03_20_071236.jpg,73.0,169.5,0.228125,0.70625,0.03125,0.05416666666666667
1004-2021_03_20_071236.jpg,bike,16,24,320,15,240,196,4,40,211,LTAdatasets/1004/annotate/1004-2021_03_20_071236.jpg,32.0,203.5,0.1,0.8479166666666667,0.05,0.0625
1004-2021_03_20_071236.jpg,bike,9,97,320,11,240,164,4,106,175,LTAdatasets/1004/annotate/1004-2021_03_20_071236.jpg,101.5,169.5,0.3171875,0.70625,0.028125,0.04583333333333333
1004-2021_03_20_071236.jpg,car,9,109,320,9,240,128,1,118,137,LTAdatasets/1004/annotate/1004-2021_03_20_071236.jpg,113.5,132.5,0.3546875,0.5520833333333334,0.028125,0.0375
1004-2021_03_20_071236.jpg,bike,6,102,320,7,240,134,4,108,141,LTAdatasets/1004/annotate/1004-2021_03_20_071236.jpg,105.0,137.5,0.328125,0.5729166666666666,0.01875,0.029166666666666667
1004-2021_03_20_220403.jpg,car,22,61,320,17,240,173,1,83,190,LTAdatasets/1004/annotate/1004-2021_03_20_220403.jpg,72.0,181.5,0.225,0.75625,0.06875,0.07083333333333333
1004-2021_03_20_220403.jpg,van,23,239,320,29,240,189,3,262,218,LTAdatasets/1004/annotate/1004-2021_03_20_220403.jpg,250.5,203.5,0.7828125,0.8479166666666667,0.071875,0.12083333333333333
1004-2021_03_20_220403.jpg,car,35,40,320,21,240,219,1,75,240,LTAdatasets/1004/annotate/1004-2021_03_20_220403.jpg,57.5,229.5,0.1796875,0.95625,0.109375,0.0875
1004-2021_03_20_220403.jpg,car,8,90,320,10,240,147,1,98,157,LTAdatasets/1004/annotate/1004-2021_03_20_220403.jpg,94.0,152.0,0.29375,0.6333333333333333,0.025,0.041666666666666664
1004-2021_03_20_220403.jpg,car,13,104,320,10,240,162,1,117,172,LTAdatasets/1004/annotate/1004-2021_03_20_220403.jpg,110.5,167.0,0.3453125,0.6958333333333333,0.040625,0.041666666666666664
1004-2021_03_20_220403.jpg,car,8,114,320,8,240,138,1,122,146,LTAdatasets/1004/annotate/1004-2021_03_20_220403.jpg,118.0,142.0,0.36875,0.5916666666666667,0.025,0.03333333333333333
1004-2021_03_20_070716.jpg,bike,11,244,320,14,240,195,4,255,209,LTAdatasets/1004/annotate/1004-2021_03_20_070716.jpg,249.5,202.0,0.7796875,0.8416666666666667,0.034375,0.058333333333333334
1004-2021_03_20_081319.jpg,car,17,83,320,16,240,180,1,100,196,LTAdatasets/1004/annotate/1004-2021_03_20_081319.jpg,91.5,188.0,0.2859375,0.7833333333333333,0.053125,0.06666666666666667
1004-2021_03_20_081319.jpg,car,29,51,320,16,240,206,1,80,222,LTAdatasets/1004/annotate/1004-2021_03_20_081319.jpg,65.5,214.0,0.2046875,0.8916666666666667,0.090625,0.06666666666666667
1004-2021_03_20_191234.jpg,car,21,238,320,23,240,194,1,259,217,LTAdatasets/1004/annotate/1004-2021_03_20_191234.jpg,248.5,205.5,0.7765625,0.85625,0.065625,0.09583333333333334
1004-2021_03_20_191234.jpg,car,27,274,320,27,240,199,1,301,226,LTAdatasets/1004/annotate/1004-2021_03_20_191234.jpg,287.5,212.5,0.8984375,0.8854166666666666,0.084375,0.1125
1004-2021_03_20_191234.jpg,car,23,75,320,14,240,189,1,98,203,LTAdatasets/1004/annotate/1004-2021_03_20_191234.jpg,86.5,196.0,0.2703125,0.8166666666666667,0.071875,0.058333333333333334
1004-2021_03_20_191234.jpg,car,15,243,320,12,240,167,1,258,179,LTAdatasets/1004/annotate/1004-2021_03_20_191234.jpg,250.5,173.0,0.7828125,0.7208333333333333,0.046875,0.05
1004-2021_03_20_191234.jpg,car,11,110,320,11,240,138,1,121,149,LTAdatasets/1004/annotate/1004-2021_03_20_191234.jpg,115.5,143.5,0.3609375,0.5979166666666667,0.034375,0.04583333333333333
1004-2021_03_20_191234.jpg,car,8,97,320,6,240,136,1,105,142,LTAdatasets/1004/annotate/1004-2021_03_20_191234.jpg,101.0,139.0,0.315625,0.5791666666666667,0.025,0.025
1004-2021_03_20_085822.jpg,lorry_truck,14,243,320,20,240,142,2,257,162,LTAdatasets/1004/annotate/1004-2021_03_20_085822.jpg,250.0,152.0,0.78125,0.6333333333333333,0.04375,0.08333333333333333
1004-2021_03_20_060353.jpg,bike,7,245,320,13,240,141,4,252,154,LTAdatasets/1004/annotate/1004-2021_03_20_060353.jpg,248.5,147.5,0.7765625,0.6145833333333334,0.021875,0.05416666666666667
1004-2021_03_20_090402.jpg,car,24,270,320,22,240,192,1,294,214,LTAdatasets/1004/annotate/1004-2021_03_20_090402.jpg,282.0,203.0,0.88125,0.8458333333333333,0.075,0.09166666666666666
1004-2021_03_20_090402.jpg,lorry_truck,18,239,320,16,240,145,2,257,161,LTAdatasets/1004/annotate/1004-2021_03_20_090402.jpg,248.0,153.0,0.775,0.6375,0.05625,0.06666666666666667
1004-2021_03_20_090402.jpg,car,10,271,320,13,240,162,1,281,175,LTAdatasets/1004/annotate/1004-2021_03_20_090402.jpg,276.0,168.5,0.8625,0.7020833333333333,0.03125,0.05416666666666667
1004-2021_03_20_202758.jpg,car,17,264,320,13,240,175,1,281,188,LTAdatasets/1004/annotate/1004-2021_03_20_202758.jpg,272.5,181.5,0.8515625,0.75625,0.053125,0.05416666666666667
1004-2021_03_20_202758.jpg,car,9,96,320,8,240,140,1,105,148,LTAdatasets/1004/annotate/1004-2021_03_20_202758.jpg,100.5,144.0,0.3140625,0.6,0.028125,0.03333333333333333
1004-2021_03_20_094305.jpg,car,18,237,320,18,240,170,1,255,188,LTAdatasets/1004/annotate/1004-2021_03_20_094305.jpg,246.0,179.0,0.76875,0.7458333333333333,0.05625,0.075
1004-2021_03_20_094305.jpg,car,22,235,320,22,240,197,1,257,219,LTAdatasets/1004/annotate/1004-2021_03_20_094305.jpg,246.0,208.0,0.76875,0.8666666666666667,0.06875,0.09166666666666666
1004-2021_03_20_094305.jpg,van,26,66,320,20,240,179,3,92,199,LTAdatasets/1004/annotate/1004-2021_03_20_094305.jpg,79.0,189.0,0.246875,0.7875,0.08125,0.08333333333333333
1004-2021_03_20_094305.jpg,lorry_truck,20,270,320,26,240,165,2,290,191,LTAdatasets/1004/annotate/1004-2021_03_20_094305.jpg,280.0,178.0,0.875,0.7416666666666667,0.0625,0.10833333333333334
1004-2021_03_20_094305.jpg,car,13,240,320,9,240,151,1,253,160,LTAdatasets/1004/annotate/1004-2021_03_20_094305.jpg,246.5,155.5,0.7703125,0.6479166666666667,0.040625,0.0375
1004-2021_03_20_195736.jpg,car,23,53,320,15,240,178,1,76,193,LTAdatasets/1004/annotate/1004-2021_03_20_195736.jpg,64.5,185.5,0.2015625,0.7729166666666667,0.071875,0.0625
1004-2021_03_20_195736.jpg,car,22,84,320,20,240,177,1,106,197,LTAdatasets/1004/annotate/1004-2021_03_20_195736.jpg,95.0,187.0,0.296875,0.7791666666666667,0.06875,0.08333333333333333
1004-2021_03_20_195736.jpg,car,9,92,320,11,240,146,1,101,157,LTAdatasets/1004/annotate/1004-2021_03_20_195736.jpg,96.5,151.5,0.3015625,0.63125,0.028125,0.04583333333333333
1004-2021_03_20_193635.jpg,van,28,68,320,27,240,184,3,96,211,LTAdatasets/1004/annotate/1004-2021_03_20_193635.jpg,82.0,197.5,0.25625,0.8229166666666666,0.0875,0.1125
1004-2021_03_20_193635.jpg,car,24,232,320,30,240,210,1,256,240,LTAdatasets/1004/annotate/1004-2021_03_20_193635.jpg,244.0,225.0,0.7625,0.9375,0.075,0.125
1004-2021_03_20_193635.jpg,car,13,83,320,14,240,149,1,96,163,LTAdatasets/1004/annotate/1004-2021_03_20_193635.jpg,89.5,156.0,0.2796875,0.65,0.040625,0.058333333333333334
1004-2021_03_20_193635.jpg,car,14,109,320,10,240,133,1,123,143,LTAdatasets/1004/annotate/1004-2021_03_20_193635.jpg,116.0,138.0,0.3625,0.575,0.04375,0.041666666666666664
1004-2021_03_20_193635.jpg,car,12,269,320,13,240,166,1,281,179,LTAdatasets/1004/annotate/1004-2021_03_20_193635.jpg,275.0,172.5,0.859375,0.71875,0.0375,0.05416666666666667
1004-2021_03_20_100405.jpg,car,23,276,320,24,240,203,1,299,227,LTAdatasets/1004/annotate/1004-2021_03_20_100405.jpg,287.5,215.0,0.8984375,0.8958333333333334,0.071875,0.1
1004-2021_03_20_100405.jpg,car,25,233,320,23,240,217,1,258,240,LTAdatasets/1004/annotate/1004-2021_03_20_100405.jpg,245.5,228.5,0.7671875,0.9520833333333333,0.078125,0.09583333333333334
1004-2021_03_20_100405.jpg,car,6,95,320,9,240,140,1,101,149,LTAdatasets/1004/annotate/1004-2021_03_20_100405.jpg,98.0,144.5,0.30625,0.6020833333333333,0.01875,0.0375
1004-2021_03_20_100405.jpg,car,11,111,320,7,240,142,1,122,149,LTAdatasets/1004/annotate/1004-2021_03_20_100405.jpg,116.5,145.5,0.3640625,0.60625,0.034375,0.029166666666666667
1004-2021_03_20_100405.jpg,lorry_truck,14,245,320,15,240,168,2,259,183,LTAdatasets/1004/annotate/1004-2021_03_20_100405.jpg,252.0,175.5,0.7875,0.73125,0.04375,0.0625
1004-2021_03_20_185153.jpg,car,27,66,320,21,240,196,1,93,217,LTAdatasets/1004/annotate/1004-2021_03_20_185153.jpg,79.5,206.5,0.2484375,0.8604166666666667,0.084375,0.0875
1004-2021_03_20_185153.jpg,car,23,238,320,27,240,186,1,261,213,LTAdatasets/1004/annotate/1004-2021_03_20_185153.jpg,249.5,199.5,0.7796875,0.83125,0.071875,0.1125
1004-2021_03_20_185153.jpg,car,19,237,320,14,240,169,1,256,183,LTAdatasets/1004/annotate/1004-2021_03_20_185153.jpg,246.5,176.0,0.7703125,0.7333333333333333,0.059375,0.058333333333333334
1004-2021_03_20_185153.jpg,car,13,242,320,8,240,149,1,255,157,LTAdatasets/1004/annotate/1004-2021_03_20_185153.jpg,248.5,153.0,0.7765625,0.6375,0.040625,0.03333333333333333
1004-2021_03_20_190634.jpg,car,18,241,320,25,240,185,1,259,210,LTAdatasets/1004/annotate/1004-2021_03_20_190634.jpg,250.0,197.5,0.78125,0.8229166666666666,0.05625,0.10416666666666667
1004-2021_03_20_190634.jpg,car,9,62,320,15,240,177,1,71,192,LTAdatasets/1004/annotate/1004-2021_03_20_190634.jpg,66.5,184.5,0.2078125,0.76875,0.028125,0.0625
1004-2021_03_20_190634.jpg,lorry_truck,16,95,320,20,240,164,2,111,184,LTAdatasets/1004/annotate/1004-2021_03_20_190634.jpg,103.0,174.0,0.321875,0.725,0.05,0.08333333333333333
1004-2021_03_20_190634.jpg,lorry_truck,8,114,320,10,240,138,2,122,148,LTAdatasets/1004/annotate/1004-2021_03_20_190634.jpg,118.0,143.0,0.36875,0.5958333333333333,0.025,0.041666666666666664
1004-2021_03_20_190634.jpg,car,7,95,320,9,240,141,1,102,150,LTAdatasets/1004/annotate/1004-2021_03_20_190634.jpg,98.5,145.5,0.3078125,0.60625,0.021875,0.0375
1004-2021_03_20_080419.jpg,car,14,245,320,17,240,177,1,259,194,LTAdatasets/1004/annotate/1004-2021_03_20_080419.jpg,252.0,185.5,0.7875,0.7729166666666667,0.04375,0.07083333333333333
1004-2021_03_20_182151.jpg,car,19,242,320,20,240,174,1,261,194,LTAdatasets/1004/annotate/1004-2021_03_20_182151.jpg,251.5,184.0,0.7859375,0.7666666666666667,0.059375,0.08333333333333333
1004-2021_03_20_182151.jpg,lorry_truck,23,53,320,23,240,171,2,76,194,LTAdatasets/1004/annotate/1004-2021_03_20_182151.jpg,64.5,182.5,0.2015625,0.7604166666666666,0.071875,0.09583333333333334
1004-2021_03_20_182151.jpg,car,10,244,320,8,240,148,1,254,156,LTAdatasets/1004/annotate/1004-2021_03_20_182151.jpg,249.0,152.0,0.778125,0.6333333333333333,0.03125,0.03333333333333333
1004-2021_03_20_182151.jpg,car,8,111,320,7,240,138,1,119,145,LTAdatasets/1004/annotate/1004-2021_03_20_182151.jpg,115.0,141.5,0.359375,0.5895833333333333,0.025,0.029166666666666667
1004-2021_03_20_191614.jpg,car,19,63,320,13,240,176,1,82,189,LTAdatasets/1004/annotate/1004-2021_03_20_191614.jpg,72.5,182.5,0.2265625,0.7604166666666666,0.059375,0.05416666666666667
1004-2021_03_20_191614.jpg,car,27,64,320,21,240,197,1,91,218,LTAdatasets/1004/annotate/1004-2021_03_20_191614.jpg,77.5,207.5,0.2421875,0.8645833333333334,0.084375,0.0875
1004-2021_03_20_191614.jpg,car,30,2,320,27,240,213,1,32,240,LTAdatasets/1004/annotate/1004-2021_03_20_191614.jpg,17.0,226.5,0.053125,0.94375,0.09375,0.1125
1004-2021_03_20_191614.jpg,car,20,240,320,23,240,188,1,260,211,LTAdatasets/1004/annotate/1004-2021_03_20_191614.jpg,250.0,199.5,0.78125,0.83125,0.0625,0.09583333333333334
1004-2021_03_20_191614.jpg,car,11,243,320,10,240,165,1,254,175,LTAdatasets/1004/annotate/1004-2021_03_20_191614.jpg,248.5,170.0,0.7765625,0.7083333333333334,0.034375,0.041666666666666664
1004-2021_03_20_191614.jpg,car,12,95,320,7,240,135,1,107,142,LTAdatasets/1004/annotate/1004-2021_03_20_191614.jpg,101.0,138.5,0.315625,0.5770833333333333,0.0375,0.029166666666666667
1004-2021_03_20_201917.jpg,car,28,230,320,37,240,201,1,258,238,LTAdatasets/1004/annotate/1004-2021_03_20_201917.jpg,244.0,219.5,0.7625,0.9145833333333333,0.0875,0.15416666666666667
1004-2021_03_20_201917.jpg,car,17,240,320,18,240,169,1,257,187,LTAdatasets/1004/annotate/1004-2021_03_20_201917.jpg,248.5,178.0,0.7765625,0.7416666666666667,0.053125,0.075
1004-2021_03_20_201917.jpg,car,14,80,320,11,240,157,1,94,168,LTAdatasets/1004/annotate/1004-2021_03_20_201917.jpg,87.0,162.5,0.271875,0.6770833333333334,0.04375,0.04583333333333333
1004-2021_03_20_201917.jpg,car,11,96,320,9,240,134,1,107,143,LTAdatasets/1004/annotate/1004-2021_03_20_201917.jpg,101.5,138.5,0.3171875,0.5770833333333333,0.034375,0.0375
1004-2021_03_20_192214.jpg,car,20,275,320,28,240,189,1,295,217,LTAdatasets/1004/annotate/1004-2021_03_20_192214.jpg,285.0,203.0,0.890625,0.8458333333333333,0.0625,0.11666666666666667
1004-2021_03_20_192214.jpg,car,14,94,320,15,240,172,1,108,187,LTAdatasets/1004/annotate/1004-2021_03_20_192214.jpg,101.0,179.5,0.315625,0.7479166666666667,0.04375,0.0625
1004-2021_03_20_192214.jpg,car,13,84,320,10,240,150,1,97,160,LTAdatasets/1004/annotate/1004-2021_03_20_192214.jpg,90.5,155.0,0.2828125,0.6458333333333334,0.040625,0.041666666666666664
1004-2021_03_20_192214.jpg,car,8,111,320,8,240,141,1,119,149,LTAdatasets/1004/annotate/1004-2021_03_20_192214.jpg,115.0,145.0,0.359375,0.6041666666666666,0.025,0.03333333333333333
1004-2021_03_20_192214.jpg,lorry_truck,11,244,320,12,240,146,2,255,158,LTAdatasets/1004/annotate/1004-2021_03_20_192214.jpg,249.5,152.0,0.7796875,0.6333333333333333,0.034375,0.05
1004-2021_03_20_095205.jpg,car,22,236,320,22,240,199,1,258,221,LTAdatasets/1004/annotate/1004-2021_03_20_095205.jpg,247.0,210.0,0.771875,0.875,0.06875,0.09166666666666666
1004-2021_03_20_095205.jpg,van,15,272,320,20,240,173,3,287,193,LTAdatasets/1004/annotate/1004-2021_03_20_095205.jpg,279.5,183.0,0.8734375,0.7625,0.046875,0.08333333333333333
1004-2021_03_20_095205.jpg,car,12,238,320,15,240,176,1,250,191,LTAdatasets/1004/annotate/1004-2021_03_20_095205.jpg,244.0,183.5,0.7625,0.7645833333333333,0.0375,0.0625
1004-2021_03_20_095205.jpg,van,11,240,320,11,240,150,3,251,161,LTAdatasets/1004/annotate/1004-2021_03_20_095205.jpg,245.5,155.5,0.7671875,0.6479166666666667,0.034375,0.04583333333333333
1004-2021_03_20_092803.jpg,car,22,231,320,24,240,199,1,253,223,LTAdatasets/1004/annotate/1004-2021_03_20_092803.jpg,242.0,211.0,0.75625,0.8791666666666667,0.06875,0.1
1004-2021_03_20_092803.jpg,car,18,239,320,22,240,179,1,257,201,LTAdatasets/1004/annotate/1004-2021_03_20_092803.jpg,248.0,190.0,0.775,0.7916666666666666,0.05625,0.09166666666666666
1004-2021_03_20_092803.jpg,car,17,240,320,10,240,169,1,257,179,LTAdatasets/1004/annotate/1004-2021_03_20_092803.jpg,248.5,174.0,0.7765625,0.725,0.053125,0.041666666666666664
1004-2021_03_20_092803.jpg,van,13,273,320,8,240,168,3,286,176,LTAdatasets/1004/annotate/1004-2021_03_20_092803.jpg,279.5,172.0,0.8734375,0.7166666666666667,0.040625,0.03333333333333333
1004-2021_03_20_092803.jpg,lorry_truck,31,273,320,46,240,177,2,304,223,LTAdatasets/1004/annotate/1004-2021_03_20_092803.jpg,288.5,200.0,0.9015625,0.8333333333333334,0.096875,0.19166666666666668
1004-2021_03_20_092803.jpg,car,24,40,320,21,240,187,1,64,208,LTAdatasets/1004/annotate/1004-2021_03_20_092803.jpg,52.0,197.5,0.1625,0.8229166666666666,0.075,0.0875
1004-2021_03_20_092803.jpg,car,9,91,320,8,240,147,1,100,155,LTAdatasets/1004/annotate/1004-2021_03_20_092803.jpg,95.5,151.0,0.2984375,0.6291666666666667,0.028125,0.03333333333333333
1004-2021_03_20_092803.jpg,car,10,243,320,6,240,150,1,253,156,LTAdatasets/1004/annotate/1004-2021_03_20_092803.jpg,248.0,153.0,0.775,0.6375,0.03125,0.025
1004-2021_03_20_183712.jpg,car,22,43,320,17,240,184,1,65,201,LTAdatasets/1004/annotate/1004-2021_03_20_183712.jpg,54.0,192.5,0.16875,0.8020833333333334,0.06875,0.07083333333333333
1004-2021_03_20_183712.jpg,car,20,239,320,18,240,185,1,259,203,LTAdatasets/1004/annotate/1004-2021_03_20_183712.jpg,249.0,194.0,0.778125,0.8083333333333333,0.0625,0.075
1004-2021_03_20_183712.jpg,car,18,270,320,15,240,183,1,288,198,LTAdatasets/1004/annotate/1004-2021_03_20_183712.jpg,279.0,190.5,0.871875,0.79375,0.05625,0.0625
1004-2021_03_20_183712.jpg,car,17,238,320,13,240,171,1,255,184,LTAdatasets/1004/annotate/1004-2021_03_20_183712.jpg,246.5,177.5,0.7703125,0.7395833333333334,0.053125,0.05416666666666667
1004-2021_03_20_183712.jpg,bike,12,78,320,15,240,192,4,90,207,LTAdatasets/1004/annotate/1004-2021_03_20_183712.jpg,84.0,199.5,0.2625,0.83125,0.0375,0.0625
1004-2021_03_20_183712.jpg,car,30,230,320,28,240,212,1,260,240,LTAdatasets/1004/annotate/1004-2021_03_20_183712.jpg,245.0,226.0,0.765625,0.9416666666666667,0.09375,0.11666666666666667
1004-2021_03_20_183712.jpg,car,8,116,320,8,240,141,1,124,149,LTAdatasets/1004/annotate/1004-2021_03_20_183712.jpg,120.0,145.0,0.375,0.6041666666666666,0.025,0.03333333333333333
1004-2021_03_20_062754.jpg,lorry_truck,16,108,320,13,240,130,2,124,143,LTAdatasets/1004/annotate/1004-2021_03_20_062754.jpg,116.0,136.5,0.3625,0.56875,0.05,0.05416666666666667
1004-2021_03_20_062754.jpg,car,9,94,320,6,240,142,1,103,148,LTAdatasets/1004/annotate/1004-2021_03_20_062754.jpg,98.5,145.0,0.3078125,0.6041666666666666,0.028125,0.025
1004-2021_03_20_215802.jpg,car,14,241,320,18,240,167,1,255,185,LTAdatasets/1004/annotate/1004-2021_03_20_215802.jpg,248.0,176.0,0.775,0.7333333333333333,0.04375,0.075
1004-2021_03_20_215802.jpg,car,7,111,320,8,240,132,1,118,140,LTAdatasets/1004/annotate/1004-2021_03_20_215802.jpg,114.5,136.0,0.3578125,0.5666666666666667,0.021875,0.03333333333333333
1004-2021_03_20_212140.jpg,car,16,93,320,12,240,174,1,109,186,LTAdatasets/1004/annotate/1004-2021_03_20_212140.jpg,101.0,180.0,0.315625,0.75,0.05,0.05
1004-2021_03_20_212140.jpg,car,23,240,320,20,240,182,1,263,202,LTAdatasets/1004/annotate/1004-2021_03_20_212140.jpg,251.5,192.0,0.7859375,0.8,0.071875,0.08333333333333333
1004-2021_03_20_100105.jpg,car,20,237,320,17,240,182,1,257,199,LTAdatasets/1004/annotate/1004-2021_03_20_100105.jpg,247.0,190.5,0.771875,0.79375,0.0625,0.07083333333333333
1004-2021_03_20_100105.jpg,lorry_truck,27,51,320,23,240,191,2,78,214,LTAdatasets/1004/annotate/1004-2021_03_20_100105.jpg,64.5,202.5,0.2015625,0.84375,0.084375,0.09583333333333334
1004-2021_03_20_100105.jpg,car,15,94,320,15,240,166,1,109,181,LTAdatasets/1004/annotate/1004-2021_03_20_100105.jpg,101.5,173.5,0.3171875,0.7229166666666667,0.046875,0.0625
1004-2021_03_20_100105.jpg,car,11,242,320,8,240,146,1,253,154,LTAdatasets/1004/annotate/1004-2021_03_20_100105.jpg,247.5,150.0,0.7734375,0.625,0.034375,0.03333333333333333
1004-2021_03_20_092143.jpg,bike,8,263,320,18,240,202,4,271,220,LTAdatasets/1004/annotate/1004-2021_03_20_092143.jpg,267.0,211.0,0.834375,0.8791666666666667,0.025,0.075
1004-2021_03_20_092143.jpg,car,26,276,320,25,240,215,1,302,240,LTAdatasets/1004/annotate/1004-2021_03_20_092143.jpg,289.0,227.5,0.903125,0.9479166666666666,0.08125,0.10416666666666667
1004-2021_03_20_092143.jpg,car,18,85,320,18,240,180,1,103,198,LTAdatasets/1004/annotate/1004-2021_03_20_092143.jpg,94.0,189.0,0.29375,0.7875,0.05625,0.075
1004-2021_03_20_092143.jpg,car,26,231,320,15,240,225,1,257,240,LTAdatasets/1004/annotate/1004-2021_03_20_092143.jpg,244.0,232.5,0.7625,0.96875,0.08125,0.0625
1004-2021_03_20_092143.jpg,car,14,238,320,14,240,173,1,252,187,LTAdatasets/1004/annotate/1004-2021_03_20_092143.jpg,245.0,180.0,0.765625,0.75,0.04375,0.058333333333333334
1004-2021_03_20_092143.jpg,lorry_truck,27,274,320,33,240,172,2,301,205,LTAdatasets/1004/annotate/1004-2021_03_20_092143.jpg,287.5,188.5,0.8984375,0.7854166666666667,0.084375,0.1375
1004-2021_03_20_092143.jpg,lorry_truck,34,15,320,27,240,193,2,49,220,LTAdatasets/1004/annotate/1004-2021_03_20_092143.jpg,32.0,206.5,0.1,0.8604166666666667,0.10625,0.1125
1004-2021_03_20_092143.jpg,van,21,237,320,21,240,191,3,258,212,LTAdatasets/1004/annotate/1004-2021_03_20_092143.jpg,247.5,201.5,0.7734375,0.8395833333333333,0.065625,0.0875
1004-2021_03_20_092143.jpg,car,10,241,320,11,240,151,1,251,162,LTAdatasets/1004/annotate/1004-2021_03_20_092143.jpg,246.0,156.5,0.76875,0.6520833333333333,0.03125,0.04583333333333333
1004-2021_03_20_073417.jpg,car,15,271,320,15,240,171,1,286,186,LTAdatasets/1004/annotate/1004-2021_03_20_073417.jpg,278.5,178.5,0.8703125,0.74375,0.046875,0.0625
1004-2021_03_20_082220.jpg,car,26,63,320,21,240,196,1,89,217,LTAdatasets/1004/annotate/1004-2021_03_20_082220.jpg,76.0,206.5,0.2375,0.8604166666666667,0.08125,0.0875
1004-2021_03_20_082220.jpg,car,11,244,320,13,240,146,1,255,159,LTAdatasets/1004/annotate/1004-2021_03_20_082220.jpg,249.5,152.5,0.7796875,0.6354166666666666,0.034375,0.05416666666666667
1004-2021_03_20_082220.jpg,lorry_truck,9,100,320,8,240,131,2,109,139,LTAdatasets/1004/annotate/1004-2021_03_20_082220.jpg,104.5,135.0,0.3265625,0.5625,0.028125,0.03333333333333333
1004-2021_03_20_075138.jpg,lorry_truck,19,89,320,23,240,168,2,108,191,LTAdatasets/1004/annotate/1004-2021_03_20_075138.jpg,98.5,179.5,0.3078125,0.7479166666666667,0.059375,0.09583333333333334
1004-2021_03_20_075138.jpg,bike,10,34,320,17,240,192,4,44,209,LTAdatasets/1004/annotate/1004-2021_03_20_075138.jpg,39.0,200.5,0.121875,0.8354166666666667,0.03125,0.07083333333333333
1004-2021_03_20_072216.jpg,bike,8,83,320,12,240,150,4,91,162,LTAdatasets/1004/annotate/1004-2021_03_20_072216.jpg,87.0,156.0,0.271875,0.65,0.025,0.05
1004-2021_03_20_072216.jpg,lorry_truck,39,28,320,20,240,220,2,67,240,LTAdatasets/1004/annotate/1004-2021_03_20_072216.jpg,47.5,230.0,0.1484375,0.9583333333333334,0.121875,0.08333333333333333
9705-2021_03_20_183112.jpg,car,30,190,640,22,360,128,1,220,150,LTAdatasets/9705/annotate/9705-2021_03_20_183112.jpg,205.0,139.0,0.3203125,0.3861111111111111,0.046875,0.06111111111111111
9705-2021_03_20_183112.jpg,car,19,421,640,17,360,78,1,440,95,LTAdatasets/9705/annotate/9705-2021_03_20_183112.jpg,430.5,86.5,0.67265625,0.24027777777777778,0.0296875,0.04722222222222222
9705-2021_03_20_183112.jpg,car,17,469,640,16,360,82,1,486,98,LTAdatasets/9705/annotate/9705-2021_03_20_183112.jpg,477.5,90.0,0.74609375,0.25,0.0265625,0.044444444444444446
9705-2021_03_20_183112.jpg,car,15,461,640,14,360,67,1,476,81,LTAdatasets/9705/annotate/9705-2021_03_20_183112.jpg,468.5,74.0,0.73203125,0.20555555555555555,0.0234375,0.03888888888888889
9705-2021_03_20_183112.jpg,lorry_truck,13,472,640,11,360,53,2,485,64,LTAdatasets/9705/annotate/9705-2021_03_20_183112.jpg,478.5,58.5,0.74765625,0.1625,0.0203125,0.030555555555555555
9705-2021_03_20_183112.jpg,lorry_truck,20,306,640,14,360,87,2,326,101,LTAdatasets/9705/annotate/9705-2021_03_20_183112.jpg,316.0,94.0,0.49375,0.2611111111111111,0.03125,0.03888888888888889
9705-2021_03_20_183112.jpg,lorry_truck,21,358,640,15,360,61,2,379,76,LTAdatasets/9705/annotate/9705-2021_03_20_183112.jpg,368.5,68.5,0.57578125,0.19027777777777777,0.0328125,0.041666666666666664
9705-2021_03_20_183112.jpg,car,12,396,640,8,360,55,1,408,63,LTAdatasets/9705/annotate/9705-2021_03_20_183112.jpg,402.0,59.0,0.628125,0.1638888888888889,0.01875,0.022222222222222223
9705-2021_03_20_183112.jpg,car,11,327,640,10,360,66,1,338,76,LTAdatasets/9705/annotate/9705-2021_03_20_183112.jpg,332.5,71.0,0.51953125,0.19722222222222222,0.0171875,0.027777777777777776
9705-2021_03_20_183112.jpg,lorry_truck,9,471,640,12,360,42,2,480,54,LTAdatasets/9705/annotate/9705-2021_03_20_183112.jpg,475.5,48.0,0.74296875,0.13333333333333333,0.0140625,0.03333333333333333
9705-2021_03_20_094024.jpg,lorry_truck,54,395,640,60,360,217,2,449,277,LTAdatasets/9705/annotate/9705-2021_03_20_094024.jpg,422.0,247.0,0.659375,0.6861111111111111,0.084375,0.16666666666666666
9705-2021_03_20_094024.jpg,bus,19,470,640,19,360,62,5,489,81,LTAdatasets/9705/annotate/9705-2021_03_20_094024.jpg,479.5,71.5,0.74921875,0.1986111111111111,0.0296875,0.05277777777777778
9705-2021_03_20_094024.jpg,car,12,446,640,12,360,83,1,458,95,LTAdatasets/9705/annotate/9705-2021_03_20_094024.jpg,452.0,89.0,0.70625,0.24722222222222223,0.01875,0.03333333333333333
9705-2021_03_20_094024.jpg,car,31,262,640,16,360,118,1,293,134,LTAdatasets/9705/annotate/9705-2021_03_20_094024.jpg,277.5,126.0,0.43359375,0.35,0.0484375,0.044444444444444446
9705-2021_03_20_094024.jpg,car,36,236,640,19,360,150,1,272,169,LTAdatasets/9705/annotate/9705-2021_03_20_094024.jpg,254.0,159.5,0.396875,0.44305555555555554,0.05625,0.05277777777777778
9705-2021_03_20_094024.jpg,van,47,141,640,23,360,175,3,188,198,LTAdatasets/9705/annotate/9705-2021_03_20_094024.jpg,164.5,186.5,0.25703125,0.5180555555555556,0.0734375,0.06388888888888888
9705-2021_03_20_094024.jpg,car,11,372,640,10,360,68,1,383,78,LTAdatasets/9705/annotate/9705-2021_03_20_094024.jpg,377.5,73.0,0.58984375,0.20277777777777778,0.0171875,0.027777777777777776
9705-2021_03_20_094024.jpg,bike,8,365,640,9,360,65,4,373,74,LTAdatasets/9705/annotate/9705-2021_03_20_094024.jpg,369.0,69.5,0.5765625,0.19305555555555556,0.0125,0.025
9705-2021_03_20_094024.jpg,car,10,388,640,9,360,59,1,398,68,LTAdatasets/9705/annotate/9705-2021_03_20_094024.jpg,393.0,63.5,0.6140625,0.1763888888888889,0.015625,0.025
9705-2021_03_20_094024.jpg,car,9,396,640,11,360,51,1,405,62,LTAdatasets/9705/annotate/9705-2021_03_20_094024.jpg,400.5,56.5,0.62578125,0.15694444444444444,0.0140625,0.030555555555555555
9705-2021_03_20_083640.jpg,car,69,170,640,65,360,286,1,239,351,LTAdatasets/9705/annotate/9705-2021_03_20_083640.jpg,204.5,318.5,0.31953125,0.8847222222222222,0.1078125,0.18055555555555555
9705-2021_03_20_083640.jpg,car,46,151,640,22,360,177,1,197,199,LTAdatasets/9705/annotate/9705-2021_03_20_083640.jpg,174.0,188.0,0.271875,0.5222222222222223,0.071875,0.06111111111111111
9705-2021_03_20_083640.jpg,car,35,228,640,17,360,157,1,263,174,LTAdatasets/9705/annotate/9705-2021_03_20_083640.jpg,245.5,165.5,0.38359375,0.4597222222222222,0.0546875,0.04722222222222222
9705-2021_03_20_083640.jpg,car,32,255,640,19,360,121,1,287,140,LTAdatasets/9705/annotate/9705-2021_03_20_083640.jpg,271.0,130.5,0.4234375,0.3625,0.05,0.05277777777777778
9705-2021_03_20_083640.jpg,van,27,299,640,16,360,99,3,326,115,LTAdatasets/9705/annotate/9705-2021_03_20_083640.jpg,312.5,107.0,0.48828125,0.2972222222222222,0.0421875,0.044444444444444446
9705-2021_03_20_083640.jpg,car,18,365,640,13,360,78,1,383,91,LTAdatasets/9705/annotate/9705-2021_03_20_083640.jpg,374.0,84.5,0.584375,0.23472222222222222,0.028125,0.03611111111111111
9705-2021_03_20_083640.jpg,car,10,390,640,7,360,68,1,400,75,LTAdatasets/9705/annotate/9705-2021_03_20_083640.jpg,395.0,71.5,0.6171875,0.1986111111111111,0.015625,0.019444444444444445
9705-2021_03_20_083640.jpg,car,12,450,640,13,360,73,1,462,86,LTAdatasets/9705/annotate/9705-2021_03_20_083640.jpg,456.0,79.5,0.7125,0.22083333333333333,0.01875,0.03611111111111111
9705-2021_03_20_083640.jpg,car,11,389,640,6,360,60,1,400,66,LTAdatasets/9705/annotate/9705-2021_03_20_083640.jpg,394.5,63.0,0.61640625,0.175,0.0171875,0.016666666666666666
9705-2021_03_20_083640.jpg,car,8,406,640,10,360,58,1,414,68,LTAdatasets/9705/annotate/9705-2021_03_20_083640.jpg,410.0,63.0,0.640625,0.175,0.0125,0.027777777777777776
9705-2021_03_20_083640.jpg,lorry_truck,20,468,640,23,360,71,2,488,94,LTAdatasets/9705/annotate/9705-2021_03_20_083640.jpg,478.0,82.5,0.746875,0.22916666666666666,0.03125,0.06388888888888888
9705-2021_03_20_083640.jpg,bike,8,447,640,10,360,56,4,455,66,LTAdatasets/9705/annotate/9705-2021_03_20_083640.jpg,451.0,61.0,0.7046875,0.16944444444444445,0.0125,0.027777777777777776
9705-2021_03_20_095505.jpg,car,25,456,640,27,360,133,1,481,160,LTAdatasets/9705/annotate/9705-2021_03_20_095505.jpg,468.5,146.5,0.73203125,0.40694444444444444,0.0390625,0.075
9705-2021_03_20_095505.jpg,car,39,325,640,27,360,156,1,364,183,LTAdatasets/9705/annotate/9705-2021_03_20_095505.jpg,344.5,169.5,0.53828125,0.4708333333333333,0.0609375,0.075
9705-2021_03_20_095505.jpg,car,9,392,640,8,360,66,1,401,74,LTAdatasets/9705/annotate/9705-2021_03_20_095505.jpg,396.5,70.0,0.61953125,0.19444444444444445,0.0140625,0.022222222222222223
9705-2021_03_20_095505.jpg,lorry_truck,12,475,640,11,360,74,2,487,85,LTAdatasets/9705/annotate/9705-2021_03_20_095505.jpg,481.0,79.5,0.7515625,0.22083333333333333,0.01875,0.030555555555555555
9705-2021_03_20_095505.jpg,lorry_truck,14,471,640,11,360,59,2,485,70,LTAdatasets/9705/annotate/9705-2021_03_20_095505.jpg,478.0,64.5,0.746875,0.17916666666666667,0.021875,0.030555555555555555
9705-2021_03_20_095505.jpg,bike,8,452,640,12,360,68,4,460,80,LTAdatasets/9705/annotate/9705-2021_03_20_095505.jpg,456.0,74.0,0.7125,0.20555555555555555,0.0125,0.03333333333333333
9705-2021_03_20_095505.jpg,bike,9,431,640,15,360,69,4,440,84,LTAdatasets/9705/annotate/9705-2021_03_20_095505.jpg,435.5,76.5,0.68046875,0.2125,0.0140625,0.041666666666666664
9705-2021_03_20_095505.jpg,lorry_truck,15,362,640,12,360,60,2,377,72,LTAdatasets/9705/annotate/9705-2021_03_20_095505.jpg,369.5,66.0,0.57734375,0.18333333333333332,0.0234375,0.03333333333333333
9705-2021_03_20_095505.jpg,car,11,440,640,9,360,58,1,451,67,LTAdatasets/9705/annotate/9705-2021_03_20_095505.jpg,445.5,62.5,0.69609375,0.1736111111111111,0.0171875,0.025
9705-2021_03_20_095505.jpg,van,12,459,640,10,360,52,3,471,62,LTAdatasets/9705/annotate/9705-2021_03_20_095505.jpg,465.0,57.0,0.7265625,0.15833333333333333,0.01875,0.027777777777777776
9705-2021_03_20_095505.jpg,car,7,474,640,8,360,48,1,481,56,LTAdatasets/9705/annotate/9705-2021_03_20_095505.jpg,477.5,52.0,0.74609375,0.14444444444444443,0.0109375,0.022222222222222223
9705-2021_03_20_093424.jpg,bus,33,287,640,16,360,75,5,320,91,LTAdatasets/9705/annotate/9705-2021_03_20_093424.jpg,303.5,83.0,0.47421875,0.23055555555555557,0.0515625,0.044444444444444446
9705-2021_03_20_093424.jpg,van,17,468,640,20,360,83,3,485,103,LTAdatasets/9705/annotate/9705-2021_03_20_093424.jpg,476.5,93.0,0.74453125,0.25833333333333336,0.0265625,0.05555555555555555
9705-2021_03_20_093424.jpg,van,12,366,640,9,360,69,3,378,78,LTAdatasets/9705/annotate/9705-2021_03_20_093424.jpg,372.0,73.5,0.58125,0.20416666666666666,0.01875,0.025
9705-2021_03_20_093424.jpg,lorry_truck,16,342,640,14,360,68,2,358,82,LTAdatasets/9705/annotate/9705-2021_03_20_093424.jpg,350.0,75.0,0.546875,0.20833333333333334,0.025,0.03888888888888889
9705-2021_03_20_093424.jpg,lorry_truck,18,471,640,20,360,46,2,489,66,LTAdatasets/9705/annotate/9705-2021_03_20_093424.jpg,480.0,56.0,0.75,0.15555555555555556,0.028125,0.05555555555555555
9705-2021_03_20_093424.jpg,lorry_truck,12,458,640,15,360,44,2,470,59,LTAdatasets/9705/annotate/9705-2021_03_20_093424.jpg,464.0,51.5,0.725,0.14305555555555555,0.01875,0.041666666666666664
9705-2021_03_20_093424.jpg,van,22,432,640,20,360,97,3,454,117,LTAdatasets/9705/annotate/9705-2021_03_20_093424.jpg,443.0,107.0,0.6921875,0.2972222222222222,0.034375,0.05555555555555555
9705-2021_03_20_093424.jpg,car,9,402,640,11,360,58,1,411,69,LTAdatasets/9705/annotate/9705-2021_03_20_093424.jpg,406.5,63.5,0.63515625,0.1763888888888889,0.0140625,0.030555555555555555
9705-2021_03_20_093424.jpg,car,7,385,640,8,360,55,1,392,63,LTAdatasets/9705/annotate/9705-2021_03_20_093424.jpg,388.5,59.0,0.60703125,0.1638888888888889,0.0109375,0.022222222222222223
9705-2021_03_20_093424.jpg,lorry_truck,11,406,640,13,360,39,2,417,52,LTAdatasets/9705/annotate/9705-2021_03_20_093424.jpg,411.5,45.5,0.64296875,0.12638888888888888,0.0171875,0.03611111111111111
9705-2021_03_20_092143.jpg,van,28,451,640,43,360,135,3,479,178,LTAdatasets/9705/annotate/9705-2021_03_20_092143.jpg,465.0,156.5,0.7265625,0.43472222222222223,0.04375,0.11944444444444445
9705-2021_03_20_092143.jpg,van,24,291,640,18,360,102,3,315,120,LTAdatasets/9705/annotate/9705-2021_03_20_092143.jpg,303.0,111.0,0.4734375,0.30833333333333335,0.0375,0.05
9705-2021_03_20_092143.jpg,car,12,456,640,9,360,52,1,468,61,LTAdatasets/9705/annotate/9705-2021_03_20_092143.jpg,462.0,56.5,0.721875,0.15694444444444444,0.01875,0.025
9705-2021_03_20_092143.jpg,car,12,405,640,12,360,54,1,417,66,LTAdatasets/9705/annotate/9705-2021_03_20_092143.jpg,411.0,60.0,0.6421875,0.16666666666666666,0.01875,0.03333333333333333
9705-2021_03_20_092143.jpg,car,41,161,640,19,360,170,1,202,189,LTAdatasets/9705/annotate/9705-2021_03_20_092143.jpg,181.5,179.5,0.28359375,0.4986111111111111,0.0640625,0.05277777777777778
9705-2021_03_20_092143.jpg,car,46,167,640,31,360,184,1,213,215,LTAdatasets/9705/annotate/9705-2021_03_20_092143.jpg,190.0,199.5,0.296875,0.5541666666666667,0.071875,0.08611111111111111
9705-2021_03_20_092143.jpg,car,12,372,640,11,360,76,1,384,87,LTAdatasets/9705/annotate/9705-2021_03_20_092143.jpg,378.0,81.5,0.590625,0.2263888888888889,0.01875,0.030555555555555555
9705-2021_03_20_092143.jpg,lorry_truck,22,331,640,15,360,72,2,353,87,LTAdatasets/9705/annotate/9705-2021_03_20_092143.jpg,342.0,79.5,0.534375,0.22083333333333333,0.034375,0.041666666666666664
9705-2021_03_20_092143.jpg,lorry_truck,16,378,640,15,360,55,2,394,70,LTAdatasets/9705/annotate/9705-2021_03_20_092143.jpg,386.0,62.5,0.603125,0.1736111111111111,0.025,0.041666666666666664
9705-2021_03_20_092143.jpg,car,17,282,640,9,360,87,1,299,96,LTAdatasets/9705/annotate/9705-2021_03_20_092143.jpg,290.5,91.5,0.45390625,0.25416666666666665,0.0265625,0.025
9705-2021_03_20_084301.jpg,car,16,335,640,10,360,86,1,351,96,LTAdatasets/9705/annotate/9705-2021_03_20_084301.jpg,343.0,91.0,0.5359375,0.25277777777777777,0.025,0.027777777777777776
9705-2021_03_20_084301.jpg,car,31,233,640,13,360,140,1,264,153,LTAdatasets/9705/annotate/9705-2021_03_20_084301.jpg,248.5,146.5,0.38828125,0.40694444444444444,0.0484375,0.03611111111111111
9705-2021_03_20_084301.jpg,car,15,220,640,11,360,120,1,235,131,LTAdatasets/9705/annotate/9705-2021_03_20_084301.jpg,227.5,125.5,0.35546875,0.3486111111111111,0.0234375,0.030555555555555555
9705-2021_03_20_084301.jpg,car,11,380,640,9,360,64,1,391,73,LTAdatasets/9705/annotate/9705-2021_03_20_084301.jpg,385.5,68.5,0.60234375,0.19027777777777777,0.0171875,0.025
9705-2021_03_20_084301.jpg,car,12,335,640,11,360,63,1,347,74,LTAdatasets/9705/annotate/9705-2021_03_20_084301.jpg,341.0,68.5,0.5328125,0.19027777777777777,0.01875,0.030555555555555555
9705-2021_03_20_084301.jpg,bike,7,459,640,10,360,59,4,466,69,LTAdatasets/9705/annotate/9705-2021_03_20_084301.jpg,462.5,64.0,0.72265625,0.17777777777777778,0.0109375,0.027777777777777776
9705-2021_03_20_084301.jpg,lorry_truck,17,361,640,18,360,55,2,378,73,LTAdatasets/9705/annotate/9705-2021_03_20_084301.jpg,369.5,64.0,0.57734375,0.17777777777777778,0.0265625,0.05
9705-2021_03_20_084301.jpg,lorry_truck,9,396,640,11,360,52,2,405,63,LTAdatasets/9705/annotate/9705-2021_03_20_084301.jpg,400.5,57.5,0.62578125,0.1597222222222222,0.0140625,0.030555555555555555
9705-2021_03_20_084301.jpg,lorry_truck,9,471,640,13,360,37,2,480,50,LTAdatasets/9705/annotate/9705-2021_03_20_084301.jpg,475.5,43.5,0.74296875,0.12083333333333333,0.0140625,0.03611111111111111
9705-2021_03_20_194616.jpg,van,29,448,640,39,360,144,3,477,183,LTAdatasets/9705/annotate/9705-2021_03_20_194616.jpg,462.5,163.5,0.72265625,0.45416666666666666,0.0453125,0.10833333333333334
9705-2021_03_20_194616.jpg,bus,26,296,640,21,360,71,5,322,92,LTAdatasets/9705/annotate/9705-2021_03_20_194616.jpg,309.0,81.5,0.4828125,0.2263888888888889,0.040625,0.058333333333333334
9705-2021_03_20_194616.jpg,car,17,454,640,14,360,82,1,471,96,LTAdatasets/9705/annotate/9705-2021_03_20_194616.jpg,462.5,89.0,0.72265625,0.24722222222222223,0.0265625,0.03888888888888889
9705-2021_03_20_194616.jpg,car,45,130,640,30,360,186,1,175,216,LTAdatasets/9705/annotate/9705-2021_03_20_194616.jpg,152.5,201.0,0.23828125,0.5583333333333333,0.0703125,0.08333333333333333
9705-2021_03_20_194616.jpg,car,12,403,640,9,360,60,1,415,69,LTAdatasets/9705/annotate/9705-2021_03_20_194616.jpg,409.0,64.5,0.6390625,0.17916666666666667,0.01875,0.025
9705-2021_03_20_194616.jpg,bike,15,287,640,10,360,89,4,302,99,LTAdatasets/9705/annotate/9705-2021_03_20_194616.jpg,294.5,94.0,0.46015625,0.2611111111111111,0.0234375,0.027777777777777776
9705-2021_03_20_194616.jpg,lorry_truck,12,387,640,11,360,50,2,399,61,LTAdatasets/9705/annotate/9705-2021_03_20_194616.jpg,393.0,55.5,0.6140625,0.15416666666666667,0.01875,0.030555555555555555
9705-2021_03_20_185153.jpg,lorry_truck,81,388,640,126,360,166,2,469,292,LTAdatasets/9705/annotate/9705-2021_03_20_185153.jpg,428.5,229.0,0.66953125,0.6361111111111111,0.1265625,0.35
9705-2021_03_20_185153.jpg,lorry_truck,17,470,640,22,360,76,2,487,98,LTAdatasets/9705/annotate/9705-2021_03_20_185153.jpg,478.5,87.0,0.74765625,0.24166666666666667,0.0265625,0.06111111111111111
9705-2021_03_20_185153.jpg,lorry_truck,15,448,640,20,360,70,2,463,90,LTAdatasets/9705/annotate/9705-2021_03_20_185153.jpg,455.5,80.0,0.71171875,0.2222222222222222,0.0234375,0.05555555555555555
9705-2021_03_20_185153.jpg,car,17,418,640,12,360,84,1,435,96,LTAdatasets/9705/annotate/9705-2021_03_20_185153.jpg,426.5,90.0,0.66640625,0.25,0.0265625,0.03333333333333333
9705-2021_03_20_185153.jpg,car,10,476,640,14,360,64,1,486,78,LTAdatasets/9705/annotate/9705-2021_03_20_185153.jpg,481.0,71.0,0.7515625,0.19722222222222222,0.015625,0.03888888888888889
9705-2021_03_20_185153.jpg,car,12,470,640,10,360,55,1,482,65,LTAdatasets/9705/annotate/9705-2021_03_20_185153.jpg,476.0,60.0,0.74375,0.16666666666666666,0.01875,0.027777777777777776
9705-2021_03_20_185153.jpg,lorry_truck,26,310,640,20,360,81,2,336,101,LTAdatasets/9705/annotate/9705-2021_03_20_185153.jpg,323.0,91.0,0.5046875,0.25277777777777777,0.040625,0.05555555555555555
9705-2021_03_20_185153.jpg,car,12,378,640,12,360,61,1,390,73,LTAdatasets/9705/annotate/9705-2021_03_20_185153.jpg,384.0,67.0,0.6,0.18611111111111112,0.01875,0.03333333333333333
9705-2021_03_20_185153.jpg,car,11,284,640,8,360,92,1,295,100,LTAdatasets/9705/annotate/9705-2021_03_20_185153.jpg,289.5,96.0,0.45234375,0.26666666666666666,0.0171875,0.022222222222222223
9705-2021_03_20_185153.jpg,car,14,322,640,12,360,68,1,336,80,LTAdatasets/9705/annotate/9705-2021_03_20_185153.jpg,329.0,74.0,0.5140625,0.20555555555555555,0.021875,0.03333333333333333
9705-2021_03_20_181011.jpg,car,28,424,640,34,360,135,1,452,169,LTAdatasets/9705/annotate/9705-2021_03_20_181011.jpg,438.0,152.0,0.684375,0.4222222222222222,0.04375,0.09444444444444444
9705-2021_03_20_181011.jpg,car,33,249,640,20,360,144,1,282,164,LTAdatasets/9705/annotate/9705-2021_03_20_181011.jpg,265.5,154.0,0.41484375,0.42777777777777776,0.0515625,0.05555555555555555
9705-2021_03_20_181011.jpg,car,35,174,640,22,360,164,1,209,186,LTAdatasets/9705/annotate/9705-2021_03_20_181011.jpg,191.5,175.0,0.29921875,0.4861111111111111,0.0546875,0.06111111111111111
9705-2021_03_20_181011.jpg,car,53,131,640,27,360,212,1,184,239,LTAdatasets/9705/annotate/9705-2021_03_20_181011.jpg,157.5,225.5,0.24609375,0.6263888888888889,0.0828125,0.075
9705-2021_03_20_181011.jpg,car,59,23,640,29,360,244,1,82,273,LTAdatasets/9705/annotate/9705-2021_03_20_181011.jpg,52.5,258.5,0.08203125,0.7180555555555556,0.0921875,0.08055555555555556
9705-2021_03_20_181011.jpg,car,26,273,640,16,360,120,1,299,136,LTAdatasets/9705/annotate/9705-2021_03_20_181011.jpg,286.0,128.0,0.446875,0.35555555555555557,0.040625,0.044444444444444446
9705-2021_03_20_181011.jpg,car,19,346,640,13,360,94,1,365,107,LTAdatasets/9705/annotate/9705-2021_03_20_181011.jpg,355.5,100.5,0.55546875,0.2791666666666667,0.0296875,0.03611111111111111
9705-2021_03_20_181011.jpg,car,16,419,640,15,360,88,1,435,103,LTAdatasets/9705/annotate/9705-2021_03_20_181011.jpg,427.0,95.5,0.6671875,0.2652777777777778,0.025,0.041666666666666664
9705-2021_03_20_181011.jpg,lorry_truck,26,229,640,22,360,122,2,255,144,LTAdatasets/9705/annotate/9705-2021_03_20_181011.jpg,242.0,133.0,0.378125,0.36944444444444446,0.040625,0.06111111111111111
9705-2021_03_20_181011.jpg,van,19,350,640,11,360,78,3,369,89,LTAdatasets/9705/annotate/9705-2021_03_20_181011.jpg,359.5,83.5,0.56171875,0.23194444444444445,0.0296875,0.030555555555555555
9705-2021_03_20_181011.jpg,car,12,297,640,9,360,83,1,309,92,LTAdatasets/9705/annotate/9705-2021_03_20_181011.jpg,303.0,87.5,0.4734375,0.24305555555555555,0.01875,0.025
9705-2021_03_20_181011.jpg,car,15,383,640,15,360,71,1,398,86,LTAdatasets/9705/annotate/9705-2021_03_20_181011.jpg,390.5,78.5,0.61015625,0.21805555555555556,0.0234375,0.041666666666666664
9705-2021_03_20_181011.jpg,car,12,363,640,9,360,65,1,375,74,LTAdatasets/9705/annotate/9705-2021_03_20_181011.jpg,369.0,69.5,0.5765625,0.19305555555555556,0.01875,0.025
9705-2021_03_20_181011.jpg,car,9,404,640,10,360,58,1,413,68,LTAdatasets/9705/annotate/9705-2021_03_20_181011.jpg,408.5,63.0,0.63828125,0.175,0.0140625,0.027777777777777776
9705-2021_03_20_181011.jpg,lorry_truck,14,382,640,10,360,52,2,396,62,LTAdatasets/9705/annotate/9705-2021_03_20_181011.jpg,389.0,57.0,0.6078125,0.15833333333333333,0.021875,0.027777777777777776
9705-2021_03_20_181011.jpg,lorry_truck,16,394,640,19,360,45,2,410,64,LTAdatasets/9705/annotate/9705-2021_03_20_181011.jpg,402.0,54.5,0.628125,0.15138888888888888,0.025,0.05277777777777778
9705-2021_03_20_081539.jpg,lorry_truck,25,442,640,47,360,112,2,467,159,LTAdatasets/9705/annotate/9705-2021_03_20_081539.jpg,454.5,135.5,0.71015625,0.3763888888888889,0.0390625,0.13055555555555556
9705-2021_03_20_081539.jpg,car,14,450,640,12,360,73,1,464,85,LTAdatasets/9705/annotate/9705-2021_03_20_081539.jpg,457.0,79.0,0.7140625,0.21944444444444444,0.021875,0.03333333333333333
9705-2021_03_20_081539.jpg,car,28,243,640,16,360,136,1,271,152,LTAdatasets/9705/annotate/9705-2021_03_20_081539.jpg,257.0,144.0,0.4015625,0.4,0.04375,0.044444444444444446
9705-2021_03_20_081539.jpg,car,11,461,640,11,360,48,1,472,59,LTAdatasets/9705/annotate/9705-2021_03_20_081539.jpg,466.5,53.5,0.72890625,0.1486111111111111,0.0171875,0.030555555555555555
9705-2021_03_20_081539.jpg,car,10,332,640,9,360,61,1,342,70,LTAdatasets/9705/annotate/9705-2021_03_20_081539.jpg,337.0,65.5,0.5265625,0.18194444444444444,0.015625,0.025
9705-2021_03_20_081539.jpg,car,8,412,640,8,360,45,1,420,53,LTAdatasets/9705/annotate/9705-2021_03_20_081539.jpg,416.0,49.0,0.65,0.1361111111111111,0.0125,0.022222222222222223
9705-2021_03_20_081539.jpg,car,14,391,640,12,360,45,1,405,57,LTAdatasets/9705/annotate/9705-2021_03_20_081539.jpg,398.0,51.0,0.621875,0.14166666666666666,0.021875,0.03333333333333333
9705-2021_03_20_081539.jpg,lorry_truck,33,193,640,20,360,119,2,226,139,LTAdatasets/9705/annotate/9705-2021_03_20_081539.jpg,209.5,129.0,0.32734375,0.35833333333333334,0.0515625,0.05555555555555555
9705-2021_03_20_203358.jpg,car,25,464,640,26,360,118,1,489,144,LTAdatasets/9705/annotate/9705-2021_03_20_203358.jpg,476.5,131.0,0.74453125,0.3638888888888889,0.0390625,0.07222222222222222
9705-2021_03_20_203358.jpg,van,39,178,640,26,360,144,3,217,170,LTAdatasets/9705/annotate/9705-2021_03_20_203358.jpg,197.5,157.0,0.30859375,0.4361111111111111,0.0609375,0.07222222222222222
9705-2021_03_20_203358.jpg,bike,26,361,640,61,360,299,4,387,360,LTAdatasets/9705/annotate/9705-2021_03_20_203358.jpg,374.0,329.5,0.584375,0.9152777777777777,0.040625,0.16944444444444445
9705-2021_03_20_203358.jpg,car,19,278,640,14,360,91,1,297,105,LTAdatasets/9705/annotate/9705-2021_03_20_203358.jpg,287.5,98.0,0.44921875,0.2722222222222222,0.0296875,0.03888888888888889
9705-2021_03_20_203358.jpg,car,13,475,640,12,360,61,1,488,73,LTAdatasets/9705/annotate/9705-2021_03_20_203358.jpg,481.5,67.0,0.75234375,0.18611111111111112,0.0203125,0.03333333333333333
9705-2021_03_20_203358.jpg,car,13,318,640,11,360,71,1,331,82,LTAdatasets/9705/annotate/9705-2021_03_20_203358.jpg,324.5,76.5,0.50703125,0.2125,0.0203125,0.030555555555555555
9705-2021_03_20_203358.jpg,car,10,337,640,10,360,58,1,347,68,LTAdatasets/9705/annotate/9705-2021_03_20_203358.jpg,342.0,63.0,0.534375,0.175,0.015625,0.027777777777777776
9705-2021_03_20_191614.jpg,van,36,380,640,42,360,151,3,416,193,LTAdatasets/9705/annotate/9705-2021_03_20_191614.jpg,398.0,172.0,0.621875,0.4777777777777778,0.05625,0.11666666666666667
9705-2021_03_20_191614.jpg,bike,7,442,640,14,360,63,4,449,77,LTAdatasets/9705/annotate/9705-2021_03_20_191614.jpg,445.5,70.0,0.69609375,0.19444444444444445,0.0109375,0.03888888888888889
9705-2021_03_20_191614.jpg,lorry_truck,24,469,640,35,360,67,2,493,102,LTAdatasets/9705/annotate/9705-2021_03_20_191614.jpg,481.0,84.5,0.7515625,0.23472222222222222,0.0375,0.09722222222222222
9705-2021_03_20_191614.jpg,lorry_truck,78,370,640,132,360,211,2,448,343,LTAdatasets/9705/annotate/9705-2021_03_20_191614.jpg,409.0,277.0,0.6390625,0.7694444444444445,0.121875,0.36666666666666664
9705-2021_03_20_191614.jpg,lorry_truck,19,263,640,24,360,101,2,282,125,LTAdatasets/9705/annotate/9705-2021_03_20_191614.jpg,272.5,113.0,0.42578125,0.3138888888888889,0.0296875,0.06666666666666667
9705-2021_03_20_191614.jpg,car,10,316,640,8,360,72,1,326,80,LTAdatasets/9705/annotate/9705-2021_03_20_191614.jpg,321.0,76.0,0.5015625,0.2111111111111111,0.015625,0.022222222222222223
9705-2021_03_20_191614.jpg,car,17,440,640,16,360,87,1,457,103,LTAdatasets/9705/annotate/9705-2021_03_20_191614.jpg,448.5,95.0,0.70078125,0.2638888888888889,0.0265625,0.044444444444444446
9705-2021_03_20_191614.jpg,car,19,393,640,17,360,108,1,412,125,LTAdatasets/9705/annotate/9705-2021_03_20_191614.jpg,402.5,116.5,0.62890625,0.3236111111111111,0.0296875,0.04722222222222222
9705-2021_03_20_191614.jpg,car,23,193,640,14,360,134,1,216,148,LTAdatasets/9705/annotate/9705-2021_03_20_191614.jpg,204.5,141.0,0.31953125,0.39166666666666666,0.0359375,0.03888888888888889
9705-2021_03_20_191614.jpg,car,39,0,640,29,360,223,1,39,252,LTAdatasets/9705/annotate/9705-2021_03_20_191614.jpg,19.5,237.5,0.03046875,0.6597222222222222,0.0609375,0.08055555555555556
9705-2021_03_20_191614.jpg,van,19,275,640,11,360,88,3,294,99,LTAdatasets/9705/annotate/9705-2021_03_20_191614.jpg,284.5,93.5,0.44453125,0.25972222222222224,0.0296875,0.030555555555555555
9705-2021_03_20_191614.jpg,car,11,461,640,10,360,54,1,472,64,LTAdatasets/9705/annotate/9705-2021_03_20_191614.jpg,466.5,59.0,0.72890625,0.1638888888888889,0.0171875,0.027777777777777776
9705-2021_03_20_084001.jpg,car,54,354,640,64,360,203,1,408,267,LTAdatasets/9705/annotate/9705-2021_03_20_084001.jpg,381.0,235.0,0.5953125,0.6527777777777778,0.084375,0.17777777777777778
9705-2021_03_20_084001.jpg,car,21,369,640,23,360,136,1,390,159,LTAdatasets/9705/annotate/9705-2021_03_20_084001.jpg,379.5,147.5,0.59296875,0.4097222222222222,0.0328125,0.06388888888888888
9705-2021_03_20_084001.jpg,car,22,263,640,19,360,138,1,285,157,LTAdatasets/9705/annotate/9705-2021_03_20_084001.jpg,274.0,147.5,0.428125,0.4097222222222222,0.034375,0.05277777777777778
9705-2021_03_20_084001.jpg,lorry_truck,36,202,640,25,360,144,2,238,169,LTAdatasets/9705/annotate/9705-2021_03_20_084001.jpg,220.0,156.5,0.34375,0.43472222222222223,0.05625,0.06944444444444445
9705-2021_03_20_084001.jpg,lorry_truck,19,319,640,21,360,76,2,338,97,LTAdatasets/9705/annotate/9705-2021_03_20_084001.jpg,328.5,86.5,0.51328125,0.24027777777777778,0.0296875,0.058333333333333334
9705-2021_03_20_084001.jpg,lorry_truck,14,360,640,17,360,67,2,374,84,LTAdatasets/9705/annotate/9705-2021_03_20_084001.jpg,367.0,75.5,0.5734375,0.20972222222222223,0.021875,0.04722222222222222
9705-2021_03_20_084001.jpg,car,12,361,640,10,360,88,1,373,98,LTAdatasets/9705/annotate/9705-2021_03_20_084001.jpg,367.0,93.0,0.5734375,0.25833333333333336,0.01875,0.027777777777777776
9705-2021_03_20_084001.jpg,car,12,382,640,11,360,72,1,394,83,LTAdatasets/9705/annotate/9705-2021_03_20_084001.jpg,388.0,77.5,0.60625,0.2152777777777778,0.01875,0.030555555555555555
9705-2021_03_20_084001.jpg,car,8,461,640,8,360,54,1,469,62,LTAdatasets/9705/annotate/9705-2021_03_20_084001.jpg,465.0,58.0,0.7265625,0.16111111111111112,0.0125,0.022222222222222223
9705-2021_03_20_084001.jpg,lorry_truck,16,367,640,14,360,52,2,383,66,LTAdatasets/9705/annotate/9705-2021_03_20_084001.jpg,375.0,59.0,0.5859375,0.1638888888888889,0.025,0.03888888888888889
9705-2021_03_20_084001.jpg,lorry_truck,9,388,640,9,360,49,2,397,58,LTAdatasets/9705/annotate/9705-2021_03_20_084001.jpg,392.5,53.5,0.61328125,0.1486111111111111,0.0140625,0.025
9705-2021_03_20_084001.jpg,lorry_truck,11,471,640,12,360,39,2,482,51,LTAdatasets/9705/annotate/9705-2021_03_20_084001.jpg,476.5,45.0,0.74453125,0.125,0.0171875,0.03333333333333333
9705-2021_03_20_084001.jpg,lorry_truck,7,404,640,9,360,45,2,411,54,LTAdatasets/9705/annotate/9705-2021_03_20_084001.jpg,407.5,49.5,0.63671875,0.1375,0.0109375,0.025
9705-2021_03_20_084001.jpg,car,9,330,640,8,360,65,1,339,73,LTAdatasets/9705/annotate/9705-2021_03_20_084001.jpg,334.5,69.0,0.52265625,0.19166666666666668,0.0140625,0.022222222222222223
9705-2021_03_20_084001.jpg,car,8,416,640,10,360,47,1,424,57,LTAdatasets/9705/annotate/9705-2021_03_20_084001.jpg,420.0,52.0,0.65625,0.14444444444444443,0.0125,0.027777777777777776
9705-2021_03_20_201317.jpg,car,14,466,640,18,360,101,1,480,119,LTAdatasets/9705/annotate/9705-2021_03_20_201317.jpg,473.0,110.0,0.7390625,0.3055555555555556,0.021875,0.05
9705-2021_03_20_201317.jpg,car,17,433,640,14,360,101,1,450,115,LTAdatasets/9705/annotate/9705-2021_03_20_201317.jpg,441.5,108.0,0.68984375,0.3,0.0265625,0.03888888888888889
9705-2021_03_20_201317.jpg,car,15,403,640,18,360,98,1,418,116,LTAdatasets/9705/annotate/9705-2021_03_20_201317.jpg,410.5,107.0,0.64140625,0.2972222222222222,0.0234375,0.05
9705-2021_03_20_201317.jpg,car,17,425,640,10,360,79,1,442,89,LTAdatasets/9705/annotate/9705-2021_03_20_201317.jpg,433.5,84.0,0.67734375,0.23333333333333334,0.0265625,0.027777777777777776
9705-2021_03_20_201317.jpg,car,17,468,640,14,360,72,1,485,86,LTAdatasets/9705/annotate/9705-2021_03_20_201317.jpg,476.5,79.0,0.74453125,0.21944444444444444,0.0265625,0.03888888888888889
9705-2021_03_20_201317.jpg,car,13,436,640,12,360,66,1,449,78,LTAdatasets/9705/annotate/9705-2021_03_20_201317.jpg,442.5,72.0,0.69140625,0.2,0.0203125,0.03333333333333333
9705-2021_03_20_201317.jpg,car,9,377,640,10,360,67,1,386,77,LTAdatasets/9705/annotate/9705-2021_03_20_201317.jpg,381.5,72.0,0.59609375,0.2,0.0140625,0.027777777777777776
9705-2021_03_20_201317.jpg,car,10,334,640,8,360,65,1,344,73,LTAdatasets/9705/annotate/9705-2021_03_20_201317.jpg,339.0,69.0,0.5296875,0.19166666666666668,0.015625,0.022222222222222223
9705-2021_03_20_201317.jpg,car,11,457,640,8,360,66,1,468,74,LTAdatasets/9705/annotate/9705-2021_03_20_201317.jpg,462.5,70.0,0.72265625,0.19444444444444445,0.0171875,0.022222222222222223
9705-2021_03_20_201317.jpg,car,11,396,640,8,360,55,1,407,63,LTAdatasets/9705/annotate/9705-2021_03_20_201317.jpg,401.5,59.0,0.62734375,0.1638888888888889,0.0171875,0.022222222222222223
9705-2021_03_20_201317.jpg,car,10,475,640,7,360,55,1,485,62,LTAdatasets/9705/annotate/9705-2021_03_20_201317.jpg,480.0,58.5,0.75,0.1625,0.015625,0.019444444444444445
9705-2021_03_20_201317.jpg,car,10,458,640,8,360,53,1,468,61,LTAdatasets/9705/annotate/9705-2021_03_20_201317.jpg,463.0,57.0,0.7234375,0.15833333333333333,0.015625,0.022222222222222223
9705-2021_03_20_201317.jpg,lorry_truck,37,156,640,37,360,151,2,193,188,LTAdatasets/9705/annotate/9705-2021_03_20_201317.jpg,174.5,169.5,0.27265625,0.4708333333333333,0.0578125,0.10277777777777777
9705-2021_03_20_073937.jpg,bike,15,373,640,34,360,195,4,388,229,LTAdatasets/9705/annotate/9705-2021_03_20_073937.jpg,380.5,212.0,0.59453125,0.5888888888888889,0.0234375,0.09444444444444444
9705-2021_03_20_073937.jpg,bus,34,277,640,19,360,79,5,311,98,LTAdatasets/9705/annotate/9705-2021_03_20_073937.jpg,294.0,88.5,0.459375,0.24583333333333332,0.053125,0.05277777777777778
9705-2021_03_20_073937.jpg,lorry_truck,79,361,640,85,360,275,2,440,360,LTAdatasets/9705/annotate/9705-2021_03_20_073937.jpg,400.5,317.5,0.62578125,0.8819444444444444,0.1234375,0.2361111111111111
9705-2021_03_20_073937.jpg,lorry_truck,17,470,640,22,360,75,2,487,97,LTAdatasets/9705/annotate/9705-2021_03_20_073937.jpg,478.5,86.0,0.74765625,0.2388888888888889,0.0265625,0.06111111111111111
9705-2021_03_20_073937.jpg,lorry_truck,31,282,640,23,360,100,2,313,123,LTAdatasets/9705/annotate/9705-2021_03_20_073937.jpg,297.5,111.5,0.46484375,0.30972222222222223,0.0484375,0.06388888888888888
9705-2021_03_20_073937.jpg,lorry_truck,33,175,640,24,360,148,2,208,172,LTAdatasets/9705/annotate/9705-2021_03_20_073937.jpg,191.5,160.0,0.29921875,0.4444444444444444,0.0515625,0.06666666666666667
9705-2021_03_20_073937.jpg,car,39,138,640,20,360,188,1,177,208,LTAdatasets/9705/annotate/9705-2021_03_20_073937.jpg,157.5,198.0,0.24609375,0.55,0.0609375,0.05555555555555555
9705-2021_03_20_073937.jpg,car,14,384,640,11,360,65,1,398,76,LTAdatasets/9705/annotate/9705-2021_03_20_073937.jpg,391.0,70.5,0.6109375,0.19583333333333333,0.021875,0.030555555555555555
9705-2021_03_20_073937.jpg,lorry_truck,14,471,640,9,360,64,2,485,73,LTAdatasets/9705/annotate/9705-2021_03_20_073937.jpg,478.0,68.5,0.746875,0.19027777777777777,0.021875,0.025
9705-2021_03_20_073937.jpg,lorry_truck,12,474,640,15,360,47,2,486,62,LTAdatasets/9705/annotate/9705-2021_03_20_073937.jpg,480.0,54.5,0.75,0.15138888888888888,0.01875,0.041666666666666664
9705-2021_03_20_073937.jpg,van,10,459,640,10,360,53,3,469,63,LTAdatasets/9705/annotate/9705-2021_03_20_073937.jpg,464.0,58.0,0.725,0.16111111111111112,0.015625,0.027777777777777776
9705-2021_03_20_073937.jpg,car,10,390,640,11,360,57,1,400,68,LTAdatasets/9705/annotate/9705-2021_03_20_073937.jpg,395.0,62.5,0.6171875,0.1736111111111111,0.015625,0.030555555555555555
9705-2021_03_20_183712.jpg,bike,15,245,640,23,360,144,4,260,167,LTAdatasets/9705/annotate/9705-2021_03_20_183712.jpg,252.5,155.5,0.39453125,0.43194444444444446,0.0234375,0.06388888888888888
9705-2021_03_20_183712.jpg,car,39,137,640,21,360,189,1,176,210,LTAdatasets/9705/annotate/9705-2021_03_20_183712.jpg,156.5,199.5,0.24453125,0.5541666666666667,0.0609375,0.058333333333333334
9705-2021_03_20_183712.jpg,car,12,318,640,9,360,70,1,330,79,LTAdatasets/9705/annotate/9705-2021_03_20_183712.jpg,324.0,74.5,0.50625,0.20694444444444443,0.01875,0.025
9705-2021_03_20_183712.jpg,car,33,0,640,21,360,221,1,33,242,LTAdatasets/9705/annotate/9705-2021_03_20_183712.jpg,16.5,231.5,0.02578125,0.6430555555555556,0.0515625,0.058333333333333334
9705-2021_03_20_183712.jpg,car,13,361,640,9,360,77,1,374,86,LTAdatasets/9705/annotate/9705-2021_03_20_183712.jpg,367.5,81.5,0.57421875,0.2263888888888889,0.0203125,0.025
9705-2021_03_20_183712.jpg,lorry_truck,20,338,640,15,360,72,2,358,87,LTAdatasets/9705/annotate/9705-2021_03_20_183712.jpg,348.0,79.5,0.54375,0.22083333333333333,0.03125,0.041666666666666664
9705-2021_03_20_183712.jpg,car,14,460,640,9,360,50,1,474,59,LTAdatasets/9705/annotate/9705-2021_03_20_183712.jpg,467.0,54.5,0.7296875,0.15138888888888888,0.021875,0.025
9705-2021_03_20_183712.jpg,car,10,336,640,9,360,59,1,346,68,LTAdatasets/9705/annotate/9705-2021_03_20_183712.jpg,341.0,63.5,0.5328125,0.1763888888888889,0.015625,0.025
9705-2021_03_20_091302.jpg,lorry_truck,26,459,640,41,360,122,2,485,163,LTAdatasets/9705/annotate/9705-2021_03_20_091302.jpg,472.0,142.5,0.7375,0.3958333333333333,0.040625,0.11388888888888889
9705-2021_03_20_091302.jpg,lorry_truck,21,465,640,37,360,73,2,486,110,LTAdatasets/9705/annotate/9705-2021_03_20_091302.jpg,475.5,91.5,0.74296875,0.25416666666666665,0.0328125,0.10277777777777777
9705-2021_03_20_091302.jpg,lorry_truck,46,202,640,30,360,115,2,248,145,LTAdatasets/9705/annotate/9705-2021_03_20_091302.jpg,225.0,130.0,0.3515625,0.3611111111111111,0.071875,0.08333333333333333
9705-2021_03_20_091302.jpg,lorry_truck,14,344,640,17,360,68,2,358,85,LTAdatasets/9705/annotate/9705-2021_03_20_091302.jpg,351.0,76.5,0.5484375,0.2125,0.021875,0.04722222222222222
9705-2021_03_20_091302.jpg,car,62,255,640,56,360,304,1,317,360,LTAdatasets/9705/annotate/9705-2021_03_20_091302.jpg,286.0,332.0,0.446875,0.9222222222222223,0.096875,0.15555555555555556
9705-2021_03_20_091302.jpg,car,32,394,640,36,360,177,1,426,213,LTAdatasets/9705/annotate/9705-2021_03_20_091302.jpg,410.0,195.0,0.640625,0.5416666666666666,0.05,0.1
9705-2021_03_20_091302.jpg,car,44,101,640,24,360,205,1,145,229,LTAdatasets/9705/annotate/9705-2021_03_20_091302.jpg,123.0,217.0,0.1921875,0.6027777777777777,0.06875,0.06666666666666667
9705-2021_03_20_091302.jpg,car,11,365,640,12,360,69,1,376,81,LTAdatasets/9705/annotate/9705-2021_03_20_091302.jpg,370.5,75.0,0.57890625,0.20833333333333334,0.0171875,0.03333333333333333
9705-2021_03_20_091302.jpg,car,12,370,640,9,360,62,1,382,71,LTAdatasets/9705/annotate/9705-2021_03_20_091302.jpg,376.0,66.5,0.5875,0.18472222222222223,0.01875,0.025
9705-2021_03_20_091302.jpg,bike,10,453,640,10,360,58,4,463,68,LTAdatasets/9705/annotate/9705-2021_03_20_091302.jpg,458.0,63.0,0.715625,0.175,0.015625,0.027777777777777776
9705-2021_03_20_091302.jpg,van,11,473,640,12,360,61,3,484,73,LTAdatasets/9705/annotate/9705-2021_03_20_091302.jpg,478.5,67.0,0.74765625,0.18611111111111112,0.0171875,0.03333333333333333
9705-2021_03_20_091302.jpg,van,23,322,640,20,360,85,3,345,105,LTAdatasets/9705/annotate/9705-2021_03_20_091302.jpg,333.5,95.0,0.52109375,0.2638888888888889,0.0359375,0.05555555555555555
9705-2021_03_20_200116.jpg,car,12,475,640,18,360,74,1,487,92,LTAdatasets/9705/annotate/9705-2021_03_20_200116.jpg,481.0,83.0,0.7515625,0.23055555555555557,0.01875,0.05
9705-2021_03_20_200116.jpg,lorry_truck,45,182,640,17,360,127,2,227,144,LTAdatasets/9705/annotate/9705-2021_03_20_200116.jpg,204.5,135.5,0.31953125,0.3763888888888889,0.0703125,0.04722222222222222
9705-2021_03_20_200116.jpg,car,14,476,640,13,360,54,1,490,67,LTAdatasets/9705/annotate/9705-2021_03_20_200116.jpg,483.0,60.5,0.7546875,0.16805555555555557,0.021875,0.03611111111111111
9705-2021_03_20_200116.jpg,car,11,459,640,12,360,56,1,470,68,LTAdatasets/9705/annotate/9705-2021_03_20_200116.jpg,464.5,62.0,0.72578125,0.17222222222222222,0.0171875,0.03333333333333333
9705-2021_03_20_200116.jpg,car,10,445,640,11,360,55,1,455,66,LTAdatasets/9705/annotate/9705-2021_03_20_200116.jpg,450.0,60.5,0.703125,0.16805555555555557,0.015625,0.030555555555555555
9705-2021_03_20_200116.jpg,car,13,319,640,8,360,72,1,332,80,LTAdatasets/9705/annotate/9705-2021_03_20_200116.jpg,325.5,76.0,0.50859375,0.2111111111111111,0.0203125,0.022222222222222223
9705-2021_03_20_195736.jpg,bike,17,373,640,30,360,177,4,390,207,LTAdatasets/9705/annotate/9705-2021_03_20_195736.jpg,381.5,192.0,0.59609375,0.5333333333333333,0.0265625,0.08333333333333333
9705-2021_03_20_195736.jpg,bike,11,454,640,16,360,92,4,465,108,LTAdatasets/9705/annotate/9705-2021_03_20_195736.jpg,459.5,100.0,0.71796875,0.2777777777777778,0.0171875,0.044444444444444446
9705-2021_03_20_195736.jpg,car,28,379,640,29,360,114,1,407,143,LTAdatasets/9705/annotate/9705-2021_03_20_195736.jpg,393.0,128.5,0.6140625,0.35694444444444445,0.04375,0.08055555555555556
9705-2021_03_20_195736.jpg,car,63,34,640,28,360,262,1,97,290,LTAdatasets/9705/annotate/9705-2021_03_20_195736.jpg,65.5,276.0,0.10234375,0.7666666666666667,0.0984375,0.07777777777777778
9705-2021_03_20_195736.jpg,car,25,0,640,21,360,232,1,25,253,LTAdatasets/9705/annotate/9705-2021_03_20_195736.jpg,12.5,242.5,0.01953125,0.6736111111111112,0.0390625,0.058333333333333334
9705-2021_03_20_195736.jpg,car,10,439,640,11,360,59,1,449,70,LTAdatasets/9705/annotate/9705-2021_03_20_195736.jpg,444.0,64.5,0.69375,0.17916666666666667,0.015625,0.030555555555555555
9705-2021_03_20_195736.jpg,car,7,461,640,8,360,59,1,468,67,LTAdatasets/9705/annotate/9705-2021_03_20_195736.jpg,464.5,63.0,0.72578125,0.175,0.0109375,0.022222222222222223
9705-2021_03_20_195736.jpg,car,12,472,640,10,360,52,1,484,62,LTAdatasets/9705/annotate/9705-2021_03_20_195736.jpg,478.0,57.0,0.746875,0.15833333333333333,0.01875,0.027777777777777776
9705-2021_03_20_195736.jpg,car,15,392,640,8,360,67,1,407,75,LTAdatasets/9705/annotate/9705-2021_03_20_195736.jpg,399.5,71.0,0.62421875,0.19722222222222222,0.0234375,0.022222222222222223
9705-2021_03_20_195736.jpg,lorry_truck,23,341,640,17,360,66,2,364,83,LTAdatasets/9705/annotate/9705-2021_03_20_195736.jpg,352.5,74.5,0.55078125,0.20694444444444443,0.0359375,0.04722222222222222
9705-2021_03_20_195736.jpg,bus,15,393,640,15,360,50,5,408,65,LTAdatasets/9705/annotate/9705-2021_03_20_195736.jpg,400.5,57.5,0.62578125,0.1597222222222222,0.0234375,0.041666666666666664
9705-2021_03_20_195736.jpg,car,18,291,640,11,360,86,1,309,97,LTAdatasets/9705/annotate/9705-2021_03_20_195736.jpg,300.0,91.5,0.46875,0.25416666666666665,0.028125,0.030555555555555555
9705-2021_03_20_080119.jpg,car,46,124,640,24,360,193,1,170,217,LTAdatasets/9705/annotate/9705-2021_03_20_080119.jpg,147.0,205.0,0.2296875,0.5694444444444444,0.071875,0.06666666666666667
9705-2021_03_20_080119.jpg,car,26,403,640,24,360,128,1,429,152,LTAdatasets/9705/annotate/9705-2021_03_20_080119.jpg,416.0,140.0,0.65,0.3888888888888889,0.040625,0.06666666666666667
9705-2021_03_20_080119.jpg,lorry_truck,22,332,640,16,360,82,2,354,98,LTAdatasets/9705/annotate/9705-2021_03_20_080119.jpg,343.0,90.0,0.5359375,0.25,0.034375,0.044444444444444446
9705-2021_03_20_080119.jpg,lorry_truck,26,335,640,18,360,65,2,361,83,LTAdatasets/9705/annotate/9705-2021_03_20_080119.jpg,348.0,74.0,0.54375,0.20555555555555555,0.040625,0.05
9705-2021_03_20_080119.jpg,car,13,455,640,10,360,63,1,468,73,LTAdatasets/9705/annotate/9705-2021_03_20_080119.jpg,461.5,68.0,0.72109375,0.18888888888888888,0.0203125,0.027777777777777776
9705-2021_03_20_080119.jpg,car,9,472,640,8,360,52,1,481,60,LTAdatasets/9705/annotate/9705-2021_03_20_080119.jpg,476.5,56.0,0.74453125,0.15555555555555556,0.0140625,0.022222222222222223
9705-2021_03_20_080119.jpg,car,8,405,640,7,360,51,1,413,58,LTAdatasets/9705/annotate/9705-2021_03_20_080119.jpg,409.0,54.5,0.6390625,0.15138888888888888,0.0125,0.019444444444444445
9705-2021_03_20_080119.jpg,car,13,309,640,12,360,74,1,322,86,LTAdatasets/9705/annotate/9705-2021_03_20_080119.jpg,315.5,80.0,0.49296875,0.2222222222222222,0.0203125,0.03333333333333333
9705-2021_03_20_080119.jpg,bike,7,387,640,10,360,58,4,394,68,LTAdatasets/9705/annotate/9705-2021_03_20_080119.jpg,390.5,63.0,0.61015625,0.175,0.0109375,0.027777777777777776
9705-2021_03_20_075818.jpg,car,23,417,640,21,360,118,1,440,139,LTAdatasets/9705/annotate/9705-2021_03_20_075818.jpg,428.5,128.5,0.66953125,0.35694444444444445,0.0359375,0.058333333333333334
9705-2021_03_20_075818.jpg,car,37,135,640,24,360,186,1,172,210,LTAdatasets/9705/annotate/9705-2021_03_20_075818.jpg,153.5,198.0,0.23984375,0.55,0.0578125,0.06666666666666667
9705-2021_03_20_075818.jpg,lorry_truck,19,469,640,24,360,73,2,488,97,LTAdatasets/9705/annotate/9705-2021_03_20_075818.jpg,478.5,85.0,0.74765625,0.2361111111111111,0.0296875,0.06666666666666667
9705-2021_03_20_075818.jpg,lorry_truck,26,283,640,22,360,90,2,309,112,LTAdatasets/9705/annotate/9705-2021_03_20_075818.jpg,296.0,101.0,0.4625,0.28055555555555556,0.040625,0.06111111111111111
9705-2021_03_20_075818.jpg,car,24,186,640,17,360,132,1,210,149,LTAdatasets/9705/annotate/9705-2021_03_20_075818.jpg,198.0,140.5,0.309375,0.3902777777777778,0.0375,0.04722222222222222
9705-2021_03_20_075818.jpg,car,17,335,640,10,360,89,1,352,99,LTAdatasets/9705/annotate/9705-2021_03_20_075818.jpg,343.5,94.0,0.53671875,0.2611111111111111,0.0265625,0.027777777777777776
9705-2021_03_20_075818.jpg,car,12,361,640,11,360,75,1,373,86,LTAdatasets/9705/annotate/9705-2021_03_20_075818.jpg,367.0,80.5,0.5734375,0.22361111111111112,0.01875,0.030555555555555555
9705-2021_03_20_075818.jpg,car,8,443,640,8,360,57,1,451,65,LTAdatasets/9705/annotate/9705-2021_03_20_075818.jpg,447.0,61.0,0.6984375,0.16944444444444445,0.0125,0.022222222222222223
9705-2021_03_20_075818.jpg,car,13,382,640,8,360,65,1,395,73,LTAdatasets/9705/annotate/9705-2021_03_20_075818.jpg,388.5,69.0,0.60703125,0.19166666666666668,0.0203125,0.022222222222222223
9705-2021_03_20_075818.jpg,car,12,321,640,9,360,69,1,333,78,LTAdatasets/9705/annotate/9705-2021_03_20_075818.jpg,327.0,73.5,0.5109375,0.20416666666666666,0.01875,0.025
9705-2021_03_20_180410.jpg,van,32,399,640,30,360,134,3,431,164,LTAdatasets/9705/annotate/9705-2021_03_20_180410.jpg,415.0,149.0,0.6484375,0.41388888888888886,0.05,0.08333333333333333
9705-2021_03_20_180410.jpg,van,17,471,640,22,360,89,3,488,111,LTAdatasets/9705/annotate/9705-2021_03_20_180410.jpg,479.5,100.0,0.74921875,0.2777777777777778,0.0265625,0.06111111111111111
9705-2021_03_20_180410.jpg,lorry_truck,33,446,640,46,360,122,2,479,168,LTAdatasets/9705/annotate/9705-2021_03_20_180410.jpg,462.5,145.0,0.72265625,0.4027777777777778,0.0515625,0.12777777777777777
9705-2021_03_20_180410.jpg,lorry_truck,28,224,640,20,360,122,2,252,142,LTAdatasets/9705/annotate/9705-2021_03_20_180410.jpg,238.0,132.0,0.371875,0.36666666666666664,0.04375,0.05555555555555555
9705-2021_03_20_180410.jpg,lorry_truck,61,31,640,33,360,233,2,92,266,LTAdatasets/9705/annotate/9705-2021_03_20_180410.jpg,61.5,249.5,0.09609375,0.6930555555555555,0.0953125,0.09166666666666666
9705-2021_03_20_180410.jpg,car,22,287,640,20,360,124,1,309,144,LTAdatasets/9705/annotate/9705-2021_03_20_180410.jpg,298.0,134.0,0.465625,0.37222222222222223,0.034375,0.05555555555555555
9705-2021_03_20_180410.jpg,car,16,342,640,14,360,93,1,358,107,LTAdatasets/9705/annotate/9705-2021_03_20_180410.jpg,350.0,100.0,0.546875,0.2777777777777778,0.025,0.03888888888888889
9705-2021_03_20_180410.jpg,car,21,400,640,16,360,98,1,421,114,LTAdatasets/9705/annotate/9705-2021_03_20_180410.jpg,410.5,106.0,0.64140625,0.29444444444444445,0.0328125,0.044444444444444446
9705-2021_03_20_180410.jpg,van,14,376,640,11,360,66,3,390,77,LTAdatasets/9705/annotate/9705-2021_03_20_180410.jpg,383.0,71.5,0.5984375,0.1986111111111111,0.021875,0.030555555555555555
9705-2021_03_20_180410.jpg,bike,10,457,640,13,360,66,4,467,79,LTAdatasets/9705/annotate/9705-2021_03_20_180410.jpg,462.0,72.5,0.721875,0.2013888888888889,0.015625,0.03611111111111111
9705-2021_03_20_180410.jpg,bike,8,368,640,8,360,62,4,376,70,LTAdatasets/9705/annotate/9705-2021_03_20_180410.jpg,372.0,66.0,0.58125,0.18333333333333332,0.0125,0.022222222222222223
9705-2021_03_20_180410.jpg,car,11,314,640,12,360,73,1,325,85,LTAdatasets/9705/annotate/9705-2021_03_20_180410.jpg,319.5,79.0,0.49921875,0.21944444444444444,0.0171875,0.03333333333333333
9705-2021_03_20_180410.jpg,car,70,23,640,37,360,269,1,93,306,LTAdatasets/9705/annotate/9705-2021_03_20_180410.jpg,58.0,287.5,0.090625,0.7986111111111112,0.109375,0.10277777777777777
9705-2021_03_20_180410.jpg,car,9,442,640,9,360,60,1,451,69,LTAdatasets/9705/annotate/9705-2021_03_20_180410.jpg,446.5,64.5,0.69765625,0.17916666666666667,0.0140625,0.025
9705-2021_03_20_180410.jpg,car,10,460,640,9,360,55,1,470,64,LTAdatasets/9705/annotate/9705-2021_03_20_180410.jpg,465.0,59.5,0.7265625,0.16527777777777777,0.015625,0.025
9705-2021_03_20_192515.jpg,lorry_truck,34,407,640,49,360,121,2,441,170,LTAdatasets/9705/annotate/9705-2021_03_20_192515.jpg,424.0,145.5,0.6625,0.4041666666666667,0.053125,0.1361111111111111
9705-2021_03_20_192515.jpg,car,17,269,640,14,360,94,1,286,108,LTAdatasets/9705/annotate/9705-2021_03_20_192515.jpg,277.5,101.0,0.43359375,0.28055555555555556,0.0265625,0.03888888888888889
9705-2021_03_20_192515.jpg,van,19,434,640,20,360,89,3,453,109,LTAdatasets/9705/annotate/9705-2021_03_20_192515.jpg,443.5,99.0,0.69296875,0.275,0.0296875,0.05555555555555555
9705-2021_03_20_192515.jpg,bike,10,436,640,13,360,69,4,446,82,LTAdatasets/9705/annotate/9705-2021_03_20_192515.jpg,441.0,75.5,0.6890625,0.20972222222222223,0.015625,0.03611111111111111
9705-2021_03_20_192515.jpg,car,12,308,640,8,360,75,1,320,83,LTAdatasets/9705/annotate/9705-2021_03_20_192515.jpg,314.0,79.0,0.490625,0.21944444444444444,0.01875,0.022222222222222223
9705-2021_03_20_192515.jpg,lorry_truck,14,378,640,14,360,56,2,392,70,LTAdatasets/9705/annotate/9705-2021_03_20_192515.jpg,385.0,63.0,0.6015625,0.175,0.021875,0.03888888888888889
9705-2021_03_20_192515.jpg,car,12,470,640,10,360,46,1,482,56,LTAdatasets/9705/annotate/9705-2021_03_20_192515.jpg,476.0,51.0,0.74375,0.14166666666666666,0.01875,0.027777777777777776
9705-2021_03_20_192515.jpg,car,11,335,640,7,360,61,1,346,68,LTAdatasets/9705/annotate/9705-2021_03_20_192515.jpg,340.5,64.5,0.53203125,0.17916666666666667,0.0171875,0.019444444444444445
9705-2021_03_20_085141.jpg,car,43,165,640,26,360,188,1,208,214,LTAdatasets/9705/annotate/9705-2021_03_20_085141.jpg,186.5,201.0,0.29140625,0.5583333333333333,0.0671875,0.07222222222222222
9705-2021_03_20_085141.jpg,car,51,73,640,23,360,216,1,124,239,LTAdatasets/9705/annotate/9705-2021_03_20_085141.jpg,98.5,227.5,0.15390625,0.6319444444444444,0.0796875,0.06388888888888888
9705-2021_03_20_085141.jpg,car,17,432,640,22,360,99,1,449,121,LTAdatasets/9705/annotate/9705-2021_03_20_085141.jpg,440.5,110.0,0.68828125,0.3055555555555556,0.0265625,0.06111111111111111
9705-2021_03_20_085141.jpg,lorry_truck,23,466,640,25,360,93,2,489,118,LTAdatasets/9705/annotate/9705-2021_03_20_085141.jpg,477.5,105.5,0.74609375,0.29305555555555557,0.0359375,0.06944444444444445
9705-2021_03_20_085141.jpg,bus,90,215,640,51,360,309,5,305,360,LTAdatasets/9705/annotate/9705-2021_03_20_085141.jpg,260.0,334.5,0.40625,0.9291666666666667,0.140625,0.14166666666666666
9705-2021_03_20_085141.jpg,car,29,268,640,13,360,121,1,297,134,LTAdatasets/9705/annotate/9705-2021_03_20_085141.jpg,282.5,127.5,0.44140625,0.3541666666666667,0.0453125,0.03611111111111111
9705-2021_03_20_085141.jpg,car,21,329,640,14,360,99,1,350,113,LTAdatasets/9705/annotate/9705-2021_03_20_085141.jpg,339.5,106.0,0.53046875,0.29444444444444445,0.0328125,0.03888888888888889
9705-2021_03_20_085141.jpg,car,20,288,640,9,360,100,1,308,109,LTAdatasets/9705/annotate/9705-2021_03_20_085141.jpg,298.0,104.5,0.465625,0.2902777777777778,0.03125,0.025
9705-2021_03_20_085141.jpg,car,15,369,640,9,360,70,1,384,79,LTAdatasets/9705/annotate/9705-2021_03_20_085141.jpg,376.5,74.5,0.58828125,0.20694444444444443,0.0234375,0.025
9705-2021_03_20_085141.jpg,car,12,368,640,6,360,63,1,380,69,LTAdatasets/9705/annotate/9705-2021_03_20_085141.jpg,374.0,66.0,0.584375,0.18333333333333332,0.01875,0.016666666666666666
9705-2021_03_20_085141.jpg,car,13,474,640,15,360,73,1,487,88,LTAdatasets/9705/annotate/9705-2021_03_20_085141.jpg,480.5,80.5,0.75078125,0.22361111111111112,0.0203125,0.041666666666666664
9705-2021_03_20_085141.jpg,lorry_truck,15,474,640,17,360,50,2,489,67,LTAdatasets/9705/annotate/9705-2021_03_20_085141.jpg,481.5,58.5,0.75234375,0.1625,0.0234375,0.04722222222222222
9705-2021_03_20_085141.jpg,car,10,457,640,8,360,57,1,467,65,LTAdatasets/9705/annotate/9705-2021_03_20_085141.jpg,462.0,61.0,0.721875,0.16944444444444445,0.015625,0.022222222222222223
9705-2021_03_20_085141.jpg,car,13,441,640,7,360,55,1,454,62,LTAdatasets/9705/annotate/9705-2021_03_20_085141.jpg,447.5,58.5,0.69921875,0.1625,0.0203125,0.019444444444444445
9705-2021_03_20_083340.jpg,car,25,405,640,24,360,135,1,430,159,LTAdatasets/9705/annotate/9705-2021_03_20_083340.jpg,417.5,147.0,0.65234375,0.4083333333333333,0.0390625,0.06666666666666667
9705-2021_03_20_083340.jpg,car,23,262,640,25,360,135,1,285,160,LTAdatasets/9705/annotate/9705-2021_03_20_083340.jpg,273.5,147.5,0.42734375,0.4097222222222222,0.0359375,0.06944444444444445
9705-2021_03_20_083340.jpg,car,21,275,640,14,360,119,1,296,133,LTAdatasets/9705/annotate/9705-2021_03_20_083340.jpg,285.5,126.0,0.44609375,0.35,0.0328125,0.03888888888888889
9705-2021_03_20_083340.jpg,car,22,302,640,18,360,115,1,324,133,LTAdatasets/9705/annotate/9705-2021_03_20_083340.jpg,313.0,124.0,0.4890625,0.34444444444444444,0.034375,0.05
9705-2021_03_20_083340.jpg,van,54,1,640,35,360,247,3,55,282,LTAdatasets/9705/annotate/9705-2021_03_20_083340.jpg,28.0,264.5,0.04375,0.7347222222222223,0.084375,0.09722222222222222
9705-2021_03_20_083340.jpg,lorry_truck,26,316,640,21,360,86,2,342,107,LTAdatasets/9705/annotate/9705-2021_03_20_083340.jpg,329.0,96.5,0.5140625,0.26805555555555555,0.040625,0.058333333333333334
9705-2021_03_20_083340.jpg,car,12,366,640,9,360,73,1,378,82,LTAdatasets/9705/annotate/9705-2021_03_20_083340.jpg,372.0,77.5,0.58125,0.2152777777777778,0.01875,0.025
9705-2021_03_20_083340.jpg,car,14,424,640,10,360,78,1,438,88,LTAdatasets/9705/annotate/9705-2021_03_20_083340.jpg,431.0,83.0,0.6734375,0.23055555555555557,0.021875,0.027777777777777776
9705-2021_03_20_083340.jpg,car,10,435,640,11,360,69,1,445,80,LTAdatasets/9705/annotate/9705-2021_03_20_083340.jpg,440.0,74.5,0.6875,0.20694444444444443,0.015625,0.030555555555555555
9705-2021_03_20_083340.jpg,car,11,384,640,4,360,64,1,395,68,LTAdatasets/9705/annotate/9705-2021_03_20_083340.jpg,389.5,66.0,0.60859375,0.18333333333333332,0.0171875,0.011111111111111112
9705-2021_03_20_083340.jpg,car,8,377,640,5,360,60,1,385,65,LTAdatasets/9705/annotate/9705-2021_03_20_083340.jpg,381.0,62.5,0.5953125,0.1736111111111111,0.0125,0.013888888888888888
9705-2021_03_20_083340.jpg,car,11,460,640,9,360,49,1,471,58,LTAdatasets/9705/annotate/9705-2021_03_20_083340.jpg,465.5,53.5,0.72734375,0.1486111111111111,0.0171875,0.025
9705-2021_03_20_083340.jpg,car,9,394,640,6,360,55,1,403,61,LTAdatasets/9705/annotate/9705-2021_03_20_083340.jpg,398.5,58.0,0.62265625,0.16111111111111112,0.0140625,0.016666666666666666
9705-2021_03_20_195136.jpg,car,38,312,640,52,360,196,1,350,248,LTAdatasets/9705/annotate/9705-2021_03_20_195136.jpg,331.0,222.0,0.5171875,0.6166666666666667,0.059375,0.14444444444444443
9705-2021_03_20_195136.jpg,car,34,229,640,23,360,162,1,263,185,LTAdatasets/9705/annotate/9705-2021_03_20_195136.jpg,246.0,173.5,0.384375,0.48194444444444445,0.053125,0.06388888888888888
9705-2021_03_20_195136.jpg,car,35,178,640,22,360,165,1,213,187,LTAdatasets/9705/annotate/9705-2021_03_20_195136.jpg,195.5,176.0,0.30546875,0.4888888888888889,0.0546875,0.06111111111111111
9705-2021_03_20_195136.jpg,car,16,452,640,19,360,99,1,468,118,LTAdatasets/9705/annotate/9705-2021_03_20_195136.jpg,460.0,108.5,0.71875,0.3013888888888889,0.025,0.05277777777777778
9705-2021_03_20_195136.jpg,bike,10,452,640,15,360,74,4,462,89,LTAdatasets/9705/annotate/9705-2021_03_20_195136.jpg,457.0,81.5,0.7140625,0.2263888888888889,0.015625,0.041666666666666664
9705-2021_03_20_195136.jpg,bike,12,301,640,14,360,81,4,313,95,LTAdatasets/9705/annotate/9705-2021_03_20_195136.jpg,307.0,88.0,0.4796875,0.24444444444444444,0.01875,0.03888888888888889
9705-2021_03_20_195136.jpg,car,19,351,640,14,360,88,1,370,102,LTAdatasets/9705/annotate/9705-2021_03_20_195136.jpg,360.5,95.0,0.56328125,0.2638888888888889,0.0296875,0.03888888888888889
9705-2021_03_20_195136.jpg,car,12,368,640,12,360,74,1,380,86,LTAdatasets/9705/annotate/9705-2021_03_20_195136.jpg,374.0,80.0,0.584375,0.2222222222222222,0.01875,0.03333333333333333
9705-2021_03_20_195136.jpg,car,11,346,640,12,360,74,1,357,86,LTAdatasets/9705/annotate/9705-2021_03_20_195136.jpg,351.5,80.0,0.54921875,0.2222222222222222,0.0171875,0.03333333333333333
9705-2021_03_20_195136.jpg,car,15,271,640,13,360,93,1,286,106,LTAdatasets/9705/annotate/9705-2021_03_20_195136.jpg,278.5,99.5,0.43515625,0.2763888888888889,0.0234375,0.03611111111111111
9705-2021_03_20_195136.jpg,lorry_truck,16,471,640,22,360,61,2,487,83,LTAdatasets/9705/annotate/9705-2021_03_20_195136.jpg,479.0,72.0,0.7484375,0.2,0.025,0.06111111111111111
9705-2021_03_20_195136.jpg,lorry_truck,17,366,640,11,360,62,2,383,73,LTAdatasets/9705/annotate/9705-2021_03_20_195136.jpg,374.5,67.5,0.58515625,0.1875,0.0265625,0.030555555555555555
9705-2021_03_20_073417.jpg,lorry_truck,51,377,640,67,360,131,2,428,198,LTAdatasets/9705/annotate/9705-2021_03_20_073417.jpg,402.5,164.5,0.62890625,0.45694444444444443,0.0796875,0.18611111111111112
9705-2021_03_20_073417.jpg,lorry_truck,27,465,640,25,360,75,2,492,100,LTAdatasets/9705/annotate/9705-2021_03_20_073417.jpg,478.5,87.5,0.74765625,0.24305555555555555,0.0421875,0.06944444444444445
9705-2021_03_20_073417.jpg,lorry_truck,19,452,640,19,360,59,2,471,78,LTAdatasets/9705/annotate/9705-2021_03_20_073417.jpg,461.5,68.5,0.72109375,0.19027777777777777,0.0296875,0.05277777777777778
9705-2021_03_20_073417.jpg,car,18,422,640,12,360,80,1,440,92,LTAdatasets/9705/annotate/9705-2021_03_20_073417.jpg,431.0,86.0,0.6734375,0.2388888888888889,0.028125,0.03333333333333333
9705-2021_03_20_073417.jpg,bus,34,450,640,49,360,108,5,484,157,LTAdatasets/9705/annotate/9705-2021_03_20_073417.jpg,467.0,132.5,0.7296875,0.3680555555555556,0.053125,0.1361111111111111
9705-2021_03_20_073417.jpg,car,23,242,640,15,360,137,1,265,152,LTAdatasets/9705/annotate/9705-2021_03_20_073417.jpg,253.5,144.5,0.39609375,0.4013888888888889,0.0359375,0.041666666666666664
9705-2021_03_20_073417.jpg,car,16,346,640,12,360,83,1,362,95,LTAdatasets/9705/annotate/9705-2021_03_20_073417.jpg,354.0,89.0,0.553125,0.24722222222222223,0.025,0.03333333333333333
9705-2021_03_20_073417.jpg,car,9,379,640,9,360,58,1,388,67,LTAdatasets/9705/annotate/9705-2021_03_20_073417.jpg,383.5,62.5,0.59921875,0.1736111111111111,0.0140625,0.025
9705-2021_03_20_080939.jpg,car,53,245,640,47,360,229,1,298,276,LTAdatasets/9705/annotate/9705-2021_03_20_080939.jpg,271.5,252.5,0.42421875,0.7013888888888888,0.0828125,0.13055555555555556
9705-2021_03_20_080939.jpg,car,20,432,640,19,360,91,1,452,110,LTAdatasets/9705/annotate/9705-2021_03_20_080939.jpg,442.0,100.5,0.690625,0.2791666666666667,0.03125,0.05277777777777778
9705-2021_03_20_080939.jpg,car,16,474,640,18,360,89,1,490,107,LTAdatasets/9705/annotate/9705-2021_03_20_080939.jpg,482.0,98.0,0.753125,0.2722222222222222,0.025,0.05
9705-2021_03_20_080939.jpg,car,12,453,640,10,360,76,1,465,86,LTAdatasets/9705/annotate/9705-2021_03_20_080939.jpg,459.0,81.0,0.7171875,0.225,0.01875,0.027777777777777776
9705-2021_03_20_080939.jpg,car,28,245,640,10,360,122,1,273,132,LTAdatasets/9705/annotate/9705-2021_03_20_080939.jpg,259.0,127.0,0.4046875,0.3527777777777778,0.04375,0.027777777777777776
9705-2021_03_20_080939.jpg,car,15,298,640,9,360,81,1,313,90,LTAdatasets/9705/annotate/9705-2021_03_20_080939.jpg,305.5,85.5,0.47734375,0.2375,0.0234375,0.025
9705-2021_03_20_080939.jpg,car,14,348,640,12,360,71,1,362,83,LTAdatasets/9705/annotate/9705-2021_03_20_080939.jpg,355.0,77.0,0.5546875,0.21388888888888888,0.021875,0.03333333333333333
9705-2021_03_20_080939.jpg,lorry_truck,14,473,640,15,360,52,2,487,67,LTAdatasets/9705/annotate/9705-2021_03_20_080939.jpg,480.0,59.5,0.75,0.16527777777777777,0.021875,0.041666666666666664
9705-2021_03_20_080939.jpg,lorry_truck,10,385,640,10,360,52,2,395,62,LTAdatasets/9705/annotate/9705-2021_03_20_080939.jpg,390.0,57.0,0.609375,0.15833333333333333,0.015625,0.027777777777777776
9705-2021_03_20_080939.jpg,bike,7,398,640,10,360,51,4,405,61,LTAdatasets/9705/annotate/9705-2021_03_20_080939.jpg,401.5,56.0,0.62734375,0.15555555555555556,0.0109375,0.027777777777777776
9705-2021_03_20_074918.jpg,car,45,275,640,50,360,206,1,320,256,LTAdatasets/9705/annotate/9705-2021_03_20_074918.jpg,297.5,231.0,0.46484375,0.6416666666666667,0.0703125,0.1388888888888889
9705-2021_03_20_074918.jpg,lorry_truck,20,458,640,39,360,101,2,478,140,LTAdatasets/9705/annotate/9705-2021_03_20_074918.jpg,468.0,120.5,0.73125,0.3347222222222222,0.03125,0.10833333333333334
9705-2021_03_20_074918.jpg,lorry_truck,25,253,640,21,360,123,2,278,144,LTAdatasets/9705/annotate/9705-2021_03_20_074918.jpg,265.5,133.5,0.41484375,0.37083333333333335,0.0390625,0.058333333333333334
9705-2021_03_20_074918.jpg,van,17,359,640,11,360,75,3,376,86,LTAdatasets/9705/annotate/9705-2021_03_20_074918.jpg,367.5,80.5,0.57421875,0.22361111111111112,0.0265625,0.030555555555555555
9705-2021_03_20_074918.jpg,car,12,397,640,8,360,56,1,409,64,LTAdatasets/9705/annotate/9705-2021_03_20_074918.jpg,403.0,60.0,0.6296875,0.16666666666666666,0.01875,0.022222222222222223
9705-2021_03_20_074918.jpg,car,15,472,640,10,360,55,1,487,65,LTAdatasets/9705/annotate/9705-2021_03_20_074918.jpg,479.5,60.0,0.74921875,0.16666666666666666,0.0234375,0.027777777777777776
9705-2021_03_20_094605.jpg,car,44,154,640,22,360,175,1,198,197,LTAdatasets/9705/annotate/9705-2021_03_20_094605.jpg,176.0,186.0,0.275,0.5166666666666667,0.06875,0.06111111111111111
9705-2021_03_20_094605.jpg,car,29,272,640,16,360,115,1,301,131,LTAdatasets/9705/annotate/9705-2021_03_20_094605.jpg,286.5,123.0,0.44765625,0.3416666666666667,0.0453125,0.044444444444444446
9705-2021_03_20_094605.jpg,lorry_truck,23,306,640,26,360,78,2,329,104,LTAdatasets/9705/annotate/9705-2021_03_20_094605.jpg,317.5,91.0,0.49609375,0.25277777777777777,0.0359375,0.07222222222222222
9705-2021_03_20_094605.jpg,car,16,359,640,14,360,73,1,375,87,LTAdatasets/9705/annotate/9705-2021_03_20_094605.jpg,367.0,80.0,0.5734375,0.2222222222222222,0.025,0.03888888888888889
9705-2021_03_20_094605.jpg,car,15,425,640,14,360,77,1,440,91,LTAdatasets/9705/annotate/9705-2021_03_20_094605.jpg,432.5,84.0,0.67578125,0.23333333333333334,0.0234375,0.03888888888888889
9705-2021_03_20_094605.jpg,car,13,376,640,12,360,64,1,389,76,LTAdatasets/9705/annotate/9705-2021_03_20_094605.jpg,382.5,70.0,0.59765625,0.19444444444444445,0.0203125,0.03333333333333333
9705-2021_03_20_094605.jpg,car,11,441,640,8,360,57,1,452,65,LTAdatasets/9705/annotate/9705-2021_03_20_094605.jpg,446.5,61.0,0.69765625,0.16944444444444445,0.0171875,0.022222222222222223
9705-2021_03_20_094605.jpg,car,28,441,640,37,360,161,1,469,198,LTAdatasets/9705/annotate/9705-2021_03_20_094605.jpg,455.0,179.5,0.7109375,0.4986111111111111,0.04375,0.10277777777777777
9705-2021_03_20_094605.jpg,lorry_truck,10,395,640,11,360,51,2,405,62,LTAdatasets/9705/annotate/9705-2021_03_20_094605.jpg,400.0,56.5,0.625,0.15694444444444444,0.015625,0.030555555555555555
9705-2021_03_20_094605.jpg,lorry_truck,104,344,640,135,360,225,2,448,360,LTAdatasets/9705/annotate/9705-2021_03_20_094605.jpg,396.0,292.5,0.61875,0.8125,0.1625,0.375
9705-2021_03_20_094605.jpg,lorry_truck,58,1,640,46,360,220,2,59,266,LTAdatasets/9705/annotate/9705-2021_03_20_094605.jpg,30.0,243.0,0.046875,0.675,0.090625,0.12777777777777777
9705-2021_03_20_075518.jpg,car,24,370,640,23,360,134,1,394,157,LTAdatasets/9705/annotate/9705-2021_03_20_075518.jpg,382.0,145.5,0.596875,0.4041666666666667,0.0375,0.06388888888888888
9705-2021_03_20_075518.jpg,van,36,294,640,18,360,112,3,330,130,LTAdatasets/9705/annotate/9705-2021_03_20_075518.jpg,312.0,121.0,0.4875,0.33611111111111114,0.05625,0.05
9705-2021_03_20_075518.jpg,van,30,1,640,31,360,244,3,31,275,LTAdatasets/9705/annotate/9705-2021_03_20_075518.jpg,16.0,259.5,0.025,0.7208333333333333,0.046875,0.08611111111111111
9705-2021_03_20_075518.jpg,bike,10,415,640,17,360,103,4,425,120,LTAdatasets/9705/annotate/9705-2021_03_20_075518.jpg,420.0,111.5,0.65625,0.30972222222222223,0.015625,0.04722222222222222
9705-2021_03_20_075518.jpg,lorry_truck,41,426,640,54,360,140,2,467,194,LTAdatasets/9705/annotate/9705-2021_03_20_075518.jpg,446.5,167.0,0.69765625,0.4638888888888889,0.0640625,0.15
9705-2021_03_20_075518.jpg,lorry_truck,25,424,640,37,360,98,2,449,135,LTAdatasets/9705/annotate/9705-2021_03_20_075518.jpg,436.5,116.5,0.68203125,0.3236111111111111,0.0390625,0.10277777777777777
9705-2021_03_20_075518.jpg,car,12,425,640,13,360,79,1,437,92,LTAdatasets/9705/annotate/9705-2021_03_20_075518.jpg,431.0,85.5,0.6734375,0.2375,0.01875,0.03611111111111111
9705-2021_03_20_075518.jpg,car,12,439,640,10,360,55,1,451,65,LTAdatasets/9705/annotate/9705-2021_03_20_075518.jpg,445.0,60.0,0.6953125,0.16666666666666666,0.01875,0.027777777777777776
9705-2021_03_20_075518.jpg,car,12,316,640,10,360,72,1,328,82,LTAdatasets/9705/annotate/9705-2021_03_20_075518.jpg,322.0,77.0,0.503125,0.21388888888888888,0.01875,0.027777777777777776
9705-2021_03_20_075518.jpg,bike,9,383,640,8,360,66,4,392,74,LTAdatasets/9705/annotate/9705-2021_03_20_075518.jpg,387.5,70.0,0.60546875,0.19444444444444445,0.0140625,0.022222222222222223
9705-2021_03_20_075518.jpg,van,12,456,640,9,360,59,3,468,68,LTAdatasets/9705/annotate/9705-2021_03_20_075518.jpg,462.0,63.5,0.721875,0.1763888888888889,0.01875,0.025
9705-2021_03_20_075518.jpg,lorry_truck,14,474,640,21,360,52,2,488,73,LTAdatasets/9705/annotate/9705-2021_03_20_075518.jpg,481.0,62.5,0.7515625,0.1736111111111111,0.021875,0.058333333333333334
9705-2021_03_20_084601.jpg,lorry_truck,32,171,640,29,360,163,2,203,192,LTAdatasets/9705/annotate/9705-2021_03_20_084601.jpg,187.0,177.5,0.2921875,0.4930555555555556,0.05,0.08055555555555556
9705-2021_03_20_084601.jpg,lorry_truck,27,225,640,22,360,124,2,252,146,LTAdatasets/9705/annotate/9705-2021_03_20_084601.jpg,238.5,135.0,0.37265625,0.375,0.0421875,0.06111111111111111
9705-2021_03_20_084601.jpg,lorry_truck,25,293,640,21,360,88,2,318,109,LTAdatasets/9705/annotate/9705-2021_03_20_084601.jpg,305.5,98.5,0.47734375,0.27361111111111114,0.0390625,0.058333333333333334
9705-2021_03_20_084601.jpg,van,19,429,640,24,360,105,3,448,129,LTAdatasets/9705/annotate/9705-2021_03_20_084601.jpg,438.5,117.0,0.68515625,0.325,0.0296875,0.06666666666666667
9705-2021_03_20_084601.jpg,car,23,295,640,16,360,119,1,318,135,LTAdatasets/9705/annotate/9705-2021_03_20_084601.jpg,306.5,127.0,0.47890625,0.3527777777777778,0.0359375,0.044444444444444446
9705-2021_03_20_084601.jpg,car,50,119,640,28,360,218,1,169,246,LTAdatasets/9705/annotate/9705-2021_03_20_084601.jpg,144.0,232.0,0.225,0.6444444444444445,0.078125,0.07777777777777778
9705-2021_03_20_084601.jpg,car,23,258,640,19,360,123,1,281,142,LTAdatasets/9705/annotate/9705-2021_03_20_084601.jpg,269.5,132.5,0.42109375,0.3680555555555556,0.0359375,0.05277777777777778
9705-2021_03_20_084601.jpg,car,11,451,640,9,360,70,1,462,79,LTAdatasets/9705/annotate/9705-2021_03_20_084601.jpg,456.5,74.5,0.71328125,0.20694444444444443,0.0171875,0.025
9705-2021_03_20_084601.jpg,lorry_truck,20,466,640,25,360,67,2,486,92,LTAdatasets/9705/annotate/9705-2021_03_20_084601.jpg,476.0,79.5,0.74375,0.22083333333333333,0.03125,0.06944444444444445
9705-2021_03_20_084601.jpg,lorry_truck,17,470,640,15,360,51,2,487,66,LTAdatasets/9705/annotate/9705-2021_03_20_084601.jpg,478.5,58.5,0.74765625,0.1625,0.0265625,0.041666666666666664
9705-2021_03_20_084601.jpg,van,13,443,640,15,360,81,3,456,96,LTAdatasets/9705/annotate/9705-2021_03_20_084601.jpg,449.5,88.5,0.70234375,0.24583333333333332,0.0203125,0.041666666666666664
9705-2021_03_20_084601.jpg,van,15,361,640,11,360,71,3,376,82,LTAdatasets/9705/annotate/9705-2021_03_20_084601.jpg,368.5,76.5,0.57578125,0.2125,0.0234375,0.030555555555555555
9705-2021_03_20_084601.jpg,car,11,401,640,8,360,59,1,412,67,LTAdatasets/9705/annotate/9705-2021_03_20_084601.jpg,406.5,63.0,0.63515625,0.175,0.0171875,0.022222222222222223
9705-2021_03_20_084601.jpg,lorry_truck,15,363,640,12,360,57,2,378,69,LTAdatasets/9705/annotate/9705-2021_03_20_084601.jpg,370.5,63.0,0.57890625,0.175,0.0234375,0.03333333333333333
9705-2021_03_20_084601.jpg,lorry_truck,11,383,640,14,360,57,2,394,71,LTAdatasets/9705/annotate/9705-2021_03_20_084601.jpg,388.5,64.0,0.60703125,0.17777777777777778,0.0171875,0.03888888888888889
9705-2021_03_20_183412.jpg,car,18,397,640,20,360,98,1,415,118,LTAdatasets/9705/annotate/9705-2021_03_20_183412.jpg,406.0,108.0,0.634375,0.3,0.028125,0.05555555555555555
9705-2021_03_20_183412.jpg,car,12,311,640,9,360,72,1,323,81,LTAdatasets/9705/annotate/9705-2021_03_20_183412.jpg,317.0,76.5,0.4953125,0.2125,0.01875,0.025
9705-2021_03_20_183412.jpg,car,13,450,640,13,360,75,1,463,88,LTAdatasets/9705/annotate/9705-2021_03_20_183412.jpg,456.5,81.5,0.71328125,0.2263888888888889,0.0203125,0.03611111111111111
9705-2021_03_20_183412.jpg,bike,10,462,640,10,360,57,4,472,67,LTAdatasets/9705/annotate/9705-2021_03_20_183412.jpg,467.0,62.0,0.7296875,0.17222222222222222,0.015625,0.027777777777777776
9705-2021_03_20_183412.jpg,bike,9,459,640,7,360,44,4,468,51,LTAdatasets/9705/annotate/9705-2021_03_20_183412.jpg,463.5,47.5,0.72421875,0.13194444444444445,0.0140625,0.019444444444444445
9705-2021_03_20_183412.jpg,lorry_truck,19,361,640,17,360,61,2,380,78,LTAdatasets/9705/annotate/9705-2021_03_20_183412.jpg,370.5,69.5,0.57890625,0.19305555555555556,0.0296875,0.04722222222222222
9705-2021_03_20_183412.jpg,car,7,411,640,11,360,51,1,418,62,LTAdatasets/9705/annotate/9705-2021_03_20_183412.jpg,414.5,56.5,0.64765625,0.15694444444444444,0.0109375,0.030555555555555555
9705-2021_03_20_183412.jpg,car,9,400,640,7,360,51,1,409,58,LTAdatasets/9705/annotate/9705-2021_03_20_183412.jpg,404.5,54.5,0.63203125,0.15138888888888888,0.0140625,0.019444444444444445
9705-2021_03_20_183412.jpg,car,13,412,640,4,360,49,1,425,53,LTAdatasets/9705/annotate/9705-2021_03_20_183412.jpg,418.5,51.0,0.65390625,0.14166666666666666,0.0203125,0.011111111111111112
9705-2021_03_20_095205.jpg,car,31,337,640,26,360,151,1,368,177,LTAdatasets/9705/annotate/9705-2021_03_20_095205.jpg,352.5,164.0,0.55078125,0.45555555555555555,0.0484375,0.07222222222222222
9705-2021_03_20_095205.jpg,car,19,417,640,20,360,115,1,436,135,LTAdatasets/9705/annotate/9705-2021_03_20_095205.jpg,426.5,125.0,0.66640625,0.3472222222222222,0.0296875,0.05555555555555555
9705-2021_03_20_095205.jpg,bike,11,456,640,20,360,108,4,467,128,LTAdatasets/9705/annotate/9705-2021_03_20_095205.jpg,461.5,118.0,0.72109375,0.3277777777777778,0.0171875,0.05555555555555555
9705-2021_03_20_095205.jpg,bike,11,281,640,17,360,118,4,292,135,LTAdatasets/9705/annotate/9705-2021_03_20_095205.jpg,286.5,126.5,0.44765625,0.35138888888888886,0.0171875,0.04722222222222222
9705-2021_03_20_095205.jpg,car,17,354,640,9,360,86,1,371,95,LTAdatasets/9705/annotate/9705-2021_03_20_095205.jpg,362.5,90.5,0.56640625,0.2513888888888889,0.0265625,0.025
9705-2021_03_20_095205.jpg,van,12,319,640,9,360,68,3,331,77,LTAdatasets/9705/annotate/9705-2021_03_20_095205.jpg,325.0,72.5,0.5078125,0.2013888888888889,0.01875,0.025
9705-2021_03_20_095205.jpg,car,15,429,640,10,360,72,1,444,82,LTAdatasets/9705/annotate/9705-2021_03_20_095205.jpg,436.5,77.0,0.68203125,0.21388888888888888,0.0234375,0.027777777777777776
9705-2021_03_20_095205.jpg,car,12,386,640,9,360,71,1,398,80,LTAdatasets/9705/annotate/9705-2021_03_20_095205.jpg,392.0,75.5,0.6125,0.20972222222222223,0.01875,0.025
9705-2021_03_20_095205.jpg,lorry_truck,22,469,640,18,360,73,2,491,91,LTAdatasets/9705/annotate/9705-2021_03_20_095205.jpg,480.0,82.0,0.75,0.22777777777777777,0.034375,0.05
9705-2021_03_20_095205.jpg,lorry_truck,16,352,640,15,360,60,2,368,75,LTAdatasets/9705/annotate/9705-2021_03_20_095205.jpg,360.0,67.5,0.5625,0.1875,0.025,0.041666666666666664
9705-2021_03_20_095205.jpg,lorry_truck,12,375,640,11,360,65,2,387,76,LTAdatasets/9705/annotate/9705-2021_03_20_095205.jpg,381.0,70.5,0.5953125,0.19583333333333333,0.01875,0.030555555555555555
9705-2021_03_20_095205.jpg,car,11,442,640,11,360,55,1,453,66,LTAdatasets/9705/annotate/9705-2021_03_20_095205.jpg,447.5,60.5,0.69921875,0.16805555555555557,0.0171875,0.030555555555555555
9705-2021_03_20_095205.jpg,car,9,401,640,9,360,52,1,410,61,LTAdatasets/9705/annotate/9705-2021_03_20_095205.jpg,405.5,56.5,0.63359375,0.15694444444444444,0.0140625,0.025
9705-2021_03_20_095205.jpg,bike,9,389,640,8,360,57,4,398,65,LTAdatasets/9705/annotate/9705-2021_03_20_095205.jpg,393.5,61.0,0.61484375,0.16944444444444445,0.0140625,0.022222222222222223
9705-2021_03_20_095205.jpg,van,11,464,640,14,360,61,3,475,75,LTAdatasets/9705/annotate/9705-2021_03_20_095205.jpg,469.5,68.0,0.73359375,0.18888888888888888,0.0171875,0.03888888888888889
9705-2021_03_20_095205.jpg,lorry_truck,12,471,640,14,360,43,2,483,57,LTAdatasets/9705/annotate/9705-2021_03_20_095205.jpg,477.0,50.0,0.7453125,0.1388888888888889,0.01875,0.03888888888888889
9705-2021_03_20_095205.jpg,lorry_truck,12,398,640,11,360,38,2,410,49,LTAdatasets/9705/annotate/9705-2021_03_20_095205.jpg,404.0,43.5,0.63125,0.12083333333333333,0.01875,0.030555555555555555
9705-2021_03_20_095205.jpg,bike,30,246,640,21,360,339,4,276,360,LTAdatasets/9705/annotate/9705-2021_03_20_095205.jpg,261.0,349.5,0.4078125,0.9708333333333333,0.046875,0.058333333333333334
9705-2021_03_20_081920.jpg,lorry_truck,47,426,640,106,360,153,2,473,259,LTAdatasets/9705/annotate/9705-2021_03_20_081920.jpg,449.5,206.0,0.70234375,0.5722222222222222,0.0734375,0.29444444444444445
9705-2021_03_20_081920.jpg,lorry_truck,25,261,640,25,360,116,2,286,141,LTAdatasets/9705/annotate/9705-2021_03_20_081920.jpg,273.5,128.5,0.42734375,0.35694444444444445,0.0390625,0.06944444444444445
9705-2021_03_20_081920.jpg,lorry_truck,22,351,640,16,360,72,2,373,88,LTAdatasets/9705/annotate/9705-2021_03_20_081920.jpg,362.0,80.0,0.565625,0.2222222222222222,0.034375,0.044444444444444446
9705-2021_03_20_081920.jpg,van,17,465,640,19,360,73,3,482,92,LTAdatasets/9705/annotate/9705-2021_03_20_081920.jpg,473.5,82.5,0.73984375,0.22916666666666666,0.0265625,0.05277777777777778
9705-2021_03_20_081920.jpg,car,38,175,640,24,360,163,1,213,187,LTAdatasets/9705/annotate/9705-2021_03_20_081920.jpg,194.0,175.0,0.303125,0.4861111111111111,0.059375,0.06666666666666667
9705-2021_03_20_081920.jpg,car,22,412,640,22,360,112,1,434,134,LTAdatasets/9705/annotate/9705-2021_03_20_081920.jpg,423.0,123.0,0.6609375,0.3416666666666667,0.034375,0.06111111111111111
9705-2021_03_20_081920.jpg,van,18,323,640,11,360,89,3,341,100,LTAdatasets/9705/annotate/9705-2021_03_20_081920.jpg,332.0,94.5,0.51875,0.2625,0.028125,0.030555555555555555
9705-2021_03_20_081920.jpg,van,4,388,640,11,360,51,3,392,62,LTAdatasets/9705/annotate/9705-2021_03_20_081920.jpg,390.0,56.5,0.609375,0.15694444444444444,0.00625,0.030555555555555555
9705-2021_03_20_081920.jpg,bike,12,446,640,17,360,86,4,458,103,LTAdatasets/9705/annotate/9705-2021_03_20_081920.jpg,452.0,94.5,0.70625,0.2625,0.01875,0.04722222222222222
9705-2021_03_20_081920.jpg,bike,12,211,640,17,360,137,4,223,154,LTAdatasets/9705/annotate/9705-2021_03_20_081920.jpg,217.0,145.5,0.3390625,0.4041666666666667,0.01875,0.04722222222222222
9705-2021_03_20_081920.jpg,van,10,400,640,8,360,50,3,410,58,LTAdatasets/9705/annotate/9705-2021_03_20_081920.jpg,405.0,54.0,0.6328125,0.15,0.015625,0.022222222222222223
9705-2021_03_20_081920.jpg,lorry_truck,21,314,640,15,360,76,2,335,91,LTAdatasets/9705/annotate/9705-2021_03_20_081920.jpg,324.5,83.5,0.50703125,0.23194444444444445,0.0328125,0.041666666666666664
9705-2021_03_20_191014.jpg,car,40,340,640,54,360,209,1,380,263,LTAdatasets/9705/annotate/9705-2021_03_20_191014.jpg,360.0,236.0,0.5625,0.6555555555555556,0.0625,0.15
9705-2021_03_20_191014.jpg,car,55,397,640,70,360,242,1,452,312,LTAdatasets/9705/annotate/9705-2021_03_20_191014.jpg,424.5,277.0,0.66328125,0.7694444444444445,0.0859375,0.19444444444444445
9705-2021_03_20_191014.jpg,car,70,135,640,59,360,301,1,205,360,LTAdatasets/9705/annotate/9705-2021_03_20_191014.jpg,170.0,330.5,0.265625,0.9180555555555555,0.109375,0.1638888888888889
9705-2021_03_20_191014.jpg,car,41,212,640,24,360,163,1,253,187,LTAdatasets/9705/annotate/9705-2021_03_20_191014.jpg,232.5,175.0,0.36328125,0.4861111111111111,0.0640625,0.06666666666666667
9705-2021_03_20_191014.jpg,car,12,426,640,14,360,73,1,438,87,LTAdatasets/9705/annotate/9705-2021_03_20_191014.jpg,432.0,80.0,0.675,0.2222222222222222,0.01875,0.03888888888888889
9705-2021_03_20_191014.jpg,lorry_truck,18,448,640,23,360,69,2,466,92,LTAdatasets/9705/annotate/9705-2021_03_20_191014.jpg,457.0,80.5,0.7140625,0.22361111111111112,0.028125,0.06388888888888888
9705-2021_03_20_191014.jpg,lorry_truck,29,289,640,20,360,90,2,318,110,LTAdatasets/9705/annotate/9705-2021_03_20_191014.jpg,303.5,100.0,0.47421875,0.2777777777777778,0.0453125,0.05555555555555555
9705-2021_03_20_191014.jpg,lorry_truck,28,326,640,21,360,78,2,354,99,LTAdatasets/9705/annotate/9705-2021_03_20_191014.jpg,340.0,88.5,0.53125,0.24583333333333332,0.04375,0.058333333333333334
9705-2021_03_20_191014.jpg,lorry_truck,12,375,640,17,360,55,2,387,72,LTAdatasets/9705/annotate/9705-2021_03_20_191014.jpg,381.0,63.5,0.5953125,0.1763888888888889,0.01875,0.04722222222222222
9705-2021_03_20_191014.jpg,car,15,369,640,10,360,81,1,384,91,LTAdatasets/9705/annotate/9705-2021_03_20_191014.jpg,376.5,86.0,0.58828125,0.2388888888888889,0.0234375,0.027777777777777776
9705-2021_03_20_191014.jpg,car,12,383,640,10,360,64,1,395,74,LTAdatasets/9705/annotate/9705-2021_03_20_191014.jpg,389.0,69.0,0.6078125,0.19166666666666668,0.01875,0.027777777777777776
9705-2021_03_20_191014.jpg,car,12,472,640,13,360,62,1,484,75,LTAdatasets/9705/annotate/9705-2021_03_20_191014.jpg,478.0,68.5,0.746875,0.19027777777777777,0.01875,0.03611111111111111
9705-2021_03_20_191014.jpg,lorry_truck,35,148,640,47,360,165,2,183,212,LTAdatasets/9705/annotate/9705-2021_03_20_191014.jpg,165.5,188.5,0.25859375,0.5236111111111111,0.0546875,0.13055555555555556
9705-2021_03_20_191014.jpg,lorry_truck,11,305,640,12,360,73,2,316,85,LTAdatasets/9705/annotate/9705-2021_03_20_191014.jpg,310.5,79.0,0.48515625,0.21944444444444444,0.0171875,0.03333333333333333
9705-2021_03_20_082740.jpg,bike,35,184,640,47,360,308,4,219,355,LTAdatasets/9705/annotate/9705-2021_03_20_082740.jpg,201.5,331.5,0.31484375,0.9208333333333333,0.0546875,0.13055555555555556
9705-2021_03_20_082740.jpg,bike,12,283,640,18,360,123,4,295,141,LTAdatasets/9705/annotate/9705-2021_03_20_082740.jpg,289.0,132.0,0.4515625,0.36666666666666664,0.01875,0.05
9705-2021_03_20_082740.jpg,bike,6,459,640,11,360,55,4,465,66,LTAdatasets/9705/annotate/9705-2021_03_20_082740.jpg,462.0,60.5,0.721875,0.16805555555555557,0.009375,0.030555555555555555
9705-2021_03_20_082740.jpg,lorry_truck,30,235,640,22,360,128,2,265,150,LTAdatasets/9705/annotate/9705-2021_03_20_082740.jpg,250.0,139.0,0.390625,0.3861111111111111,0.046875,0.06111111111111111
9705-2021_03_20_082740.jpg,lorry_truck,83,2,640,57,360,223,2,85,280,LTAdatasets/9705/annotate/9705-2021_03_20_082740.jpg,43.5,251.5,0.06796875,0.6986111111111111,0.1296875,0.15833333333333333
9705-2021_03_20_082740.jpg,car,60,35,640,29,360,268,1,95,297,LTAdatasets/9705/annotate/9705-2021_03_20_082740.jpg,65.0,282.5,0.1015625,0.7847222222222222,0.09375,0.08055555555555556
9705-2021_03_20_082740.jpg,car,12,294,640,11,360,84,1,306,95,LTAdatasets/9705/annotate/9705-2021_03_20_082740.jpg,300.0,89.5,0.46875,0.24861111111111112,0.01875,0.030555555555555555
9705-2021_03_20_082740.jpg,car,11,389,640,9,360,59,1,400,68,LTAdatasets/9705/annotate/9705-2021_03_20_082740.jpg,394.5,63.5,0.61640625,0.1763888888888889,0.0171875,0.025
9705-2021_03_20_082740.jpg,car,15,405,640,6,360,54,1,420,60,LTAdatasets/9705/annotate/9705-2021_03_20_082740.jpg,412.5,57.0,0.64453125,0.15833333333333333,0.0234375,0.016666666666666666
9705-2021_03_20_082740.jpg,car,8,446,640,9,360,48,1,454,57,LTAdatasets/9705/annotate/9705-2021_03_20_082740.jpg,450.0,52.5,0.703125,0.14583333333333334,0.0125,0.025
9705-2021_03_20_082740.jpg,car,10,324,640,12,360,65,1,334,77,LTAdatasets/9705/annotate/9705-2021_03_20_082740.jpg,329.0,71.0,0.5140625,0.19722222222222222,0.015625,0.03333333333333333
9705-2021_03_20_194315.jpg,van,35,222,640,23,360,127,3,257,150,LTAdatasets/9705/annotate/9705-2021_03_20_194315.jpg,239.5,138.5,0.37421875,0.38472222222222224,0.0546875,0.06388888888888888
9705-2021_03_20_194315.jpg,car,16,414,640,14,360,90,1,430,104,LTAdatasets/9705/annotate/9705-2021_03_20_194315.jpg,422.0,97.0,0.659375,0.26944444444444443,0.025,0.03888888888888889
9705-2021_03_20_194315.jpg,lorry_truck,22,345,640,17,360,67,2,367,84,LTAdatasets/9705/annotate/9705-2021_03_20_194315.jpg,356.0,75.5,0.55625,0.20972222222222223,0.034375,0.04722222222222222
9705-2021_03_20_194315.jpg,car,14,374,640,11,360,65,1,388,76,LTAdatasets/9705/annotate/9705-2021_03_20_194315.jpg,381.0,70.5,0.5953125,0.19583333333333333,0.021875,0.030555555555555555
9705-2021_03_20_194315.jpg,bike,10,450,640,13,360,69,4,460,82,LTAdatasets/9705/annotate/9705-2021_03_20_194315.jpg,455.0,75.5,0.7109375,0.20972222222222223,0.015625,0.03611111111111111
9705-2021_03_20_194315.jpg,car,11,458,640,8,360,57,1,469,65,LTAdatasets/9705/annotate/9705-2021_03_20_194315.jpg,463.5,61.0,0.72421875,0.16944444444444445,0.0171875,0.022222222222222223
9705-2021_03_20_194315.jpg,car,10,446,640,9,360,48,1,456,57,LTAdatasets/9705/annotate/9705-2021_03_20_194315.jpg,451.0,52.5,0.7046875,0.14583333333333334,0.015625,0.025
9705-2021_03_20_201617.jpg,car,24,407,640,24,360,133,1,431,157,LTAdatasets/9705/annotate/9705-2021_03_20_201617.jpg,419.0,145.0,0.6546875,0.4027777777777778,0.0375,0.06666666666666667
9705-2021_03_20_201617.jpg,van,35,441,640,47,360,166,3,476,213,LTAdatasets/9705/annotate/9705-2021_03_20_201617.jpg,458.5,189.5,0.71640625,0.5263888888888889,0.0546875,0.13055555555555556
9705-2021_03_20_201617.jpg,car,16,436,640,20,360,94,1,452,114,LTAdatasets/9705/annotate/9705-2021_03_20_201617.jpg,444.0,104.0,0.69375,0.28888888888888886,0.025,0.05555555555555555
9705-2021_03_20_201617.jpg,car,17,451,640,12,360,68,1,468,80,LTAdatasets/9705/annotate/9705-2021_03_20_201617.jpg,459.5,74.0,0.71796875,0.20555555555555555,0.0265625,0.03333333333333333
9705-2021_03_20_201617.jpg,car,14,473,640,12,360,59,1,487,71,LTAdatasets/9705/annotate/9705-2021_03_20_201617.jpg,480.0,65.0,0.75,0.18055555555555555,0.021875,0.03333333333333333
9705-2021_03_20_201617.jpg,car,11,458,640,11,360,55,1,469,66,LTAdatasets/9705/annotate/9705-2021_03_20_201617.jpg,463.5,60.5,0.72421875,0.16805555555555557,0.0171875,0.030555555555555555
9705-2021_03_20_201617.jpg,car,9,397,640,10,360,54,1,406,64,LTAdatasets/9705/annotate/9705-2021_03_20_201617.jpg,401.5,59.0,0.62734375,0.1638888888888889,0.0140625,0.027777777777777776
9705-2021_03_20_185753.jpg,van,66,373,640,91,360,269,3,439,360,LTAdatasets/9705/annotate/9705-2021_03_20_185753.jpg,406.0,314.5,0.634375,0.8736111111111111,0.103125,0.25277777777777777
9705-2021_03_20_185753.jpg,van,13,472,640,19,360,71,3,485,90,LTAdatasets/9705/annotate/9705-2021_03_20_185753.jpg,478.5,80.5,0.74765625,0.22361111111111112,0.0203125,0.05277777777777778
9705-2021_03_20_185753.jpg,car,10,455,640,7,360,60,1,465,67,LTAdatasets/9705/annotate/9705-2021_03_20_185753.jpg,460.0,63.5,0.71875,0.1763888888888889,0.015625,0.019444444444444445
9705-2021_03_20_185753.jpg,car,9,446,640,7,360,55,1,455,62,LTAdatasets/9705/annotate/9705-2021_03_20_185753.jpg,450.5,58.5,0.70390625,0.1625,0.0140625,0.019444444444444445
9705-2021_03_20_185753.jpg,car,11,460,640,12,360,48,1,471,60,LTAdatasets/9705/annotate/9705-2021_03_20_185753.jpg,465.5,54.0,0.72734375,0.15,0.0171875,0.03333333333333333
9705-2021_03_20_185753.jpg,van,10,328,640,10,360,66,3,338,76,LTAdatasets/9705/annotate/9705-2021_03_20_185753.jpg,333.0,71.0,0.5203125,0.19722222222222222,0.015625,0.027777777777777776
9705-2021_03_20_185753.jpg,bike,10,371,640,9,360,63,4,381,72,LTAdatasets/9705/annotate/9705-2021_03_20_185753.jpg,376.0,67.5,0.5875,0.1875,0.015625,0.025
9705-2021_03_20_193415.jpg,lorry_truck,25,291,640,26,360,99,2,316,125,LTAdatasets/9705/annotate/9705-2021_03_20_193415.jpg,303.5,112.0,0.47421875,0.3111111111111111,0.0390625,0.07222222222222222
9705-2021_03_20_193415.jpg,lorry_truck,14,318,640,13,360,66,2,332,79,LTAdatasets/9705/annotate/9705-2021_03_20_193415.jpg,325.0,72.5,0.5078125,0.2013888888888889,0.021875,0.03611111111111111
9705-2021_03_20_193415.jpg,bike,10,354,640,11,360,79,4,364,90,LTAdatasets/9705/annotate/9705-2021_03_20_193415.jpg,359.0,84.5,0.5609375,0.23472222222222222,0.015625,0.030555555555555555
9705-2021_03_20_193415.jpg,bike,11,466,640,12,360,57,4,477,69,LTAdatasets/9705/annotate/9705-2021_03_20_193415.jpg,471.5,63.0,0.73671875,0.175,0.0171875,0.03333333333333333
9705-2021_03_20_193415.jpg,car,12,448,640,15,360,76,1,460,91,LTAdatasets/9705/annotate/9705-2021_03_20_193415.jpg,454.0,83.5,0.709375,0.23194444444444445,0.01875,0.041666666666666664
9705-2021_03_20_193415.jpg,car,22,434,640,18,360,104,1,456,122,LTAdatasets/9705/annotate/9705-2021_03_20_193415.jpg,445.0,113.0,0.6953125,0.3138888888888889,0.034375,0.05
9705-2021_03_20_193415.jpg,car,16,476,640,12,360,95,1,492,107,LTAdatasets/9705/annotate/9705-2021_03_20_193415.jpg,484.0,101.0,0.75625,0.28055555555555556,0.025,0.03333333333333333
9705-2021_03_20_193415.jpg,car,15,375,640,10,360,76,1,390,86,LTAdatasets/9705/annotate/9705-2021_03_20_193415.jpg,382.5,81.0,0.59765625,0.225,0.0234375,0.027777777777777776
9705-2021_03_20_193415.jpg,car,13,398,640,11,360,58,1,411,69,LTAdatasets/9705/annotate/9705-2021_03_20_193415.jpg,404.5,63.5,0.63203125,0.1763888888888889,0.0203125,0.030555555555555555
9705-2021_03_20_193415.jpg,lorry_truck,19,471,640,22,360,71,2,490,93,LTAdatasets/9705/annotate/9705-2021_03_20_193415.jpg,480.5,82.0,0.75078125,0.22777777777777777,0.0296875,0.06111111111111111
9705-2021_03_20_092543.jpg,car,43,303,640,41,360,186,1,346,227,LTAdatasets/9705/annotate/9705-2021_03_20_092543.jpg,324.5,206.5,0.50703125,0.5736111111111111,0.0671875,0.11388888888888889
9705-2021_03_20_092543.jpg,car,25,251,640,19,360,128,1,276,147,LTAdatasets/9705/annotate/9705-2021_03_20_092543.jpg,263.5,137.5,0.41171875,0.3819444444444444,0.0390625,0.05277777777777778
9705-2021_03_20_092543.jpg,lorry_truck,17,432,640,32,360,90,2,449,122,LTAdatasets/9705/annotate/9705-2021_03_20_092543.jpg,440.5,106.0,0.68828125,0.29444444444444445,0.0265625,0.08888888888888889
9705-2021_03_20_092543.jpg,car,10,461,640,9,360,52,1,471,61,LTAdatasets/9705/annotate/9705-2021_03_20_092543.jpg,466.0,56.5,0.728125,0.15694444444444444,0.015625,0.025
9705-2021_03_20_092543.jpg,car,8,458,640,11,360,43,1,466,54,LTAdatasets/9705/annotate/9705-2021_03_20_092543.jpg,462.0,48.5,0.721875,0.13472222222222222,0.0125,0.030555555555555555
9705-2021_03_20_092543.jpg,car,9,387,640,9,360,51,1,396,60,LTAdatasets/9705/annotate/9705-2021_03_20_092543.jpg,391.5,55.5,0.61171875,0.15416666666666667,0.0140625,0.025
9705-2021_03_20_092543.jpg,lorry_truck,11,351,640,13,360,66,2,362,79,LTAdatasets/9705/annotate/9705-2021_03_20_092543.jpg,356.5,72.5,0.55703125,0.2013888888888889,0.0171875,0.03611111111111111
9705-2021_03_20_100105.jpg,car,48,276,640,43,360,202,1,324,245,LTAdatasets/9705/annotate/9705-2021_03_20_100105.jpg,300.0,223.5,0.46875,0.6208333333333333,0.075,0.11944444444444445
9705-2021_03_20_100105.jpg,van,49,187,640,33,360,164,3,236,197,LTAdatasets/9705/annotate/9705-2021_03_20_100105.jpg,211.5,180.5,0.33046875,0.5013888888888889,0.0765625,0.09166666666666666
9705-2021_03_20_100105.jpg,lorry_truck,35,451,640,51,360,117,2,486,168,LTAdatasets/9705/annotate/9705-2021_03_20_100105.jpg,468.5,142.5,0.73203125,0.3958333333333333,0.0546875,0.14166666666666666
9705-2021_03_20_100105.jpg,car,17,318,640,15,360,95,1,335,110,LTAdatasets/9705/annotate/9705-2021_03_20_100105.jpg,326.5,102.5,0.51015625,0.2847222222222222,0.0265625,0.041666666666666664
9705-2021_03_20_100105.jpg,bike,16,259,640,14,360,128,4,275,142,LTAdatasets/9705/annotate/9705-2021_03_20_100105.jpg,267.0,135.0,0.4171875,0.375,0.025,0.03888888888888889
9705-2021_03_20_100105.jpg,lorry_truck,12,473,640,17,360,55,2,485,72,LTAdatasets/9705/annotate/9705-2021_03_20_100105.jpg,479.0,63.5,0.7484375,0.1763888888888889,0.01875,0.04722222222222222
9705-2021_03_20_100105.jpg,lorry_truck,19,351,640,18,360,61,2,370,79,LTAdatasets/9705/annotate/9705-2021_03_20_100105.jpg,360.5,70.0,0.56328125,0.19444444444444445,0.0296875,0.05
9705-2021_03_20_100105.jpg,lorry_truck,12,378,640,17,360,59,2,390,76,LTAdatasets/9705/annotate/9705-2021_03_20_100105.jpg,384.0,67.5,0.6,0.1875,0.01875,0.04722222222222222
9705-2021_03_20_100105.jpg,car,15,388,640,10,360,55,1,403,65,LTAdatasets/9705/annotate/9705-2021_03_20_100105.jpg,395.5,60.0,0.61796875,0.16666666666666666,0.0234375,0.027777777777777776
9705-2021_03_20_100105.jpg,car,9,411,640,8,360,42,1,420,50,LTAdatasets/9705/annotate/9705-2021_03_20_100105.jpg,415.5,46.0,0.64921875,0.12777777777777777,0.0140625,0.022222222222222223
9705-2021_03_20_100105.jpg,car,7,475,640,9,360,48,1,482,57,LTAdatasets/9705/annotate/9705-2021_03_20_100105.jpg,478.5,52.5,0.74765625,0.14583333333333334,0.0109375,0.025
9705-2021_03_20_093103.jpg,car,39,156,640,20,360,176,1,195,196,LTAdatasets/9705/annotate/9705-2021_03_20_093103.jpg,175.5,186.0,0.27421875,0.5166666666666667,0.0609375,0.05555555555555555
9705-2021_03_20_093103.jpg,car,15,433,640,22,360,101,1,448,123,LTAdatasets/9705/annotate/9705-2021_03_20_093103.jpg,440.5,112.0,0.68828125,0.3111111111111111,0.0234375,0.06111111111111111
9705-2021_03_20_093103.jpg,car,7,457,640,9,360,54,1,464,63,LTAdatasets/9705/annotate/9705-2021_03_20_093103.jpg,460.5,58.5,0.71953125,0.1625,0.0109375,0.025
9705-2021_03_20_093103.jpg,car,12,474,640,10,360,54,1,486,64,LTAdatasets/9705/annotate/9705-2021_03_20_093103.jpg,480.0,59.0,0.75,0.1638888888888889,0.01875,0.027777777777777776
9705-2021_03_20_093103.jpg,van,16,469,640,20,360,73,3,485,93,LTAdatasets/9705/annotate/9705-2021_03_20_093103.jpg,477.0,83.0,0.7453125,0.23055555555555557,0.025,0.05555555555555555
9705-2021_03_20_093103.jpg,lorry_truck,12,386,640,17,360,44,2,398,61,LTAdatasets/9705/annotate/9705-2021_03_20_093103.jpg,392.0,52.5,0.6125,0.14583333333333334,0.01875,0.04722222222222222
9705-2021_03_20_202437.jpg,bike,15,409,640,37,360,185,4,424,222,LTAdatasets/9705/annotate/9705-2021_03_20_202437.jpg,416.5,203.5,0.65078125,0.5652777777777778,0.0234375,0.10277777777777777
9705-2021_03_20_202437.jpg,van,71,250,640,76,360,284,3,321,360,LTAdatasets/9705/annotate/9705-2021_03_20_202437.jpg,285.5,322.0,0.44609375,0.8944444444444445,0.1109375,0.2111111111111111
9705-2021_03_20_202437.jpg,car,52,411,640,63,360,242,1,463,305,LTAdatasets/9705/annotate/9705-2021_03_20_202437.jpg,437.0,273.5,0.6828125,0.7597222222222222,0.08125,0.175
9705-2021_03_20_202437.jpg,car,19,360,640,17,360,78,1,379,95,LTAdatasets/9705/annotate/9705-2021_03_20_202437.jpg,369.5,86.5,0.57734375,0.24027777777777778,0.0296875,0.04722222222222222
9705-2021_03_20_202437.jpg,lorry_truck,21,305,640,28,360,89,2,326,117,LTAdatasets/9705/annotate/9705-2021_03_20_202437.jpg,315.5,103.0,0.49296875,0.2861111111111111,0.0328125,0.07777777777777778
9705-2021_03_20_202437.jpg,lorry_truck,41,142,640,38,360,171,2,183,209,LTAdatasets/9705/annotate/9705-2021_03_20_202437.jpg,162.5,190.0,0.25390625,0.5277777777777778,0.0640625,0.10555555555555556
9705-2021_03_20_202437.jpg,lorry_truck,19,469,640,18,360,59,2,488,77,LTAdatasets/9705/annotate/9705-2021_03_20_202437.jpg,478.5,68.0,0.74765625,0.18888888888888888,0.0296875,0.05
9705-2021_03_20_202437.jpg,car,10,409,640,9,360,57,1,419,66,LTAdatasets/9705/annotate/9705-2021_03_20_202437.jpg,414.0,61.5,0.646875,0.17083333333333334,0.015625,0.025
9705-2021_03_20_202437.jpg,car,17,444,640,9,360,47,1,461,56,LTAdatasets/9705/annotate/9705-2021_03_20_202437.jpg,452.5,51.5,0.70703125,0.14305555555555555,0.0265625,0.025
9705-2021_03_20_180110.jpg,car,34,388,640,42,360,155,1,422,197,LTAdatasets/9705/annotate/9705-2021_03_20_180110.jpg,405.0,176.0,0.6328125,0.4888888888888889,0.053125,0.11666666666666667
9705-2021_03_20_180110.jpg,van,44,182,640,27,360,153,3,226,180,LTAdatasets/9705/annotate/9705-2021_03_20_180110.jpg,204.0,166.5,0.31875,0.4625,0.06875,0.075
9705-2021_03_20_180110.jpg,lorry_truck,34,439,640,88,360,135,2,473,223,LTAdatasets/9705/annotate/9705-2021_03_20_180110.jpg,456.0,179.0,0.7125,0.49722222222222223,0.053125,0.24444444444444444
9705-2021_03_20_180110.jpg,lorry_truck,91,308,640,139,360,221,2,399,360,LTAdatasets/9705/annotate/9705-2021_03_20_180110.jpg,353.5,290.5,0.55234375,0.8069444444444445,0.1421875,0.3861111111111111
9705-2021_03_20_180110.jpg,lorry_truck,21,472,640,30,360,79,2,493,109,LTAdatasets/9705/annotate/9705-2021_03_20_180110.jpg,482.5,94.0,0.75390625,0.2611111111111111,0.0328125,0.08333333333333333
9705-2021_03_20_180110.jpg,car,14,452,640,13,360,66,1,466,79,LTAdatasets/9705/annotate/9705-2021_03_20_180110.jpg,459.0,72.5,0.7171875,0.2013888888888889,0.021875,0.03611111111111111
9705-2021_03_20_180110.jpg,car,12,474,640,10,360,66,1,486,76,LTAdatasets/9705/annotate/9705-2021_03_20_180110.jpg,480.0,71.0,0.75,0.19722222222222222,0.01875,0.027777777777777776
9705-2021_03_20_180110.jpg,car,11,371,640,11,360,79,1,382,90,LTAdatasets/9705/annotate/9705-2021_03_20_180110.jpg,376.5,84.5,0.58828125,0.23472222222222222,0.0171875,0.030555555555555555
9705-2021_03_20_180110.jpg,bike,9,355,640,14,360,77,4,364,91,LTAdatasets/9705/annotate/9705-2021_03_20_180110.jpg,359.5,84.0,0.56171875,0.23333333333333334,0.0140625,0.03888888888888889
9705-2021_03_20_180110.jpg,car,12,308,640,10,360,76,1,320,86,LTAdatasets/9705/annotate/9705-2021_03_20_180110.jpg,314.0,81.0,0.490625,0.225,0.01875,0.027777777777777776
9705-2021_03_20_180110.jpg,lorry_truck,12,361,640,17,360,60,2,373,77,LTAdatasets/9705/annotate/9705-2021_03_20_180110.jpg,367.0,68.5,0.5734375,0.19027777777777777,0.01875,0.04722222222222222
9705-2021_03_20_092803.jpg,car,50,270,640,64,360,192,1,320,256,LTAdatasets/9705/annotate/9705-2021_03_20_092803.jpg,295.0,224.0,0.4609375,0.6222222222222222,0.078125,0.17777777777777778
9705-2021_03_20_092803.jpg,lorry_truck,50,423,640,90,360,133,2,473,223,LTAdatasets/9705/annotate/9705-2021_03_20_092803.jpg,448.0,178.0,0.7,0.49444444444444446,0.078125,0.25
9705-2021_03_20_092803.jpg,lorry_truck,18,431,640,29,360,96,2,449,125,LTAdatasets/9705/annotate/9705-2021_03_20_092803.jpg,440.0,110.5,0.6875,0.30694444444444446,0.028125,0.08055555555555556
9705-2021_03_20_092803.jpg,lorry_truck,16,472,640,23,360,65,2,488,88,LTAdatasets/9705/annotate/9705-2021_03_20_092803.jpg,480.0,76.5,0.75,0.2125,0.025,0.06388888888888888
9705-2021_03_20_092803.jpg,lorry_truck,25,289,640,25,360,92,2,314,117,LTAdatasets/9705/annotate/9705-2021_03_20_092803.jpg,301.5,104.5,0.47109375,0.2902777777777778,0.0390625,0.06944444444444445
9705-2021_03_20_092803.jpg,lorry_truck,30,176,640,32,360,140,2,206,172,LTAdatasets/9705/annotate/9705-2021_03_20_092803.jpg,191.0,156.0,0.2984375,0.43333333333333335,0.046875,0.08888888888888889
9705-2021_03_20_092803.jpg,bike,16,217,640,21,360,142,4,233,163,LTAdatasets/9705/annotate/9705-2021_03_20_092803.jpg,225.0,152.5,0.3515625,0.4236111111111111,0.025,0.058333333333333334
9705-2021_03_20_092803.jpg,car,21,329,640,21,360,95,1,350,116,LTAdatasets/9705/annotate/9705-2021_03_20_092803.jpg,339.5,105.5,0.53046875,0.29305555555555557,0.0328125,0.058333333333333334
9705-2021_03_20_092803.jpg,car,19,384,640,28,360,112,1,403,140,LTAdatasets/9705/annotate/9705-2021_03_20_092803.jpg,393.5,126.0,0.61484375,0.35,0.0296875,0.07777777777777778
9705-2021_03_20_092803.jpg,car,14,419,640,14,360,83,1,433,97,LTAdatasets/9705/annotate/9705-2021_03_20_092803.jpg,426.0,90.0,0.665625,0.25,0.021875,0.03888888888888889
9705-2021_03_20_092803.jpg,van,16,446,640,17,360,75,3,462,92,LTAdatasets/9705/annotate/9705-2021_03_20_092803.jpg,454.0,83.5,0.709375,0.23194444444444445,0.025,0.04722222222222222
9705-2021_03_20_092803.jpg,car,10,438,640,12,360,70,1,448,82,LTAdatasets/9705/annotate/9705-2021_03_20_092803.jpg,443.0,76.0,0.6921875,0.2111111111111111,0.015625,0.03333333333333333
9705-2021_03_20_092803.jpg,car,9,403,640,10,360,52,1,412,62,LTAdatasets/9705/annotate/9705-2021_03_20_092803.jpg,407.5,57.0,0.63671875,0.15833333333333333,0.0140625,0.027777777777777776
9705-2021_03_20_181851.jpg,lorry_truck,90,270,640,170,360,182,2,360,352,LTAdatasets/9705/annotate/9705-2021_03_20_181851.jpg,315.0,267.0,0.4921875,0.7416666666666667,0.140625,0.4722222222222222
9705-2021_03_20_181851.jpg,lorry_truck,15,473,640,13,360,65,2,488,78,LTAdatasets/9705/annotate/9705-2021_03_20_181851.jpg,480.5,71.5,0.75078125,0.1986111111111111,0.0234375,0.03611111111111111
9705-2021_03_20_181851.jpg,lorry_truck,14,377,640,14,360,59,2,391,73,LTAdatasets/9705/annotate/9705-2021_03_20_181851.jpg,384.0,66.0,0.6,0.18333333333333332,0.021875,0.03888888888888889
9705-2021_03_20_181851.jpg,car,15,334,640,13,360,89,1,349,102,LTAdatasets/9705/annotate/9705-2021_03_20_181851.jpg,341.5,95.5,0.53359375,0.2652777777777778,0.0234375,0.03611111111111111
9705-2021_03_20_181851.jpg,car,18,369,640,11,360,78,1,387,89,LTAdatasets/9705/annotate/9705-2021_03_20_181851.jpg,378.0,83.5,0.590625,0.23194444444444445,0.028125,0.030555555555555555
9705-2021_03_20_181851.jpg,car,14,390,640,14,360,66,1,404,80,LTAdatasets/9705/annotate/9705-2021_03_20_181851.jpg,397.0,73.0,0.6203125,0.20277777777777778,0.021875,0.03888888888888889
9705-2021_03_20_181851.jpg,car,16,306,640,9,360,78,1,322,87,LTAdatasets/9705/annotate/9705-2021_03_20_181851.jpg,314.0,82.5,0.490625,0.22916666666666666,0.025,0.025
9705-2021_03_20_181851.jpg,car,12,332,640,5,360,65,1,344,70,LTAdatasets/9705/annotate/9705-2021_03_20_181851.jpg,338.0,67.5,0.528125,0.1875,0.01875,0.013888888888888888
9705-2021_03_20_181851.jpg,car,14,267,640,15,360,97,1,281,112,LTAdatasets/9705/annotate/9705-2021_03_20_181851.jpg,274.0,104.5,0.428125,0.2902777777777778,0.021875,0.041666666666666664
9705-2021_03_20_181851.jpg,bike,8,417,640,10,360,48,4,425,58,LTAdatasets/9705/annotate/9705-2021_03_20_181851.jpg,421.0,53.0,0.6578125,0.14722222222222223,0.0125,0.027777777777777776
9705-2021_03_20_181851.jpg,bike,10,347,640,15,360,94,4,357,109,LTAdatasets/9705/annotate/9705-2021_03_20_181851.jpg,352.0,101.5,0.55,0.28194444444444444,0.015625,0.041666666666666664
9705-2021_03_20_185453.jpg,car,54,69,640,37,360,245,1,123,282,LTAdatasets/9705/annotate/9705-2021_03_20_185453.jpg,96.0,263.5,0.15,0.7319444444444444,0.084375,0.10277777777777777
9705-2021_03_20_185453.jpg,car,27,408,640,25,360,129,1,435,154,LTAdatasets/9705/annotate/9705-2021_03_20_185453.jpg,421.5,141.5,0.65859375,0.39305555555555555,0.0421875,0.06944444444444445
9705-2021_03_20_185453.jpg,van,14,446,640,19,360,81,3,460,100,LTAdatasets/9705/annotate/9705-2021_03_20_185453.jpg,453.0,90.5,0.7078125,0.2513888888888889,0.021875,0.05277777777777778
9705-2021_03_20_185453.jpg,lorry_truck,19,471,640,25,360,63,2,490,88,LTAdatasets/9705/annotate/9705-2021_03_20_185453.jpg,480.5,75.5,0.75078125,0.20972222222222223,0.0296875,0.06944444444444445
9705-2021_03_20_185453.jpg,car,18,299,640,13,360,105,1,317,118,LTAdatasets/9705/annotate/9705-2021_03_20_185453.jpg,308.0,111.5,0.48125,0.30972222222222223,0.028125,0.03611111111111111
9705-2021_03_20_185453.jpg,car,16,359,640,14,360,85,1,375,99,LTAdatasets/9705/annotate/9705-2021_03_20_185453.jpg,367.0,92.0,0.5734375,0.25555555555555554,0.025,0.03888888888888889
9705-2021_03_20_185453.jpg,car,17,177,640,19,360,140,1,194,159,LTAdatasets/9705/annotate/9705-2021_03_20_185453.jpg,185.5,149.5,0.28984375,0.4152777777777778,0.0265625,0.05277777777777778
9705-2021_03_20_185453.jpg,lorry_truck,11,380,640,13,360,63,2,391,76,LTAdatasets/9705/annotate/9705-2021_03_20_185453.jpg,385.5,69.5,0.60234375,0.19305555555555556,0.0171875,0.03611111111111111
9705-2021_03_20_185453.jpg,bike,9,324,640,11,360,85,4,333,96,LTAdatasets/9705/annotate/9705-2021_03_20_185453.jpg,328.5,90.5,0.51328125,0.2513888888888889,0.0140625,0.030555555555555555
9705-2021_03_20_185453.jpg,bike,12,303,640,12,360,95,4,315,107,LTAdatasets/9705/annotate/9705-2021_03_20_185453.jpg,309.0,101.0,0.4828125,0.28055555555555556,0.01875,0.03333333333333333
9705-2021_03_20_183952.jpg,bike,13,368,640,28,360,177,4,381,205,LTAdatasets/9705/annotate/9705-2021_03_20_183952.jpg,374.5,191.0,0.58515625,0.5305555555555556,0.0203125,0.07777777777777778
9705-2021_03_20_183952.jpg,car,55,236,640,55,360,225,1,291,280,LTAdatasets/9705/annotate/9705-2021_03_20_183952.jpg,263.5,252.5,0.41171875,0.7013888888888888,0.0859375,0.1527777777777778
9705-2021_03_20_183952.jpg,car,17,318,640,16,360,112,1,335,128,LTAdatasets/9705/annotate/9705-2021_03_20_183952.jpg,326.5,120.0,0.51015625,0.3333333333333333,0.0265625,0.044444444444444446
9705-2021_03_20_183952.jpg,car,22,183,640,16,360,137,1,205,153,LTAdatasets/9705/annotate/9705-2021_03_20_183952.jpg,194.0,145.0,0.303125,0.4027777777777778,0.034375,0.044444444444444446
9705-2021_03_20_183952.jpg,car,35,156,640,16,360,180,1,191,196,LTAdatasets/9705/annotate/9705-2021_03_20_183952.jpg,173.5,188.0,0.27109375,0.5222222222222223,0.0546875,0.044444444444444446
9705-2021_03_20_183952.jpg,car,20,283,640,9,360,90,1,303,99,LTAdatasets/9705/annotate/9705-2021_03_20_183952.jpg,293.0,94.5,0.4578125,0.2625,0.03125,0.025
9705-2021_03_20_183952.jpg,car,13,395,640,13,360,62,1,408,75,LTAdatasets/9705/annotate/9705-2021_03_20_183952.jpg,401.5,68.5,0.62734375,0.19027777777777777,0.0203125,0.03611111111111111
9705-2021_03_20_183952.jpg,lorry_truck,31,288,640,31,360,96,2,319,127,LTAdatasets/9705/annotate/9705-2021_03_20_183952.jpg,303.5,111.5,0.47421875,0.30972222222222223,0.0484375,0.08611111111111111
9705-2021_03_20_183952.jpg,car,7,414,640,9,360,51,1,421,60,LTAdatasets/9705/annotate/9705-2021_03_20_183952.jpg,417.5,55.5,0.65234375,0.15416666666666667,0.0109375,0.025
9705-2021_03_20_183952.jpg,car,8,394,640,10,360,50,1,402,60,LTAdatasets/9705/annotate/9705-2021_03_20_183952.jpg,398.0,55.0,0.621875,0.1527777777777778,0.0125,0.027777777777777776
9705-2021_03_20_181251.jpg,car,14,409,640,20,360,93,1,423,113,LTAdatasets/9705/annotate/9705-2021_03_20_181251.jpg,416.0,103.0,0.65,0.2861111111111111,0.021875,0.05555555555555555
9705-2021_03_20_181251.jpg,car,16,442,640,17,360,93,1,458,110,LTAdatasets/9705/annotate/9705-2021_03_20_181251.jpg,450.0,101.5,0.703125,0.28194444444444444,0.025,0.04722222222222222
9705-2021_03_20_181251.jpg,car,11,384,640,9,360,64,1,395,73,LTAdatasets/9705/annotate/9705-2021_03_20_181251.jpg,389.5,68.5,0.60859375,0.19027777777777777,0.0171875,0.025
9705-2021_03_20_181251.jpg,van,12,323,640,11,360,68,3,335,79,LTAdatasets/9705/annotate/9705-2021_03_20_181251.jpg,329.0,73.5,0.5140625,0.20416666666666666,0.01875,0.030555555555555555
9705-2021_03_20_202758.jpg,car,28,432,640,61,360,193,1,460,254,LTAdatasets/9705/annotate/9705-2021_03_20_202758.jpg,446.0,223.5,0.696875,0.6208333333333333,0.04375,0.16944444444444445
9705-2021_03_20_202758.jpg,car,20,459,640,19,360,105,1,479,124,LTAdatasets/9705/annotate/9705-2021_03_20_202758.jpg,469.0,114.5,0.7328125,0.31805555555555554,0.03125,0.05277777777777778
9705-2021_03_20_202758.jpg,car,19,214,640,16,360,118,1,233,134,LTAdatasets/9705/annotate/9705-2021_03_20_202758.jpg,223.5,126.0,0.34921875,0.35,0.0296875,0.044444444444444446
9705-2021_03_20_202758.jpg,lorry_truck,24,266,640,20,360,84,2,290,104,LTAdatasets/9705/annotate/9705-2021_03_20_202758.jpg,278.0,94.0,0.434375,0.2611111111111111,0.0375,0.05555555555555555
9705-2021_03_20_193935.jpg,van,18,463,640,22,360,96,3,481,118,LTAdatasets/9705/annotate/9705-2021_03_20_193935.jpg,472.0,107.0,0.7375,0.2972222222222222,0.028125,0.06111111111111111
9705-2021_03_20_193935.jpg,car,21,305,640,16,360,112,1,326,128,LTAdatasets/9705/annotate/9705-2021_03_20_193935.jpg,315.5,120.0,0.49296875,0.3333333333333333,0.0328125,0.044444444444444446
9705-2021_03_20_193935.jpg,car,14,267,640,11,360,98,1,281,109,LTAdatasets/9705/annotate/9705-2021_03_20_193935.jpg,274.0,103.5,0.428125,0.2875,0.021875,0.030555555555555555
9705-2021_03_20_193935.jpg,car,13,364,640,10,360,73,1,377,83,LTAdatasets/9705/annotate/9705-2021_03_20_193935.jpg,370.5,78.0,0.57890625,0.21666666666666667,0.0203125,0.027777777777777776
9705-2021_03_20_193935.jpg,car,15,322,640,7,360,69,1,337,76,LTAdatasets/9705/annotate/9705-2021_03_20_193935.jpg,329.5,72.5,0.51484375,0.2013888888888889,0.0234375,0.019444444444444445
9705-2021_03_20_193935.jpg,lorry_truck,16,372,640,15,360,54,2,388,69,LTAdatasets/9705/annotate/9705-2021_03_20_193935.jpg,380.0,61.5,0.59375,0.17083333333333334,0.025,0.041666666666666664
9705-2021_03_20_193935.jpg,car,9,396,640,11,360,56,1,405,67,LTAdatasets/9705/annotate/9705-2021_03_20_193935.jpg,400.5,61.5,0.62578125,0.17083333333333334,0.0140625,0.030555555555555555
9705-2021_03_20_193935.jpg,bike,11,464,640,10,360,65,4,475,75,LTAdatasets/9705/annotate/9705-2021_03_20_193935.jpg,469.5,70.0,0.73359375,0.19444444444444445,0.0171875,0.027777777777777776
9705-2021_03_20_090102.jpg,van,35,170,640,24,360,165,3,205,189,LTAdatasets/9705/annotate/9705-2021_03_20_090102.jpg,187.5,177.0,0.29296875,0.49166666666666664,0.0546875,0.06666666666666667
9705-2021_03_20_090102.jpg,van,31,383,640,47,360,153,3,414,200,LTAdatasets/9705/annotate/9705-2021_03_20_090102.jpg,398.5,176.5,0.62265625,0.49027777777777776,0.0484375,0.13055555555555556
9705-2021_03_20_090102.jpg,lorry_truck,31,184,640,26,360,140,2,215,166,LTAdatasets/9705/annotate/9705-2021_03_20_090102.jpg,199.5,153.0,0.31171875,0.425,0.0484375,0.07222222222222222
9705-2021_03_20_090102.jpg,lorry_truck,38,439,640,61,360,124,2,477,185,LTAdatasets/9705/annotate/9705-2021_03_20_090102.jpg,458.0,154.5,0.715625,0.42916666666666664,0.059375,0.16944444444444445
9705-2021_03_20_090102.jpg,lorry_truck,16,318,640,15,360,82,2,334,97,LTAdatasets/9705/annotate/9705-2021_03_20_090102.jpg,326.0,89.5,0.509375,0.24861111111111112,0.025,0.041666666666666664
9705-2021_03_20_090102.jpg,car,11,366,640,13,360,70,1,377,83,LTAdatasets/9705/annotate/9705-2021_03_20_090102.jpg,371.5,76.5,0.58046875,0.2125,0.0171875,0.03611111111111111
9705-2021_03_20_090102.jpg,car,10,299,640,11,360,78,1,309,89,LTAdatasets/9705/annotate/9705-2021_03_20_090102.jpg,304.0,83.5,0.475,0.23194444444444445,0.015625,0.030555555555555555
9705-2021_03_20_090102.jpg,car,12,452,640,9,360,71,1,464,80,LTAdatasets/9705/annotate/9705-2021_03_20_090102.jpg,458.0,75.5,0.715625,0.20972222222222223,0.01875,0.025
9705-2021_03_20_090102.jpg,lorry_truck,10,475,640,16,360,58,2,485,74,LTAdatasets/9705/annotate/9705-2021_03_20_090102.jpg,480.0,66.0,0.75,0.18333333333333332,0.015625,0.044444444444444446
9705-2021_03_20_190634.jpg,car,15,310,640,8,360,74,1,325,82,LTAdatasets/9705/annotate/9705-2021_03_20_190634.jpg,317.5,78.0,0.49609375,0.21666666666666667,0.0234375,0.022222222222222223
9705-2021_03_20_190634.jpg,car,14,424,640,10,360,81,1,438,91,LTAdatasets/9705/annotate/9705-2021_03_20_190634.jpg,431.0,86.0,0.6734375,0.2388888888888889,0.021875,0.027777777777777776
9705-2021_03_20_190634.jpg,car,12,444,640,11,360,63,1,456,74,LTAdatasets/9705/annotate/9705-2021_03_20_190634.jpg,450.0,68.5,0.703125,0.19027777777777777,0.01875,0.030555555555555555
9705-2021_03_20_190634.jpg,car,20,354,640,11,360,89,1,374,100,LTAdatasets/9705/annotate/9705-2021_03_20_190634.jpg,364.0,94.5,0.56875,0.2625,0.03125,0.030555555555555555
9705-2021_03_20_190634.jpg,lorry_truck,19,358,640,14,360,70,2,377,84,LTAdatasets/9705/annotate/9705-2021_03_20_190634.jpg,367.5,77.0,0.57421875,0.21388888888888888,0.0296875,0.03888888888888889
9705-2021_03_20_190634.jpg,car,10,401,640,9,360,55,1,411,64,LTAdatasets/9705/annotate/9705-2021_03_20_190634.jpg,406.0,59.5,0.634375,0.16527777777777777,0.015625,0.025
9705-2021_03_20_190634.jpg,car,9,463,640,8,360,55,1,472,63,LTAdatasets/9705/annotate/9705-2021_03_20_190634.jpg,467.5,59.0,0.73046875,0.1638888888888889,0.0140625,0.022222222222222223
9705-2021_03_20_182151.jpg,lorry_truck,117,326,640,57,360,303,2,443,360,LTAdatasets/9705/annotate/9705-2021_03_20_182151.jpg,384.5,331.5,0.60078125,0.9208333333333333,0.1828125,0.15833333333333333
9705-2021_03_20_182151.jpg,car,35,439,640,43,360,172,1,474,215,LTAdatasets/9705/annotate/9705-2021_03_20_182151.jpg,456.5,193.5,0.71328125,0.5375,0.0546875,0.11944444444444445
9705-2021_03_20_182151.jpg,car,29,361,640,25,360,133,1,390,158,LTAdatasets/9705/annotate/9705-2021_03_20_182151.jpg,375.5,145.5,0.58671875,0.4041666666666667,0.0453125,0.06944444444444445
9705-2021_03_20_182151.jpg,car,21,405,640,17,360,102,1,426,119,LTAdatasets/9705/annotate/9705-2021_03_20_182151.jpg,415.5,110.5,0.64921875,0.30694444444444446,0.0328125,0.04722222222222222
9705-2021_03_20_182151.jpg,car,17,296,640,11,360,100,1,313,111,LTAdatasets/9705/annotate/9705-2021_03_20_182151.jpg,304.5,105.5,0.47578125,0.29305555555555557,0.0265625,0.030555555555555555
9705-2021_03_20_182151.jpg,van,16,288,640,11,360,85,3,304,96,LTAdatasets/9705/annotate/9705-2021_03_20_182151.jpg,296.0,90.5,0.4625,0.2513888888888889,0.025,0.030555555555555555
9705-2021_03_20_182151.jpg,van,15,446,640,18,360,88,3,461,106,LTAdatasets/9705/annotate/9705-2021_03_20_182151.jpg,453.5,97.0,0.70859375,0.26944444444444443,0.0234375,0.05
9705-2021_03_20_182151.jpg,car,12,427,640,16,360,69,1,439,85,LTAdatasets/9705/annotate/9705-2021_03_20_182151.jpg,433.0,77.0,0.6765625,0.21388888888888888,0.01875,0.044444444444444446
9705-2021_03_20_182151.jpg,bike,11,377,640,8,360,75,4,388,83,LTAdatasets/9705/annotate/9705-2021_03_20_182151.jpg,382.5,79.0,0.59765625,0.21944444444444444,0.0171875,0.022222222222222223
9705-2021_03_20_182151.jpg,bike,10,389,640,9,360,63,4,399,72,LTAdatasets/9705/annotate/9705-2021_03_20_182151.jpg,394.0,67.5,0.615625,0.1875,0.015625,0.025
9705-2021_03_20_182151.jpg,car,11,448,640,14,360,76,1,459,90,LTAdatasets/9705/annotate/9705-2021_03_20_182151.jpg,453.5,83.0,0.70859375,0.23055555555555557,0.0171875,0.03888888888888889
9705-2021_03_20_182151.jpg,lorry_truck,10,369,640,14,360,68,2,379,82,LTAdatasets/9705/annotate/9705-2021_03_20_182151.jpg,374.0,75.0,0.584375,0.20833333333333334,0.015625,0.03888888888888889
9705-2021_03_20_182151.jpg,lorry_truck,15,473,640,20,360,56,2,488,76,LTAdatasets/9705/annotate/9705-2021_03_20_182151.jpg,480.5,66.0,0.75078125,0.18333333333333332,0.0234375,0.05555555555555555
9705-2021_03_20_200637.jpg,lorry_truck,21,277,640,20,360,103,2,298,123,LTAdatasets/9705/annotate/9705-2021_03_20_200637.jpg,287.5,113.0,0.44921875,0.3138888888888889,0.0328125,0.05555555555555555
9705-2021_03_20_200637.jpg,lorry_truck,55,190,640,31,360,140,2,245,171,LTAdatasets/9705/annotate/9705-2021_03_20_200637.jpg,217.5,155.5,0.33984375,0.43194444444444446,0.0859375,0.08611111111111111
9705-2021_03_20_200637.jpg,bus,16,474,640,22,360,58,5,490,80,LTAdatasets/9705/annotate/9705-2021_03_20_200637.jpg,482.0,69.0,0.753125,0.19166666666666668,0.025,0.06111111111111111
9705-2021_03_20_200637.jpg,car,39,208,640,28,360,164,1,247,192,LTAdatasets/9705/annotate/9705-2021_03_20_200637.jpg,227.5,178.0,0.35546875,0.49444444444444446,0.0609375,0.07777777777777778
9705-2021_03_20_200637.jpg,car,17,285,640,9,360,89,1,302,98,LTAdatasets/9705/annotate/9705-2021_03_20_200637.jpg,293.5,93.5,0.45859375,0.25972222222222224,0.0265625,0.025
9705-2021_03_20_200637.jpg,lorry_truck,16,369,640,11,360,60,2,385,71,LTAdatasets/9705/annotate/9705-2021_03_20_200637.jpg,377.0,65.5,0.5890625,0.18194444444444444,0.025,0.030555555555555555
9705-2021_03_20_200637.jpg,car,15,438,640,12,360,57,1,453,69,LTAdatasets/9705/annotate/9705-2021_03_20_200637.jpg,445.5,63.0,0.69609375,0.175,0.0234375,0.03333333333333333
9705-2021_03_20_184613.jpg,bike,15,462,640,21,360,139,4,477,160,LTAdatasets/9705/annotate/9705-2021_03_20_184613.jpg,469.5,149.5,0.73359375,0.4152777777777778,0.0234375,0.058333333333333334
9705-2021_03_20_184613.jpg,bike,16,287,640,20,360,124,4,303,144,LTAdatasets/9705/annotate/9705-2021_03_20_184613.jpg,295.0,134.0,0.4609375,0.37222222222222223,0.025,0.05555555555555555
9705-2021_03_20_184613.jpg,bike,11,311,640,11,360,95,4,322,106,LTAdatasets/9705/annotate/9705-2021_03_20_184613.jpg,316.5,100.5,0.49453125,0.2791666666666667,0.0171875,0.030555555555555555
9705-2021_03_20_184613.jpg,car,23,244,640,17,360,134,1,267,151,LTAdatasets/9705/annotate/9705-2021_03_20_184613.jpg,255.5,142.5,0.39921875,0.3958333333333333,0.0359375,0.04722222222222222
9705-2021_03_20_184613.jpg,lorry_truck,22,271,640,34,360,91,2,293,125,LTAdatasets/9705/annotate/9705-2021_03_20_184613.jpg,282.0,108.0,0.440625,0.3,0.034375,0.09444444444444444
9705-2021_03_20_184613.jpg,car,16,326,640,15,360,93,1,342,108,LTAdatasets/9705/annotate/9705-2021_03_20_184613.jpg,334.0,100.5,0.521875,0.2791666666666667,0.025,0.041666666666666664
9705-2021_03_20_184613.jpg,car,9,375,640,8,360,60,1,384,68,LTAdatasets/9705/annotate/9705-2021_03_20_184613.jpg,379.5,64.0,0.59296875,0.17777777777777778,0.0140625,0.022222222222222223
9705-2021_03_20_184613.jpg,car,12,400,640,12,360,59,1,412,71,LTAdatasets/9705/annotate/9705-2021_03_20_184613.jpg,406.0,65.0,0.634375,0.18055555555555555,0.01875,0.03333333333333333
9705-2021_03_20_184613.jpg,car,9,459,640,8,360,52,1,468,60,LTAdatasets/9705/annotate/9705-2021_03_20_184613.jpg,463.5,56.0,0.72421875,0.15555555555555556,0.0140625,0.022222222222222223
9705-2021_03_20_184613.jpg,lorry_truck,9,474,640,15,360,48,2,483,63,LTAdatasets/9705/annotate/9705-2021_03_20_184613.jpg,478.5,55.5,0.74765625,0.15416666666666667,0.0140625,0.041666666666666664
9705-2021_03_20_085822.jpg,car,10,329,640,6,360,65,1,339,71,LTAdatasets/9705/annotate/9705-2021_03_20_085822.jpg,334.0,68.0,0.521875,0.18888888888888888,0.015625,0.016666666666666666
9705-2021_03_20_085822.jpg,lorry_truck,18,471,640,21,360,46,2,489,67,LTAdatasets/9705/annotate/9705-2021_03_20_085822.jpg,480.0,56.5,0.75,0.15694444444444444,0.028125,0.058333333333333334
9705-2021_03_20_085822.jpg,van,7,391,640,8,360,50,3,398,58,LTAdatasets/9705/annotate/9705-2021_03_20_085822.jpg,394.5,54.0,0.61640625,0.15,0.0109375,0.022222222222222223
9705-2021_03_20_072517.jpg,car,66,142,640,52,360,308,1,208,360,LTAdatasets/9705/annotate/9705-2021_03_20_072517.jpg,175.0,334.0,0.2734375,0.9277777777777778,0.103125,0.14444444444444443
9705-2021_03_20_072517.jpg,lorry_truck,33,195,640,25,360,135,2,228,160,LTAdatasets/9705/annotate/9705-2021_03_20_072517.jpg,211.5,147.5,0.33046875,0.4097222222222222,0.0515625,0.06944444444444445
9705-2021_03_20_072517.jpg,bike,15,471,640,24,360,133,4,486,157,LTAdatasets/9705/annotate/9705-2021_03_20_072517.jpg,478.5,145.0,0.74765625,0.4027777777777778,0.0234375,0.06666666666666667
9705-2021_03_20_072517.jpg,bike,14,421,640,15,360,85,4,435,100,LTAdatasets/9705/annotate/9705-2021_03_20_072517.jpg,428.0,92.5,0.66875,0.2569444444444444,0.021875,0.041666666666666664
9705-2021_03_20_072517.jpg,bike,25,52,640,29,360,259,4,77,288,LTAdatasets/9705/annotate/9705-2021_03_20_072517.jpg,64.5,273.5,0.10078125,0.7597222222222222,0.0390625,0.08055555555555556
9705-2021_03_20_072517.jpg,van,46,1,640,49,360,245,3,47,294,LTAdatasets/9705/annotate/9705-2021_03_20_072517.jpg,24.0,269.5,0.0375,0.7486111111111111,0.071875,0.1361111111111111
9705-2021_03_20_072517.jpg,lorry_truck,26,459,640,35,360,86,2,485,121,LTAdatasets/9705/annotate/9705-2021_03_20_072517.jpg,472.0,103.5,0.7375,0.2875,0.040625,0.09722222222222222
9705-2021_03_20_072517.jpg,lorry_truck,10,470,640,19,360,45,2,480,64,LTAdatasets/9705/annotate/9705-2021_03_20_072517.jpg,475.0,54.5,0.7421875,0.15138888888888888,0.015625,0.05277777777777778
9705-2021_03_20_072517.jpg,bike,7,412,640,11,360,49,4,419,60,LTAdatasets/9705/annotate/9705-2021_03_20_072517.jpg,415.5,54.5,0.64921875,0.15138888888888888,0.0109375,0.030555555555555555
9705-2021_03_20_181551.jpg,van,37,432,640,62,360,174,3,469,236,LTAdatasets/9705/annotate/9705-2021_03_20_181551.jpg,450.5,205.0,0.70390625,0.5694444444444444,0.0578125,0.17222222222222222
9705-2021_03_20_181551.jpg,car,20,246,640,18,360,137,1,266,155,LTAdatasets/9705/annotate/9705-2021_03_20_181551.jpg,256.0,146.0,0.4,0.40555555555555556,0.03125,0.05
9705-2021_03_20_181551.jpg,lorry_truck,25,297,640,21,360,101,2,322,122,LTAdatasets/9705/annotate/9705-2021_03_20_181551.jpg,309.5,111.5,0.48359375,0.30972222222222223,0.0390625,0.058333333333333334
9705-2021_03_20_181551.jpg,lorry_truck,21,270,640,26,360,99,2,291,125,LTAdatasets/9705/annotate/9705-2021_03_20_181551.jpg,280.5,112.0,0.43828125,0.3111111111111111,0.0328125,0.07222222222222222
9705-2021_03_20_181551.jpg,lorry_truck,17,326,640,17,360,79,2,343,96,LTAdatasets/9705/annotate/9705-2021_03_20_181551.jpg,334.5,87.5,0.52265625,0.24305555555555555,0.0265625,0.04722222222222222
9705-2021_03_20_181551.jpg,lorry_truck,21,350,640,19,360,70,2,371,89,LTAdatasets/9705/annotate/9705-2021_03_20_181551.jpg,360.5,79.5,0.56328125,0.22083333333333333,0.0328125,0.05277777777777778
9705-2021_03_20_181551.jpg,van,11,475,640,13,360,55,3,486,68,LTAdatasets/9705/annotate/9705-2021_03_20_181551.jpg,480.5,61.5,0.75078125,0.17083333333333334,0.0171875,0.03611111111111111
9705-2021_03_20_181551.jpg,car,8,438,640,14,360,63,1,446,77,LTAdatasets/9705/annotate/9705-2021_03_20_181551.jpg,442.0,70.0,0.690625,0.19444444444444445,0.0125,0.03888888888888889
9705-2021_03_20_181551.jpg,car,14,456,640,10,360,62,1,470,72,LTAdatasets/9705/annotate/9705-2021_03_20_181551.jpg,463.0,67.0,0.7234375,0.18611111111111112,0.021875,0.027777777777777776
9705-2021_03_20_181551.jpg,car,10,384,640,11,360,72,1,394,83,LTAdatasets/9705/annotate/9705-2021_03_20_181551.jpg,389.0,77.5,0.6078125,0.2152777777777778,0.015625,0.030555555555555555
9705-2021_03_20_181551.jpg,car,10,406,640,8,360,59,1,416,67,LTAdatasets/9705/annotate/9705-2021_03_20_181551.jpg,411.0,63.0,0.6421875,0.175,0.015625,0.022222222222222223
9705-2021_03_20_181551.jpg,car,8,416,640,8,360,51,1,424,59,LTAdatasets/9705/annotate/9705-2021_03_20_181551.jpg,420.0,55.0,0.65625,0.1527777777777778,0.0125,0.022222222222222223
9705-2021_03_20_181551.jpg,car,11,399,640,7,360,54,1,410,61,LTAdatasets/9705/annotate/9705-2021_03_20_181551.jpg,404.5,57.5,0.63203125,0.1597222222222222,0.0171875,0.019444444444444445
9705-2021_03_20_190413.jpg,bike,23,418,640,48,360,264,4,441,312,LTAdatasets/9705/annotate/9705-2021_03_20_190413.jpg,429.5,288.0,0.67109375,0.8,0.0359375,0.13333333333333333
9705-2021_03_20_190413.jpg,lorry_truck,17,441,640,16,360,82,2,458,98,LTAdatasets/9705/annotate/9705-2021_03_20_190413.jpg,449.5,90.0,0.70234375,0.25,0.0265625,0.044444444444444446
9705-2021_03_20_190413.jpg,car,11,312,640,9,360,75,1,323,84,LTAdatasets/9705/annotate/9705-2021_03_20_190413.jpg,317.5,79.5,0.49609375,0.22083333333333333,0.0171875,0.025
9705-2021_03_20_190413.jpg,car,12,458,640,12,360,60,1,470,72,LTAdatasets/9705/annotate/9705-2021_03_20_190413.jpg,464.0,66.0,0.725,0.18333333333333332,0.01875,0.03333333333333333
9705-2021_03_20_192214.jpg,car,35,169,640,30,360,168,1,204,198,LTAdatasets/9705/annotate/9705-2021_03_20_192214.jpg,186.5,183.0,0.29140625,0.5083333333333333,0.0546875,0.08333333333333333
9705-2021_03_20_192214.jpg,car,25,171,640,16,360,146,1,196,162,LTAdatasets/9705/annotate/9705-2021_03_20_192214.jpg,183.5,154.0,0.28671875,0.42777777777777776,0.0390625,0.044444444444444446
9705-2021_03_20_192214.jpg,car,21,335,640,15,360,89,1,356,104,LTAdatasets/9705/annotate/9705-2021_03_20_192214.jpg,345.5,96.5,0.53984375,0.26805555555555555,0.0328125,0.041666666666666664
9705-2021_03_20_192214.jpg,bike,8,369,640,13,360,64,4,377,77,LTAdatasets/9705/annotate/9705-2021_03_20_192214.jpg,373.0,70.5,0.5828125,0.19583333333333333,0.0125,0.03611111111111111
9705-2021_03_20_192214.jpg,van,16,444,640,19,360,80,3,460,99,LTAdatasets/9705/annotate/9705-2021_03_20_192214.jpg,452.0,89.5,0.70625,0.24861111111111112,0.025,0.05277777777777778
9705-2021_03_20_192214.jpg,car,10,456,640,8,360,64,1,466,72,LTAdatasets/9705/annotate/9705-2021_03_20_192214.jpg,461.0,68.0,0.7203125,0.18888888888888888,0.015625,0.022222222222222223
9705-2021_03_20_192214.jpg,car,11,456,640,7,360,56,1,467,63,LTAdatasets/9705/annotate/9705-2021_03_20_192214.jpg,461.5,59.5,0.72109375,0.16527777777777777,0.0171875,0.019444444444444445
9705-2021_03_20_192214.jpg,lorry_truck,15,471,640,19,360,47,2,486,66,LTAdatasets/9705/annotate/9705-2021_03_20_192214.jpg,478.5,56.5,0.74765625,0.15694444444444444,0.0234375,0.05277777777777778
9705-2021_03_20_192214.jpg,lorry_truck,20,310,640,23,360,78,2,330,101,LTAdatasets/9705/annotate/9705-2021_03_20_192214.jpg,320.0,89.5,0.5,0.24861111111111112,0.03125,0.06388888888888888
9705-2021_03_20_192214.jpg,car,8,411,640,7,360,54,1,419,61,LTAdatasets/9705/annotate/9705-2021_03_20_192214.jpg,415.0,57.5,0.6484375,0.1597222222222222,0.0125,0.019444444444444445
9705-2021_03_20_200937.jpg,bike,13,437,640,24,360,122,4,450,146,LTAdatasets/9705/annotate/9705-2021_03_20_200937.jpg,443.5,134.0,0.69296875,0.37222222222222223,0.0203125,0.06666666666666667
9705-2021_03_20_200937.jpg,car,18,277,640,11,360,91,1,295,102,LTAdatasets/9705/annotate/9705-2021_03_20_200937.jpg,286.0,96.5,0.446875,0.26805555555555555,0.028125,0.030555555555555555
9705-2021_03_20_200937.jpg,bike,7,304,640,11,360,77,4,311,88,LTAdatasets/9705/annotate/9705-2021_03_20_200937.jpg,307.5,82.5,0.48046875,0.22916666666666666,0.0109375,0.030555555555555555
9705-2021_03_20_200937.jpg,lorry_truck,24,463,640,28,360,88,2,487,116,LTAdatasets/9705/annotate/9705-2021_03_20_200937.jpg,475.0,102.0,0.7421875,0.2833333333333333,0.0375,0.07777777777777778
9705-2021_03_20_200937.jpg,van,16,470,640,15,360,75,3,486,90,LTAdatasets/9705/annotate/9705-2021_03_20_200937.jpg,478.0,82.5,0.746875,0.22916666666666666,0.025,0.041666666666666664
9705-2021_03_20_200937.jpg,lorry_truck,12,368,640,13,360,60,2,380,73,LTAdatasets/9705/annotate/9705-2021_03_20_200937.jpg,374.0,66.5,0.584375,0.18472222222222223,0.01875,0.03611111111111111
9705-2021_03_20_200937.jpg,car,11,447,640,8,360,47,1,458,55,LTAdatasets/9705/annotate/9705-2021_03_20_200937.jpg,452.5,51.0,0.70703125,0.14166666666666666,0.0171875,0.022222222222222223
9705-2021_03_20_200937.jpg,car,9,461,640,10,360,50,1,470,60,LTAdatasets/9705/annotate/9705-2021_03_20_200937.jpg,465.5,55.0,0.72734375,0.1527777777777778,0.0140625,0.027777777777777776
9705-2021_03_20_080419.jpg,bike,17,456,640,25,360,144,4,473,169,LTAdatasets/9705/annotate/9705-2021_03_20_080419.jpg,464.5,156.5,0.72578125,0.43472222222222223,0.0265625,0.06944444444444445
9705-2021_03_20_080419.jpg,bike,10,318,640,16,360,104,4,328,120,LTAdatasets/9705/annotate/9705-2021_03_20_080419.jpg,323.0,112.0,0.5046875,0.3111111111111111,0.015625,0.044444444444444446
9705-2021_03_20_080419.jpg,lorry_truck,22,471,640,33,360,82,2,493,115,LTAdatasets/9705/annotate/9705-2021_03_20_080419.jpg,482.0,98.5,0.753125,0.27361111111111114,0.034375,0.09166666666666666
9705-2021_03_20_080419.jpg,lorry_truck,29,285,640,20,360,105,2,314,125,LTAdatasets/9705/annotate/9705-2021_03_20_080419.jpg,299.5,115.0,0.46796875,0.3194444444444444,0.0453125,0.05555555555555555
9705-2021_03_20_080419.jpg,bus,17,474,640,19,360,52,5,491,71,LTAdatasets/9705/annotate/9705-2021_03_20_080419.jpg,482.5,61.5,0.75390625,0.17083333333333334,0.0265625,0.05277777777777778
9705-2021_03_20_080419.jpg,car,15,454,640,12,360,63,1,469,75,LTAdatasets/9705/annotate/9705-2021_03_20_080419.jpg,461.5,69.0,0.72109375,0.19166666666666668,0.0234375,0.03333333333333333
9705-2021_03_20_080419.jpg,car,38,162,640,20,360,176,1,200,196,LTAdatasets/9705/annotate/9705-2021_03_20_080419.jpg,181.0,186.0,0.2828125,0.5166666666666667,0.059375,0.05555555555555555
9705-2021_03_20_080419.jpg,car,8,408,640,10,360,55,1,416,65,LTAdatasets/9705/annotate/9705-2021_03_20_080419.jpg,412.0,60.0,0.64375,0.16666666666666666,0.0125,0.027777777777777776
9705-2021_03_20_090402.jpg,bike,11,461,640,21,360,130,4,472,151,LTAdatasets/9705/annotate/9705-2021_03_20_090402.jpg,466.5,140.5,0.72890625,0.3902777777777778,0.0171875,0.058333333333333334
9705-2021_03_20_090402.jpg,lorry_truck,21,315,640,20,360,79,2,336,99,LTAdatasets/9705/annotate/9705-2021_03_20_090402.jpg,325.5,89.0,0.50859375,0.24722222222222223,0.0328125,0.05555555555555555
9705-2021_03_20_090402.jpg,lorry_truck,10,368,640,12,360,57,2,378,69,LTAdatasets/9705/annotate/9705-2021_03_20_090402.jpg,373.0,63.0,0.5828125,0.175,0.015625,0.03333333333333333
9705-2021_03_20_090402.jpg,lorry_truck,15,319,640,12,360,62,2,334,74,LTAdatasets/9705/annotate/9705-2021_03_20_090402.jpg,326.5,68.0,0.51015625,0.18888888888888888,0.0234375,0.03333333333333333
9705-2021_03_20_090402.jpg,car,15,308,640,12,360,71,1,323,83,LTAdatasets/9705/annotate/9705-2021_03_20_090402.jpg,315.5,77.0,0.49296875,0.21388888888888888,0.0234375,0.03333333333333333
9705-2021_03_20_090402.jpg,bike,23,127,640,26,360,194,4,150,220,LTAdatasets/9705/annotate/9705-2021_03_20_090402.jpg,138.5,207.0,0.21640625,0.575,0.0359375,0.07222222222222222
9705-2021_03_20_090402.jpg,lorry_truck,12,395,640,13,360,43,2,407,56,LTAdatasets/9705/annotate/9705-2021_03_20_090402.jpg,401.0,49.5,0.6265625,0.1375,0.01875,0.03611111111111111
9705-2021_03_20_074318.jpg,bike,13,397,640,17,360,107,4,410,124,LTAdatasets/9705/annotate/9705-2021_03_20_074318.jpg,403.5,115.5,0.63046875,0.32083333333333336,0.0203125,0.04722222222222222
9705-2021_03_20_074318.jpg,bike,9,479,640,16,360,79,4,488,95,LTAdatasets/9705/annotate/9705-2021_03_20_074318.jpg,483.5,87.0,0.75546875,0.24166666666666667,0.0140625,0.044444444444444446
9705-2021_03_20_074318.jpg,bike,10,373,640,14,360,74,4,383,88,LTAdatasets/9705/annotate/9705-2021_03_20_074318.jpg,378.0,81.0,0.590625,0.225,0.015625,0.03888888888888889
9705-2021_03_20_074318.jpg,bike,12,327,640,14,360,89,4,339,103,LTAdatasets/9705/annotate/9705-2021_03_20_074318.jpg,333.0,96.0,0.5203125,0.26666666666666666,0.01875,0.03888888888888889
9705-2021_03_20_074318.jpg,bike,23,129,640,25,360,212,4,152,237,LTAdatasets/9705/annotate/9705-2021_03_20_074318.jpg,140.5,224.5,0.21953125,0.6236111111111111,0.0359375,0.06944444444444445
9705-2021_03_20_074318.jpg,lorry_truck,51,343,640,93,360,238,2,394,331,LTAdatasets/9705/annotate/9705-2021_03_20_074318.jpg,368.5,284.5,0.57578125,0.7902777777777777,0.0796875,0.25833333333333336
9705-2021_03_20_074318.jpg,van,22,273,640,14,360,109,3,295,123,LTAdatasets/9705/annotate/9705-2021_03_20_074318.jpg,284.0,116.0,0.44375,0.32222222222222224,0.034375,0.03888888888888889
9705-2021_03_20_074318.jpg,van,30,255,640,19,360,127,3,285,146,LTAdatasets/9705/annotate/9705-2021_03_20_074318.jpg,270.0,136.5,0.421875,0.37916666666666665,0.046875,0.05277777777777778
9705-2021_03_20_074318.jpg,car,31,249,640,19,360,149,1,280,168,LTAdatasets/9705/annotate/9705-2021_03_20_074318.jpg,264.5,158.5,0.41328125,0.44027777777777777,0.0484375,0.05277777777777778
9705-2021_03_20_074318.jpg,lorry_truck,22,439,640,30,360,78,2,461,108,LTAdatasets/9705/annotate/9705-2021_03_20_074318.jpg,450.0,93.0,0.703125,0.25833333333333336,0.034375,0.08333333333333333
9705-2021_03_20_074318.jpg,car,7,325,640,8,360,71,1,332,79,LTAdatasets/9705/annotate/9705-2021_03_20_074318.jpg,328.5,75.0,0.51328125,0.20833333333333334,0.0109375,0.022222222222222223
9705-2021_03_20_090702.jpg,car,22,286,640,12,360,100,1,308,112,LTAdatasets/9705/annotate/9705-2021_03_20_090702.jpg,297.0,106.0,0.4640625,0.29444444444444445,0.034375,0.03333333333333333
9705-2021_03_20_090702.jpg,car,13,380,640,10,360,71,1,393,81,LTAdatasets/9705/annotate/9705-2021_03_20_090702.jpg,386.5,76.0,0.60390625,0.2111111111111111,0.0203125,0.027777777777777776
9705-2021_03_20_090702.jpg,car,18,433,640,10,360,70,1,451,80,LTAdatasets/9705/annotate/9705-2021_03_20_090702.jpg,442.0,75.0,0.690625,0.20833333333333334,0.028125,0.027777777777777776
9705-2021_03_20_090702.jpg,car,8,459,640,10,360,60,1,467,70,LTAdatasets/9705/annotate/9705-2021_03_20_090702.jpg,463.0,65.0,0.7234375,0.18055555555555555,0.0125,0.027777777777777776
9705-2021_03_20_090702.jpg,car,10,438,640,8,360,59,1,448,67,LTAdatasets/9705/annotate/9705-2021_03_20_090702.jpg,443.0,63.0,0.6921875,0.175,0.015625,0.022222222222222223
9705-2021_03_20_090702.jpg,car,14,384,640,8,360,59,1,398,67,LTAdatasets/9705/annotate/9705-2021_03_20_090702.jpg,391.0,63.0,0.6109375,0.175,0.021875,0.022222222222222223
9705-2021_03_20_090702.jpg,lorry_truck,20,346,640,14,360,65,2,366,79,LTAdatasets/9705/annotate/9705-2021_03_20_090702.jpg,356.0,72.0,0.55625,0.2,0.03125,0.03888888888888889
9705-2021_03_20_090702.jpg,lorry_truck,56,11,640,31,360,222,2,67,253,LTAdatasets/9705/annotate/9705-2021_03_20_090702.jpg,39.0,237.5,0.0609375,0.6597222222222222,0.0875,0.08611111111111111
9705-2021_03_20_090702.jpg,lorry_truck,15,472,640,17,360,46,2,487,63,LTAdatasets/9705/annotate/9705-2021_03_20_090702.jpg,479.5,54.5,0.74921875,0.15138888888888888,0.0234375,0.04722222222222222
9705-2021_03_20_090702.jpg,car,12,398,640,8,360,52,1,410,60,LTAdatasets/9705/annotate/9705-2021_03_20_090702.jpg,404.0,56.0,0.63125,0.15555555555555556,0.01875,0.022222222222222223
9705-2021_03_20_203058.jpg,bike,19,456,640,28,360,166,4,475,194,LTAdatasets/9705/annotate/9705-2021_03_20_203058.jpg,465.5,180.0,0.72734375,0.5,0.0296875,0.07777777777777778
9705-2021_03_20_203058.jpg,car,23,401,640,24,360,96,1,424,120,LTAdatasets/9705/annotate/9705-2021_03_20_203058.jpg,412.5,108.0,0.64453125,0.3,0.0359375,0.06666666666666667
9705-2021_03_20_203058.jpg,bike,10,474,640,15,360,68,4,484,83,LTAdatasets/9705/annotate/9705-2021_03_20_203058.jpg,479.0,75.5,0.7484375,0.20972222222222223,0.015625,0.041666666666666664
9705-2021_03_20_203058.jpg,lorry_truck,17,269,640,13,360,95,2,286,108,LTAdatasets/9705/annotate/9705-2021_03_20_203058.jpg,277.5,101.5,0.43359375,0.28194444444444444,0.0265625,0.03611111111111111
9705-2021_03_20_203058.jpg,car,18,174,640,14,360,144,1,192,158,LTAdatasets/9705/annotate/9705-2021_03_20_203058.jpg,183.0,151.0,0.2859375,0.41944444444444445,0.028125,0.03888888888888889
9705-2021_03_20_203058.jpg,car,12,329,640,11,360,65,1,341,76,LTAdatasets/9705/annotate/9705-2021_03_20_203058.jpg,335.0,70.5,0.5234375,0.19583333333333333,0.01875,0.030555555555555555
9705-2021_03_20_203058.jpg,car,9,472,640,10,360,49,1,481,59,LTAdatasets/9705/annotate/9705-2021_03_20_203058.jpg,476.5,54.0,0.74453125,0.15,0.0140625,0.027777777777777776
9705-2021_03_20_082220.jpg,lorry_truck,32,177,640,31,360,156,2,209,187,LTAdatasets/9705/annotate/9705-2021_03_20_082220.jpg,193.0,171.5,0.3015625,0.47638888888888886,0.05,0.08611111111111111
9705-2021_03_20_082220.jpg,lorry_truck,35,393,640,58,360,118,2,428,176,LTAdatasets/9705/annotate/9705-2021_03_20_082220.jpg,410.5,147.0,0.64140625,0.4083333333333333,0.0546875,0.16111111111111112
9705-2021_03_20_082220.jpg,car,43,1,640,32,360,295,1,44,327,LTAdatasets/9705/annotate/9705-2021_03_20_082220.jpg,22.5,311.0,0.03515625,0.8638888888888889,0.0671875,0.08888888888888889
9705-2021_03_20_082220.jpg,car,14,448,640,11,360,83,1,462,94,LTAdatasets/9705/annotate/9705-2021_03_20_082220.jpg,455.0,88.5,0.7109375,0.24583333333333332,0.021875,0.030555555555555555
9705-2021_03_20_082220.jpg,car,11,373,640,8,360,68,1,384,76,LTAdatasets/9705/annotate/9705-2021_03_20_082220.jpg,378.5,72.0,0.59140625,0.2,0.0171875,0.022222222222222223
9705-2021_03_20_082220.jpg,car,8,411,640,7,360,51,1,419,58,LTAdatasets/9705/annotate/9705-2021_03_20_082220.jpg,415.0,54.5,0.6484375,0.15138888888888888,0.0125,0.019444444444444445
9705-2021_03_20_082220.jpg,car,12,449,640,10,360,51,1,461,61,LTAdatasets/9705/annotate/9705-2021_03_20_082220.jpg,455.0,56.0,0.7109375,0.15555555555555556,0.01875,0.027777777777777776
9705-2021_03_20_082220.jpg,bus,32,461,640,48,360,87,5,493,135,LTAdatasets/9705/annotate/9705-2021_03_20_082220.jpg,477.0,111.0,0.7453125,0.30833333333333335,0.05,0.13333333333333333
9705-2021_03_20_073037.jpg,lorry_truck,30,460,640,41,360,104,2,490,145,LTAdatasets/9705/annotate/9705-2021_03_20_073037.jpg,475.0,124.5,0.7421875,0.3458333333333333,0.046875,0.11388888888888889
9705-2021_03_20_073037.jpg,car,47,54,640,38,360,241,1,101,279,LTAdatasets/9705/annotate/9705-2021_03_20_073037.jpg,77.5,260.0,0.12109375,0.7222222222222222,0.0734375,0.10555555555555556
9705-2021_03_20_073037.jpg,car,23,275,640,18,360,115,1,298,133,LTAdatasets/9705/annotate/9705-2021_03_20_073037.jpg,286.5,124.0,0.44765625,0.34444444444444444,0.0359375,0.05
9705-2021_03_20_073037.jpg,van,12,449,640,14,360,74,3,461,88,LTAdatasets/9705/annotate/9705-2021_03_20_073037.jpg,455.0,81.0,0.7109375,0.225,0.01875,0.03888888888888889
9705-2021_03_20_073037.jpg,lorry_truck,14,475,640,16,360,59,2,489,75,LTAdatasets/9705/annotate/9705-2021_03_20_073037.jpg,482.0,67.0,0.753125,0.18611111111111112,0.021875,0.044444444444444446
9705-2021_03_20_073037.jpg,lorry_truck,10,393,640,12,360,48,2,403,60,LTAdatasets/9705/annotate/9705-2021_03_20_073037.jpg,398.0,54.0,0.621875,0.15,0.015625,0.03333333333333333
9705-2021_03_20_073037.jpg,car,12,458,640,9,360,54,1,470,63,LTAdatasets/9705/annotate/9705-2021_03_20_073037.jpg,464.0,58.5,0.725,0.1625,0.01875,0.025
9705-2021_03_20_073037.jpg,bike,9,373,640,12,360,69,4,382,81,LTAdatasets/9705/annotate/9705-2021_03_20_073037.jpg,377.5,75.0,0.58984375,0.20833333333333334,0.0140625,0.03333333333333333
9705-2021_03_20_073717.jpg,car,48,265,640,68,360,235,1,313,303,LTAdatasets/9705/annotate/9705-2021_03_20_073717.jpg,289.0,269.0,0.4515625,0.7472222222222222,0.075,0.18888888888888888
9705-2021_03_20_073717.jpg,lorry_truck,47,136,640,34,360,168,2,183,202,LTAdatasets/9705/annotate/9705-2021_03_20_073717.jpg,159.5,185.0,0.24921875,0.5138888888888888,0.0734375,0.09444444444444444
9705-2021_03_20_073717.jpg,van,21,417,640,39,360,119,3,438,158,LTAdatasets/9705/annotate/9705-2021_03_20_073717.jpg,427.5,138.5,0.66796875,0.38472222222222224,0.0328125,0.10833333333333334
9705-2021_03_20_073717.jpg,lorry_truck,28,446,640,45,360,127,2,474,172,LTAdatasets/9705/annotate/9705-2021_03_20_073717.jpg,460.0,149.5,0.71875,0.4152777777777778,0.04375,0.125
9705-2021_03_20_073717.jpg,bus,19,361,640,18,360,57,5,380,75,LTAdatasets/9705/annotate/9705-2021_03_20_073717.jpg,370.5,66.0,0.57890625,0.18333333333333332,0.0296875,0.05
9705-2021_03_20_073717.jpg,van,16,326,640,16,360,80,3,342,96,LTAdatasets/9705/annotate/9705-2021_03_20_073717.jpg,334.0,88.0,0.521875,0.24444444444444444,0.025,0.044444444444444446
9705-2021_03_20_073717.jpg,car,14,381,640,10,360,63,1,395,73,LTAdatasets/9705/annotate/9705-2021_03_20_073717.jpg,388.0,68.0,0.60625,0.18888888888888888,0.021875,0.027777777777777776
9705-2021_03_20_073717.jpg,car,10,409,640,10,360,55,1,419,65,LTAdatasets/9705/annotate/9705-2021_03_20_073717.jpg,414.0,60.0,0.646875,0.16666666666666666,0.015625,0.027777777777777776
9705-2021_03_20_073717.jpg,car,9,392,640,11,360,52,1,401,63,LTAdatasets/9705/annotate/9705-2021_03_20_073717.jpg,396.5,57.5,0.61953125,0.1597222222222222,0.0140625,0.030555555555555555
9705-2021_03_20_200416.jpg,car,44,336,640,54,360,212,1,380,266,LTAdatasets/9705/annotate/9705-2021_03_20_200416.jpg,358.0,239.0,0.559375,0.6638888888888889,0.06875,0.15
9705-2021_03_20_200416.jpg,van,26,223,640,19,360,144,3,249,163,LTAdatasets/9705/annotate/9705-2021_03_20_200416.jpg,236.0,153.5,0.36875,0.4263888888888889,0.040625,0.05277777777777778
9705-2021_03_20_200416.jpg,car,30,157,640,18,360,165,1,187,183,LTAdatasets/9705/annotate/9705-2021_03_20_200416.jpg,172.0,174.0,0.26875,0.48333333333333334,0.046875,0.05
9705-2021_03_20_200416.jpg,car,15,365,640,15,360,77,1,380,92,LTAdatasets/9705/annotate/9705-2021_03_20_200416.jpg,372.5,84.5,0.58203125,0.23472222222222222,0.0234375,0.041666666666666664
9705-2021_03_20_200416.jpg,car,17,321,640,11,360,105,1,338,116,LTAdatasets/9705/annotate/9705-2021_03_20_200416.jpg,329.5,110.5,0.51484375,0.30694444444444446,0.0265625,0.030555555555555555
9705-2021_03_20_200416.jpg,car,17,410,640,21,360,90,1,427,111,LTAdatasets/9705/annotate/9705-2021_03_20_200416.jpg,418.5,100.5,0.65390625,0.2791666666666667,0.0265625,0.058333333333333334
9705-2021_03_20_200416.jpg,lorry_truck,15,445,640,15,360,80,2,460,95,LTAdatasets/9705/annotate/9705-2021_03_20_200416.jpg,452.5,87.5,0.70703125,0.24305555555555555,0.0234375,0.041666666666666664
9705-2021_03_20_200416.jpg,car,9,431,640,9,360,74,1,440,83,LTAdatasets/9705/annotate/9705-2021_03_20_200416.jpg,435.5,78.5,0.68046875,0.21805555555555556,0.0140625,0.025
9705-2021_03_20_200416.jpg,car,17,454,640,14,360,65,1,471,79,LTAdatasets/9705/annotate/9705-2021_03_20_200416.jpg,462.5,72.0,0.72265625,0.2,0.0265625,0.03888888888888889
9705-2021_03_20_200416.jpg,bike,11,443,640,14,360,64,4,454,78,LTAdatasets/9705/annotate/9705-2021_03_20_200416.jpg,448.5,71.0,0.70078125,0.19722222222222222,0.0171875,0.03888888888888889
9705-2021_03_20_200416.jpg,car,10,461,640,8,360,47,1,471,55,LTAdatasets/9705/annotate/9705-2021_03_20_200416.jpg,466.0,51.0,0.728125,0.14166666666666666,0.015625,0.022222222222222223
9705-2021_03_20_200416.jpg,car,12,445,640,8,360,50,1,457,58,LTAdatasets/9705/annotate/9705-2021_03_20_200416.jpg,451.0,54.0,0.7046875,0.15,0.01875,0.022222222222222223
9705-2021_03_20_194916.jpg,car,23,180,640,20,360,134,1,203,154,LTAdatasets/9705/annotate/9705-2021_03_20_194916.jpg,191.5,144.0,0.29921875,0.4,0.0359375,0.05555555555555555
9705-2021_03_20_194916.jpg,car,14,471,640,16,360,78,1,485,94,LTAdatasets/9705/annotate/9705-2021_03_20_194916.jpg,478.0,86.0,0.746875,0.2388888888888889,0.021875,0.044444444444444446
9705-2021_03_20_194916.jpg,car,14,472,640,11,360,53,1,486,64,LTAdatasets/9705/annotate/9705-2021_03_20_194916.jpg,479.0,58.5,0.7484375,0.1625,0.021875,0.030555555555555555
9705-2021_03_20_194916.jpg,car,15,457,640,10,360,45,1,472,55,LTAdatasets/9705/annotate/9705-2021_03_20_194916.jpg,464.5,50.0,0.72578125,0.1388888888888889,0.0234375,0.027777777777777776
9705-2021_03_20_194916.jpg,lorry_truck,20,392,640,15,360,57,2,412,72,LTAdatasets/9705/annotate/9705-2021_03_20_194916.jpg,402.0,64.5,0.628125,0.17916666666666667,0.03125,0.041666666666666664
9705-2021_03_20_194916.jpg,car,13,303,640,11,360,79,1,316,90,LTAdatasets/9705/annotate/9705-2021_03_20_194916.jpg,309.5,84.5,0.48359375,0.23472222222222222,0.0203125,0.030555555555555555
9705-2021_03_20_193115.jpg,lorry_truck,49,0,640,66,360,225,2,49,291,LTAdatasets/9705/annotate/9705-2021_03_20_193115.jpg,24.5,258.0,0.03828125,0.7166666666666667,0.0765625,0.18333333333333332
9705-2021_03_20_193115.jpg,lorry_truck,16,368,640,19,360,63,2,384,82,LTAdatasets/9705/annotate/9705-2021_03_20_193115.jpg,376.0,72.5,0.5875,0.2013888888888889,0.025,0.05277777777777778
9705-2021_03_20_193115.jpg,van,13,310,640,10,360,73,3,323,83,LTAdatasets/9705/annotate/9705-2021_03_20_193115.jpg,316.5,78.0,0.49453125,0.21666666666666667,0.0203125,0.027777777777777776
9705-2021_03_20_193115.jpg,car,19,283,640,8,360,90,1,302,98,LTAdatasets/9705/annotate/9705-2021_03_20_193115.jpg,292.5,94.0,0.45703125,0.2611111111111111,0.0296875,0.022222222222222223
9705-2021_03_20_193115.jpg,car,54,68,640,40,360,246,1,122,286,LTAdatasets/9705/annotate/9705-2021_03_20_193115.jpg,95.0,266.0,0.1484375,0.7388888888888889,0.084375,0.1111111111111111
9705-2021_03_20_193115.jpg,bike,7,480,640,14,360,61,4,487,75,LTAdatasets/9705/annotate/9705-2021_03_20_193115.jpg,483.5,68.0,0.75546875,0.18888888888888888,0.0109375,0.03888888888888889
9705-2021_03_20_193115.jpg,car,9,474,640,12,360,43,1,483,55,LTAdatasets/9705/annotate/9705-2021_03_20_193115.jpg,478.5,49.0,0.74765625,0.1361111111111111,0.0140625,0.03333333333333333
9705-2021_03_20_193115.jpg,car,11,459,640,8,360,44,1,470,52,LTAdatasets/9705/annotate/9705-2021_03_20_193115.jpg,464.5,48.0,0.72578125,0.13333333333333333,0.0171875,0.022222222222222223
9705-2021_03_20_193115.jpg,car,17,472,640,18,360,72,1,489,90,LTAdatasets/9705/annotate/9705-2021_03_20_193115.jpg,480.5,81.0,0.75078125,0.225,0.0265625,0.05
9705-2021_03_20_074618.jpg,lorry_truck,28,460,640,35,360,98,2,488,133,LTAdatasets/9705/annotate/9705-2021_03_20_074618.jpg,474.0,115.5,0.740625,0.32083333333333336,0.04375,0.09722222222222222
9705-2021_03_20_074618.jpg,lorry_truck,16,438,640,26,360,88,2,454,114,LTAdatasets/9705/annotate/9705-2021_03_20_074618.jpg,446.0,101.0,0.696875,0.28055555555555556,0.025,0.07222222222222222
9705-2021_03_20_074618.jpg,lorry_truck,35,153,640,31,360,168,2,188,199,LTAdatasets/9705/annotate/9705-2021_03_20_074618.jpg,170.5,183.5,0.26640625,0.5097222222222222,0.0546875,0.08611111111111111
9705-2021_03_20_074618.jpg,car,10,395,640,8,360,57,1,405,65,LTAdatasets/9705/annotate/9705-2021_03_20_074618.jpg,400.0,61.0,0.625,0.16944444444444445,0.015625,0.022222222222222223
9705-2021_03_20_085501.jpg,bike,9,284,640,13,360,113,4,293,126,LTAdatasets/9705/annotate/9705-2021_03_20_085501.jpg,288.5,119.5,0.45078125,0.33194444444444443,0.0140625,0.03611111111111111
9705-2021_03_20_085501.jpg,bike,10,377,640,11,360,62,4,387,73,LTAdatasets/9705/annotate/9705-2021_03_20_085501.jpg,382.0,67.5,0.596875,0.1875,0.015625,0.030555555555555555
9705-2021_03_20_085501.jpg,lorry_truck,35,439,640,50,360,158,2,474,208,LTAdatasets/9705/annotate/9705-2021_03_20_085501.jpg,456.5,183.0,0.71328125,0.5083333333333333,0.0546875,0.1388888888888889
9705-2021_03_20_085501.jpg,lorry_truck,30,399,640,58,360,115,2,429,173,LTAdatasets/9705/annotate/9705-2021_03_20_085501.jpg,414.0,144.0,0.646875,0.4,0.046875,0.16111111111111112
9705-2021_03_20_085501.jpg,lorry_truck,52,273,640,24,360,85,2,325,109,LTAdatasets/9705/annotate/9705-2021_03_20_085501.jpg,299.0,97.0,0.4671875,0.26944444444444443,0.08125,0.06666666666666667
9705-2021_03_20_085501.jpg,bike,13,330,640,16,360,90,4,343,106,LTAdatasets/9705/annotate/9705-2021_03_20_085501.jpg,336.5,98.0,0.52578125,0.2722222222222222,0.0203125,0.044444444444444446
9705-2021_03_20_085501.jpg,lorry_truck,15,449,640,14,360,67,2,464,81,LTAdatasets/9705/annotate/9705-2021_03_20_085501.jpg,456.5,74.0,0.71328125,0.20555555555555555,0.0234375,0.03888888888888889
9705-2021_03_20_085501.jpg,car,13,352,640,11,360,80,1,365,91,LTAdatasets/9705/annotate/9705-2021_03_20_085501.jpg,358.5,85.5,0.56015625,0.2375,0.0203125,0.030555555555555555
9705-2021_03_20_085501.jpg,lorry_truck,33,2,640,35,360,259,2,35,294,LTAdatasets/9705/annotate/9705-2021_03_20_085501.jpg,18.5,276.5,0.02890625,0.7680555555555556,0.0515625,0.09722222222222222
9705-2021_03_20_085501.jpg,lorry_truck,65,172,640,37,360,129,2,237,166,LTAdatasets/9705/annotate/9705-2021_03_20_085501.jpg,204.5,147.5,0.31953125,0.4097222222222222,0.1015625,0.10277777777777777
9705-2021_03_20_085501.jpg,car,9,402,640,10,360,58,1,411,68,LTAdatasets/9705/annotate/9705-2021_03_20_085501.jpg,406.5,63.0,0.63515625,0.175,0.0140625,0.027777777777777776
9705-2021_03_20_085501.jpg,car,11,408,640,8,360,55,1,419,63,LTAdatasets/9705/annotate/9705-2021_03_20_085501.jpg,413.5,59.0,0.64609375,0.1638888888888889,0.0171875,0.022222222222222223
9705-2021_03_20_093724.jpg,lorry_truck,28,411,640,32,360,118,2,439,150,LTAdatasets/9705/annotate/9705-2021_03_20_093724.jpg,425.0,134.0,0.6640625,0.37222222222222223,0.04375,0.08888888888888889
9705-2021_03_20_093724.jpg,lorry_truck,29,457,640,56,360,99,2,486,155,LTAdatasets/9705/annotate/9705-2021_03_20_093724.jpg,471.5,127.0,0.73671875,0.3527777777777778,0.0453125,0.15555555555555556
9705-2021_03_20_093724.jpg,car,61,258,640,42,360,318,1,319,360,LTAdatasets/9705/annotate/9705-2021_03_20_093724.jpg,288.5,339.0,0.45078125,0.9416666666666667,0.0953125,0.11666666666666667
9705-2021_03_20_093724.jpg,lorry_truck,20,286,640,19,360,92,2,306,111,LTAdatasets/9705/annotate/9705-2021_03_20_093724.jpg,296.0,101.5,0.4625,0.28194444444444444,0.03125,0.05277777777777778
9705-2021_03_20_093724.jpg,car,11,380,640,13,360,62,1,391,75,LTAdatasets/9705/annotate/9705-2021_03_20_093724.jpg,385.5,68.5,0.60234375,0.19027777777777777,0.0171875,0.03611111111111111
9705-2021_03_20_093724.jpg,car,11,444,640,8,360,58,1,455,66,LTAdatasets/9705/annotate/9705-2021_03_20_093724.jpg,449.5,62.0,0.70234375,0.17222222222222222,0.0171875,0.022222222222222223
9705-2021_03_20_093724.jpg,car,12,443,640,7,360,49,1,455,56,LTAdatasets/9705/annotate/9705-2021_03_20_093724.jpg,449.0,52.5,0.7015625,0.14583333333333334,0.01875,0.019444444444444445
9705-2021_03_20_093724.jpg,lorry_truck,14,473,640,17,360,50,2,487,67,LTAdatasets/9705/annotate/9705-2021_03_20_093724.jpg,480.0,58.5,0.75,0.1625,0.021875,0.04722222222222222
9705-2021_03_20_093724.jpg,lorry_truck,12,457,640,21,360,49,2,469,70,LTAdatasets/9705/annotate/9705-2021_03_20_093724.jpg,463.0,59.5,0.7234375,0.16527777777777777,0.01875,0.058333333333333334
9705-2021_03_20_191914.jpg,car,26,199,640,14,360,129,1,225,143,LTAdatasets/9705/annotate/9705-2021_03_20_191914.jpg,212.0,136.0,0.33125,0.37777777777777777,0.040625,0.03888888888888889
9705-2021_03_20_191914.jpg,car,18,408,640,19,360,94,1,426,113,LTAdatasets/9705/annotate/9705-2021_03_20_191914.jpg,417.0,103.5,0.6515625,0.2875,0.028125,0.05277777777777778
9705-2021_03_20_191914.jpg,car,17,448,640,13,360,70,1,465,83,LTAdatasets/9705/annotate/9705-2021_03_20_191914.jpg,456.5,76.5,0.71328125,0.2125,0.0265625,0.03611111111111111
9705-2021_03_20_191914.jpg,van,17,342,640,12,360,83,3,359,95,LTAdatasets/9705/annotate/9705-2021_03_20_191914.jpg,350.5,89.0,0.54765625,0.24722222222222223,0.0265625,0.03333333333333333
9705-2021_03_20_191914.jpg,car,15,298,640,10,360,81,1,313,91,LTAdatasets/9705/annotate/9705-2021_03_20_191914.jpg,305.5,86.0,0.47734375,0.2388888888888889,0.0234375,0.027777777777777776
9705-2021_03_20_191914.jpg,lorry_truck,11,363,640,12,360,61,2,374,73,LTAdatasets/9705/annotate/9705-2021_03_20_191914.jpg,368.5,67.0,0.57578125,0.18611111111111112,0.0171875,0.03333333333333333
9705-2021_03_20_191914.jpg,van,14,370,640,12,360,70,3,384,82,LTAdatasets/9705/annotate/9705-2021_03_20_191914.jpg,377.0,76.0,0.5890625,0.2111111111111111,0.021875,0.03333333333333333
9705-2021_03_20_191914.jpg,van,11,445,640,7,360,54,3,456,61,LTAdatasets/9705/annotate/9705-2021_03_20_191914.jpg,450.5,57.5,0.70390625,0.1597222222222222,0.0171875,0.019444444444444445
9705-2021_03_20_191914.jpg,van,15,469,640,9,360,55,3,484,64,LTAdatasets/9705/annotate/9705-2021_03_20_191914.jpg,476.5,59.5,0.74453125,0.16527777777777777,0.0234375,0.025
9705-2021_03_20_191914.jpg,van,9,388,640,8,360,56,3,397,64,LTAdatasets/9705/annotate/9705-2021_03_20_191914.jpg,392.5,60.0,0.61328125,0.16666666666666666,0.0140625,0.022222222222222223
9705-2021_03_20_191914.jpg,bike,12,467,640,10,360,62,4,479,72,LTAdatasets/9705/annotate/9705-2021_03_20_191914.jpg,473.0,67.0,0.7390625,0.18611111111111112,0.01875,0.027777777777777776
9705-2021_03_20_080719.jpg,bike,24,436,640,39,360,204,4,460,243,LTAdatasets/9705/annotate/9705-2021_03_20_080719.jpg,448.0,223.5,0.7,0.6208333333333333,0.0375,0.10833333333333334
9705-2021_03_20_080719.jpg,bike,23,354,640,20,360,155,4,377,175,LTAdatasets/9705/annotate/9705-2021_03_20_080719.jpg,365.5,165.0,0.57109375,0.4583333333333333,0.0359375,0.05555555555555555
9705-2021_03_20_080719.jpg,bike,11,397,640,14,360,58,4,408,72,LTAdatasets/9705/annotate/9705-2021_03_20_080719.jpg,402.5,65.0,0.62890625,0.18055555555555555,0.0171875,0.03888888888888889
9705-2021_03_20_080719.jpg,car,53,233,640,56,360,237,1,286,293,LTAdatasets/9705/annotate/9705-2021_03_20_080719.jpg,259.5,265.0,0.40546875,0.7361111111111112,0.0828125,0.15555555555555556
9705-2021_03_20_080719.jpg,lorry_truck,57,328,640,92,360,180,2,385,272,LTAdatasets/9705/annotate/9705-2021_03_20_080719.jpg,356.5,226.0,0.55703125,0.6277777777777778,0.0890625,0.25555555555555554
9705-2021_03_20_080719.jpg,lorry_truck,31,420,640,42,360,135,2,451,177,LTAdatasets/9705/annotate/9705-2021_03_20_080719.jpg,435.5,156.0,0.68046875,0.43333333333333335,0.0484375,0.11666666666666667
9705-2021_03_20_080719.jpg,lorry_truck,31,303,640,21,360,79,2,334,100,LTAdatasets/9705/annotate/9705-2021_03_20_080719.jpg,318.5,89.5,0.49765625,0.24861111111111112,0.0484375,0.058333333333333334
9705-2021_03_20_080719.jpg,car,14,352,640,14,360,75,1,366,89,LTAdatasets/9705/annotate/9705-2021_03_20_080719.jpg,359.0,82.0,0.5609375,0.22777777777777777,0.021875,0.03888888888888889
9705-2021_03_20_075138.jpg,car,27,370,640,25,360,126,1,397,151,LTAdatasets/9705/annotate/9705-2021_03_20_075138.jpg,383.5,138.5,0.59921875,0.38472222222222224,0.0421875,0.06944444444444445
9705-2021_03_20_075138.jpg,car,36,249,640,21,360,125,1,285,146,LTAdatasets/9705/annotate/9705-2021_03_20_075138.jpg,267.0,135.5,0.4171875,0.3763888888888889,0.05625,0.058333333333333334
9705-2021_03_20_075138.jpg,bike,23,137,640,25,360,210,4,160,235,LTAdatasets/9705/annotate/9705-2021_03_20_075138.jpg,148.5,222.5,0.23203125,0.6180555555555556,0.0359375,0.06944444444444445
9705-2021_03_20_075138.jpg,bike,36,46,640,17,360,236,4,82,253,LTAdatasets/9705/annotate/9705-2021_03_20_075138.jpg,64.0,244.5,0.1,0.6791666666666667,0.05625,0.04722222222222222
9705-2021_03_20_075138.jpg,lorry_truck,30,297,640,21,360,87,2,327,108,LTAdatasets/9705/annotate/9705-2021_03_20_075138.jpg,312.0,97.5,0.4875,0.2708333333333333,0.046875,0.058333333333333334
9705-2021_03_20_075138.jpg,car,16,335,640,11,360,87,1,351,98,LTAdatasets/9705/annotate/9705-2021_03_20_075138.jpg,343.0,92.5,0.5359375,0.2569444444444444,0.025,0.030555555555555555
9705-2021_03_20_075138.jpg,car,16,444,640,16,360,82,1,460,98,LTAdatasets/9705/annotate/9705-2021_03_20_075138.jpg,452.0,90.0,0.70625,0.25,0.025,0.044444444444444446
9705-2021_03_20_075138.jpg,car,19,471,640,12,360,62,1,490,74,LTAdatasets/9705/annotate/9705-2021_03_20_075138.jpg,480.5,68.0,0.75078125,0.18888888888888888,0.0296875,0.03333333333333333
9705-2021_03_20_075138.jpg,car,11,474,640,7,360,51,1,485,58,LTAdatasets/9705/annotate/9705-2021_03_20_075138.jpg,479.5,54.5,0.74921875,0.15138888888888888,0.0171875,0.019444444444444445
9705-2021_03_20_075138.jpg,bike,9,372,640,10,360,68,4,381,78,LTAdatasets/9705/annotate/9705-2021_03_20_075138.jpg,376.5,73.0,0.58828125,0.20277777777777778,0.0140625,0.027777777777777776
9705-2021_03_20_202217.jpg,van,32,440,640,48,360,156,3,472,204,LTAdatasets/9705/annotate/9705-2021_03_20_202217.jpg,456.0,180.0,0.7125,0.5,0.05,0.13333333333333333
9705-2021_03_20_202217.jpg,lorry_truck,38,262,640,37,360,88,2,300,125,LTAdatasets/9705/annotate/9705-2021_03_20_202217.jpg,281.0,106.5,0.4390625,0.29583333333333334,0.059375,0.10277777777777777
9705-2021_03_20_202217.jpg,car,17,322,640,14,360,69,1,339,83,LTAdatasets/9705/annotate/9705-2021_03_20_202217.jpg,330.5,76.0,0.51640625,0.2111111111111111,0.0265625,0.03888888888888889
9705-2021_03_20_202217.jpg,car,60,313,640,77,360,218,1,373,295,LTAdatasets/9705/annotate/9705-2021_03_20_202217.jpg,343.0,256.5,0.5359375,0.7125,0.09375,0.21388888888888888
9705-2021_03_20_202217.jpg,car,19,469,640,16,360,95,1,488,111,LTAdatasets/9705/annotate/9705-2021_03_20_202217.jpg,478.5,103.0,0.74765625,0.2861111111111111,0.0296875,0.044444444444444446
9705-2021_03_20_191234.jpg,lorry_truck,47,192,640,34,360,142,2,239,176,LTAdatasets/9705/annotate/9705-2021_03_20_191234.jpg,215.5,159.0,0.33671875,0.44166666666666665,0.0734375,0.09444444444444444
9705-2021_03_20_191234.jpg,lorry_truck,50,0,640,38,360,220,2,50,258,LTAdatasets/9705/annotate/9705-2021_03_20_191234.jpg,25.0,239.0,0.0390625,0.6638888888888889,0.078125,0.10555555555555556
9705-2021_03_20_191234.jpg,lorry_truck,20,326,640,16,360,89,2,346,105,LTAdatasets/9705/annotate/9705-2021_03_20_191234.jpg,336.0,97.0,0.525,0.26944444444444443,0.03125,0.044444444444444446
9705-2021_03_20_191234.jpg,lorry_truck,10,374,640,8,360,60,2,384,68,LTAdatasets/9705/annotate/9705-2021_03_20_191234.jpg,379.0,64.0,0.5921875,0.17777777777777778,0.015625,0.022222222222222223
9705-2021_03_20_191234.jpg,bike,6,370,640,12,360,67,4,376,79,LTAdatasets/9705/annotate/9705-2021_03_20_191234.jpg,373.0,73.0,0.5828125,0.20277777777777778,0.009375,0.03333333333333333
9705-2021_03_20_191234.jpg,car,13,443,640,12,360,52,1,456,64,LTAdatasets/9705/annotate/9705-2021_03_20_191234.jpg,449.5,58.0,0.70234375,0.16111111111111112,0.0203125,0.03333333333333333
9705-2021_03_20_191234.jpg,car,79,129,640,42,360,318,1,208,360,LTAdatasets/9705/annotate/9705-2021_03_20_191234.jpg,168.5,339.0,0.26328125,0.9416666666666667,0.1234375,0.11666666666666667
9705-2021_03_20_182752.jpg,van,28,444,640,47,360,136,3,472,183,LTAdatasets/9705/annotate/9705-2021_03_20_182752.jpg,458.0,159.5,0.715625,0.44305555555555554,0.04375,0.13055555555555556
9705-2021_03_20_182752.jpg,lorry_truck,18,370,640,10,360,69,2,388,79,LTAdatasets/9705/annotate/9705-2021_03_20_182752.jpg,379.0,74.0,0.5921875,0.20555555555555555,0.028125,0.027777777777777776
9705-2021_03_20_182752.jpg,car,12,472,640,8,360,55,1,484,63,LTAdatasets/9705/annotate/9705-2021_03_20_182752.jpg,478.0,59.0,0.746875,0.1638888888888889,0.01875,0.022222222222222223
9705-2021_03_20_182752.jpg,car,14,445,640,8,360,51,1,459,59,LTAdatasets/9705/annotate/9705-2021_03_20_182752.jpg,452.0,55.0,0.70625,0.1527777777777778,0.021875,0.022222222222222223
9705-2021_03_20_182752.jpg,car,10,408,640,10,360,48,1,418,58,LTAdatasets/9705/annotate/9705-2021_03_20_182752.jpg,413.0,53.0,0.6453125,0.14722222222222223,0.015625,0.027777777777777776
9705-2021_03_20_182752.jpg,car,6,424,640,7,360,46,1,430,53,LTAdatasets/9705/annotate/9705-2021_03_20_182752.jpg,427.0,49.5,0.6671875,0.1375,0.009375,0.019444444444444445
9705-2021_03_20_182752.jpg,van,11,370,640,6,360,61,3,381,67,LTAdatasets/9705/annotate/9705-2021_03_20_182752.jpg,375.5,64.0,0.58671875,0.17777777777777778,0.0171875,0.016666666666666666
9705-2021_03_20_182451.jpg,lorry_truck,39,179,640,29,360,125,2,218,154,LTAdatasets/9705/annotate/9705-2021_03_20_182451.jpg,198.5,139.5,0.31015625,0.3875,0.0609375,0.08055555555555556
9705-2021_03_20_182451.jpg,van,58,5,640,38,360,242,3,63,280,LTAdatasets/9705/annotate/9705-2021_03_20_182451.jpg,34.0,261.0,0.053125,0.725,0.090625,0.10555555555555556
9705-2021_03_20_182451.jpg,van,65,237,640,46,360,314,3,302,360,LTAdatasets/9705/annotate/9705-2021_03_20_182451.jpg,269.5,337.0,0.42109375,0.9361111111111111,0.1015625,0.12777777777777777
9705-2021_03_20_182451.jpg,van,15,391,640,14,360,62,3,406,76,LTAdatasets/9705/annotate/9705-2021_03_20_182451.jpg,398.5,69.0,0.62265625,0.19166666666666668,0.0234375,0.03888888888888889
9705-2021_03_20_182451.jpg,van,15,471,640,11,360,56,3,486,67,LTAdatasets/9705/annotate/9705-2021_03_20_182451.jpg,478.5,61.5,0.74765625,0.17083333333333334,0.0234375,0.030555555555555555
9705-2021_03_20_182451.jpg,lorry_truck,17,394,640,17,360,46,2,411,63,LTAdatasets/9705/annotate/9705-2021_03_20_182451.jpg,402.5,54.5,0.62890625,0.15138888888888888,0.0265625,0.04722222222222222
9705-2021_03_20_182451.jpg,car,17,281,640,8,360,91,1,298,99,LTAdatasets/9705/annotate/9705-2021_03_20_182451.jpg,289.5,95.0,0.45234375,0.2638888888888889,0.0265625,0.022222222222222223
9705-2021_03_20_182451.jpg,car,10,309,640,10,360,76,1,319,86,LTAdatasets/9705/annotate/9705-2021_03_20_182451.jpg,314.0,81.0,0.490625,0.225,0.015625,0.027777777777777776
9705-2021_03_20_182451.jpg,lorry_truck,12,341,640,16,360,73,2,353,89,LTAdatasets/9705/annotate/9705-2021_03_20_182451.jpg,347.0,81.0,0.5421875,0.225,0.01875,0.044444444444444446
9705-2021_03_20_081319.jpg,lorry_truck,42,383,640,34,360,150,2,425,184,LTAdatasets/9705/annotate/9705-2021_03_20_081319.jpg,404.0,167.0,0.63125,0.4638888888888889,0.065625,0.09444444444444444
9705-2021_03_20_081319.jpg,lorry_truck,74,239,640,73,360,287,2,313,360,LTAdatasets/9705/annotate/9705-2021_03_20_081319.jpg,276.0,323.5,0.43125,0.8986111111111111,0.115625,0.20277777777777778
9705-2021_03_20_081319.jpg,lorry_truck,30,454,640,44,360,97,2,484,141,LTAdatasets/9705/annotate/9705-2021_03_20_081319.jpg,469.0,119.0,0.7328125,0.33055555555555555,0.046875,0.12222222222222222
9705-2021_03_20_081319.jpg,lorry_truck,22,423,640,33,360,87,2,445,120,LTAdatasets/9705/annotate/9705-2021_03_20_081319.jpg,434.0,103.5,0.678125,0.2875,0.034375,0.09166666666666666
9705-2021_03_20_081319.jpg,lorry_truck,15,457,640,13,360,63,2,472,76,LTAdatasets/9705/annotate/9705-2021_03_20_081319.jpg,464.5,69.5,0.72578125,0.19305555555555556,0.0234375,0.03611111111111111
9705-2021_03_20_081319.jpg,lorry_truck,12,472,640,16,360,47,2,484,63,LTAdatasets/9705/annotate/9705-2021_03_20_081319.jpg,478.0,55.0,0.746875,0.1527777777777778,0.01875,0.044444444444444446
9705-2021_03_20_081319.jpg,car,7,445,640,10,360,56,1,452,66,LTAdatasets/9705/annotate/9705-2021_03_20_081319.jpg,448.5,61.0,0.70078125,0.16944444444444445,0.0109375,0.027777777777777776
9705-2021_03_20_081319.jpg,car,41,249,640,15,360,144,1,290,159,LTAdatasets/9705/annotate/9705-2021_03_20_081319.jpg,269.5,151.5,0.42109375,0.42083333333333334,0.0640625,0.041666666666666664
9705-2021_03_20_081319.jpg,bike,7,395,640,11,360,54,4,402,65,LTAdatasets/9705/annotate/9705-2021_03_20_081319.jpg,398.5,59.5,0.62265625,0.16527777777777777,0.0109375,0.030555555555555555
9705-2021_03_20_091002.jpg,car,42,297,640,43,360,178,1,339,221,LTAdatasets/9705/annotate/9705-2021_03_20_091002.jpg,318.0,199.5,0.496875,0.5541666666666667,0.065625,0.11944444444444445
9705-2021_03_20_091002.jpg,car,21,384,640,26,360,111,1,405,137,LTAdatasets/9705/annotate/9705-2021_03_20_091002.jpg,394.5,124.0,0.61640625,0.34444444444444444,0.0328125,0.07222222222222222
9705-2021_03_20_091002.jpg,car,19,409,640,17,360,84,1,428,101,LTAdatasets/9705/annotate/9705-2021_03_20_091002.jpg,418.5,92.5,0.65390625,0.2569444444444444,0.0296875,0.04722222222222222
9705-2021_03_20_091002.jpg,car,14,426,640,17,360,69,1,440,86,LTAdatasets/9705/annotate/9705-2021_03_20_091002.jpg,433.0,77.5,0.6765625,0.2152777777777778,0.021875,0.04722222222222222
9705-2021_03_20_091002.jpg,bike,7,443,640,15,360,62,4,450,77,LTAdatasets/9705/annotate/9705-2021_03_20_091002.jpg,446.5,69.5,0.69765625,0.19305555555555556,0.0109375,0.041666666666666664
9705-2021_03_20_091002.jpg,car,20,429,640,26,360,100,1,449,126,LTAdatasets/9705/annotate/9705-2021_03_20_091002.jpg,439.0,113.0,0.6859375,0.3138888888888889,0.03125,0.07222222222222222
9705-2021_03_20_091002.jpg,car,12,445,640,13,360,77,1,457,90,LTAdatasets/9705/annotate/9705-2021_03_20_091002.jpg,451.0,83.5,0.7046875,0.23194444444444445,0.01875,0.03611111111111111
9705-2021_03_20_091002.jpg,van,19,266,640,15,360,92,3,285,107,LTAdatasets/9705/annotate/9705-2021_03_20_091002.jpg,275.5,99.5,0.43046875,0.2763888888888889,0.0296875,0.041666666666666664
9705-2021_03_20_091002.jpg,car,64,5,640,41,360,239,1,69,280,LTAdatasets/9705/annotate/9705-2021_03_20_091002.jpg,37.0,259.5,0.0578125,0.7208333333333333,0.1,0.11388888888888889
9705-2021_03_20_091002.jpg,lorry_truck,98,211,640,77,360,283,2,309,360,LTAdatasets/9705/annotate/9705-2021_03_20_091002.jpg,260.0,321.5,0.40625,0.8930555555555556,0.153125,0.21388888888888888
9705-2021_03_20_091002.jpg,lorry_truck,25,462,640,26,360,82,2,487,108,LTAdatasets/9705/annotate/9705-2021_03_20_091002.jpg,474.5,95.0,0.74140625,0.2638888888888889,0.0390625,0.07222222222222222
9705-2021_03_20_091002.jpg,car,12,401,640,8,360,56,1,413,64,LTAdatasets/9705/annotate/9705-2021_03_20_091002.jpg,407.0,60.0,0.6359375,0.16666666666666666,0.01875,0.022222222222222223
9705-2021_03_20_091002.jpg,car,7,385,640,9,360,60,1,392,69,LTAdatasets/9705/annotate/9705-2021_03_20_091002.jpg,388.5,64.5,0.60703125,0.17916666666666667,0.0109375,0.025
9705-2021_03_20_091002.jpg,car,13,356,640,8,360,71,1,369,79,LTAdatasets/9705/annotate/9705-2021_03_20_091002.jpg,362.5,75.0,0.56640625,0.20833333333333334,0.0203125,0.022222222222222223
9705-2021_03_20_091002.jpg,lorry_truck,15,471,640,16,360,51,2,486,67,LTAdatasets/9705/annotate/9705-2021_03_20_091002.jpg,478.5,59.0,0.74765625,0.1638888888888889,0.0234375,0.044444444444444446
9705-2021_03_20_082440.jpg,bike,25,330,640,37,360,221,4,355,258,LTAdatasets/9705/annotate/9705-2021_03_20_082440.jpg,342.5,239.5,0.53515625,0.6652777777777777,0.0390625,0.10277777777777777
9705-2021_03_20_082440.jpg,lorry_truck,46,404,640,109,360,190,2,450,299,LTAdatasets/9705/annotate/9705-2021_03_20_082440.jpg,427.0,244.5,0.6671875,0.6791666666666667,0.071875,0.30277777777777776
9705-2021_03_20_082440.jpg,lorry_truck,16,475,640,20,360,73,2,491,93,LTAdatasets/9705/annotate/9705-2021_03_20_082440.jpg,483.0,83.0,0.7546875,0.23055555555555557,0.025,0.05555555555555555
9705-2021_03_20_082440.jpg,lorry_truck,20,265,640,20,360,103,2,285,123,LTAdatasets/9705/annotate/9705-2021_03_20_082440.jpg,275.0,113.0,0.4296875,0.3138888888888889,0.03125,0.05555555555555555
9705-2021_03_20_082440.jpg,lorry_truck,47,151,640,39,360,157,2,198,196,LTAdatasets/9705/annotate/9705-2021_03_20_082440.jpg,174.5,176.5,0.27265625,0.49027777777777776,0.0734375,0.10833333333333334
9705-2021_03_20_082440.jpg,lorry_truck,38,24,640,26,360,227,2,62,253,LTAdatasets/9705/annotate/9705-2021_03_20_082440.jpg,43.0,240.0,0.0671875,0.6666666666666666,0.059375,0.07222222222222222
9705-2021_03_20_082440.jpg,car,9,312,640,11,360,73,1,321,84,LTAdatasets/9705/annotate/9705-2021_03_20_082440.jpg,316.5,78.5,0.49453125,0.21805555555555556,0.0140625,0.030555555555555555
9705-2021_03_20_082440.jpg,bike,9,293,640,10,360,80,4,302,90,LTAdatasets/9705/annotate/9705-2021_03_20_082440.jpg,297.5,85.0,0.46484375,0.2361111111111111,0.0140625,0.027777777777777776
9705-2021_03_20_082440.jpg,car,15,472,640,10,360,55,1,487,65,LTAdatasets/9705/annotate/9705-2021_03_20_082440.jpg,479.5,60.0,0.74921875,0.16666666666666666,0.0234375,0.027777777777777776
9705-2021_03_20_082440.jpg,car,7,397,640,7,360,55,1,404,62,LTAdatasets/9705/annotate/9705-2021_03_20_082440.jpg,400.5,58.5,0.62578125,0.1625,0.0109375,0.019444444444444445
9705-2021_03_20_082440.jpg,lorry_truck,6,386,640,11,360,54,2,392,65,LTAdatasets/9705/annotate/9705-2021_03_20_082440.jpg,389.0,59.5,0.6078125,0.16527777777777777,0.009375,0.030555555555555555
9705-2021_03_20_190113.jpg,lorry_truck,81,134,640,59,360,301,2,215,360,LTAdatasets/9705/annotate/9705-2021_03_20_190113.jpg,174.5,330.5,0.27265625,0.9180555555555555,0.1265625,0.1638888888888889
9705-2021_03_20_190113.jpg,lorry_truck,24,430,640,24,360,110,2,454,134,LTAdatasets/9705/annotate/9705-2021_03_20_190113.jpg,442.0,122.0,0.690625,0.3388888888888889,0.0375,0.06666666666666667
9705-2021_03_20_190113.jpg,lorry_truck,16,272,640,12,360,92,2,288,104,LTAdatasets/9705/annotate/9705-2021_03_20_190113.jpg,280.0,98.0,0.4375,0.2722222222222222,0.025,0.03333333333333333
9705-2021_03_20_190113.jpg,bike,8,392,640,14,360,54,4,400,68,LTAdatasets/9705/annotate/9705-2021_03_20_190113.jpg,396.0,61.0,0.61875,0.16944444444444445,0.0125,0.03888888888888889
9705-2021_03_20_190113.jpg,bike,7,448,640,11,360,58,4,455,69,LTAdatasets/9705/annotate/9705-2021_03_20_190113.jpg,451.5,63.5,0.70546875,0.1763888888888889,0.0109375,0.030555555555555555
9705-2021_03_20_190113.jpg,bike,8,462,640,10,360,54,4,470,64,LTAdatasets/9705/annotate/9705-2021_03_20_190113.jpg,466.0,59.0,0.728125,0.1638888888888889,0.0125,0.027777777777777776
9705-2021_03_20_190113.jpg,bike,8,322,640,11,360,69,4,330,80,LTAdatasets/9705/annotate/9705-2021_03_20_190113.jpg,326.0,74.5,0.509375,0.20694444444444443,0.0125,0.030555555555555555
9705-2021_03_20_094305.jpg,car,69,190,640,56,360,259,1,259,315,LTAdatasets/9705/annotate/9705-2021_03_20_094305.jpg,224.5,287.0,0.35078125,0.7972222222222223,0.1078125,0.15555555555555556
9705-2021_03_20_094305.jpg,car,23,412,640,22,360,123,1,435,145,LTAdatasets/9705/annotate/9705-2021_03_20_094305.jpg,423.5,134.0,0.66171875,0.37222222222222223,0.0359375,0.06111111111111111
9705-2021_03_20_094305.jpg,bike,13,444,640,17,360,92,4,457,109,LTAdatasets/9705/annotate/9705-2021_03_20_094305.jpg,450.5,100.5,0.70390625,0.2791666666666667,0.0203125,0.04722222222222222
9705-2021_03_20_094305.jpg,lorry_truck,21,468,640,34,360,74,2,489,108,LTAdatasets/9705/annotate/9705-2021_03_20_094305.jpg,478.5,91.0,0.74765625,0.25277777777777777,0.0328125,0.09444444444444444
9705-2021_03_20_094305.jpg,lorry_truck,16,419,640,10,360,83,2,435,93,LTAdatasets/9705/annotate/9705-2021_03_20_094305.jpg,427.0,88.0,0.6671875,0.24444444444444444,0.025,0.027777777777777776
9705-2021_03_20_094305.jpg,bike,18,216,640,21,360,155,4,234,176,LTAdatasets/9705/annotate/9705-2021_03_20_094305.jpg,225.0,165.5,0.3515625,0.4597222222222222,0.028125,0.058333333333333334
9705-2021_03_20_094305.jpg,lorry_truck,32,176,640,26,360,157,2,208,183,LTAdatasets/9705/annotate/9705-2021_03_20_094305.jpg,192.0,170.0,0.3,0.4722222222222222,0.05,0.07222222222222222
9705-2021_03_20_094305.jpg,lorry_truck,33,302,640,30,360,71,2,335,101,LTAdatasets/9705/annotate/9705-2021_03_20_094305.jpg,318.5,86.0,0.49765625,0.2388888888888889,0.0515625,0.08333333333333333
9705-2021_03_20_094305.jpg,lorry_truck,17,380,640,18,360,54,2,397,72,LTAdatasets/9705/annotate/9705-2021_03_20_094305.jpg,388.5,63.0,0.60703125,0.175,0.0265625,0.05
9705-2021_03_20_094305.jpg,car,12,331,640,7,360,61,1,343,68,LTAdatasets/9705/annotate/9705-2021_03_20_094305.jpg,337.0,64.5,0.5265625,0.17916666666666667,0.01875,0.019444444444444445
9705-2021_03_20_094305.jpg,car,16,468,640,9,360,64,1,484,73,LTAdatasets/9705/annotate/9705-2021_03_20_094305.jpg,476.0,68.5,0.74375,0.19027777777777777,0.025,0.025
9705-2021_03_20_094305.jpg,car,9,440,640,10,360,58,1,449,68,LTAdatasets/9705/annotate/9705-2021_03_20_094305.jpg,444.5,63.0,0.69453125,0.175,0.0140625,0.027777777777777776
9705-2021_03_20_193635.jpg,car,29,105,640,19,360,215,1,134,234,LTAdatasets/9705/annotate/9705-2021_03_20_193635.jpg,119.5,224.5,0.18671875,0.6236111111111111,0.0453125,0.05277777777777778
9705-2021_03_20_193635.jpg,car,17,294,640,18,360,107,1,311,125,LTAdatasets/9705/annotate/9705-2021_03_20_193635.jpg,302.5,116.0,0.47265625,0.32222222222222224,0.0265625,0.05
9705-2021_03_20_193635.jpg,lorry_truck,16,283,640,16,360,86,2,299,102,LTAdatasets/9705/annotate/9705-2021_03_20_193635.jpg,291.0,94.0,0.4546875,0.2611111111111111,0.025,0.044444444444444446
9705-2021_03_20_193635.jpg,lorry_truck,30,192,640,14,360,130,2,222,144,LTAdatasets/9705/annotate/9705-2021_03_20_193635.jpg,207.0,137.0,0.3234375,0.38055555555555554,0.046875,0.03888888888888889
9705-2021_03_20_193635.jpg,lorry_truck,18,344,640,18,360,63,2,362,81,LTAdatasets/9705/annotate/9705-2021_03_20_193635.jpg,353.0,72.0,0.5515625,0.2,0.028125,0.05
9705-2021_03_20_193635.jpg,lorry_truck,17,388,640,13,360,55,2,405,68,LTAdatasets/9705/annotate/9705-2021_03_20_193635.jpg,396.5,61.5,0.61953125,0.17083333333333334,0.0265625,0.03611111111111111
9705-2021_03_20_193635.jpg,car,12,369,640,8,360,76,1,381,84,LTAdatasets/9705/annotate/9705-2021_03_20_193635.jpg,375.0,80.0,0.5859375,0.2222222222222222,0.01875,0.022222222222222223
9705-2021_03_20_193635.jpg,bike,13,327,640,13,360,104,4,340,117,LTAdatasets/9705/annotate/9705-2021_03_20_193635.jpg,333.5,110.5,0.52109375,0.30694444444444446,0.0203125,0.03611111111111111
9705-2021_03_20_072817.jpg,lorry_truck,28,247,640,20,360,124,2,275,144,LTAdatasets/9705/annotate/9705-2021_03_20_072817.jpg,261.0,134.0,0.4078125,0.37222222222222223,0.04375,0.05555555555555555
9705-2021_03_20_072817.jpg,car,16,328,640,19,360,100,1,344,119,LTAdatasets/9705/annotate/9705-2021_03_20_072817.jpg,336.0,109.5,0.525,0.30416666666666664,0.025,0.05277777777777778
9705-2021_03_20_072817.jpg,car,9,313,640,12,360,100,1,322,112,LTAdatasets/9705/annotate/9705-2021_03_20_072817.jpg,317.5,106.0,0.49609375,0.29444444444444445,0.0140625,0.03333333333333333
9705-2021_03_20_072817.jpg,car,19,359,640,8,360,86,1,378,94,LTAdatasets/9705/annotate/9705-2021_03_20_072817.jpg,368.5,90.0,0.57578125,0.25,0.0296875,0.022222222222222223
9705-2021_03_20_072817.jpg,car,17,385,640,12,360,72,1,402,84,LTAdatasets/9705/annotate/9705-2021_03_20_072817.jpg,393.5,78.0,0.61484375,0.21666666666666667,0.0265625,0.03333333333333333
9705-2021_03_20_072817.jpg,car,22,176,640,14,360,145,1,198,159,LTAdatasets/9705/annotate/9705-2021_03_20_072817.jpg,187.0,152.0,0.2921875,0.4222222222222222,0.034375,0.03888888888888889
9705-2021_03_20_072817.jpg,lorry_truck,46,386,640,64,360,127,2,432,191,LTAdatasets/9705/annotate/9705-2021_03_20_072817.jpg,409.0,159.0,0.6390625,0.44166666666666665,0.071875,0.17777777777777778
9705-2021_03_20_072817.jpg,lorry_truck,30,456,640,43,360,108,2,486,151,LTAdatasets/9705/annotate/9705-2021_03_20_072817.jpg,471.0,129.5,0.7359375,0.3597222222222222,0.046875,0.11944444444444445
9705-2021_03_20_072817.jpg,lorry_truck,16,435,640,17,360,97,2,451,114,LTAdatasets/9705/annotate/9705-2021_03_20_072817.jpg,443.0,105.5,0.6921875,0.29305555555555557,0.025,0.04722222222222222
9705-2021_03_20_072817.jpg,lorry_truck,18,463,640,29,360,82,2,481,111,LTAdatasets/9705/annotate/9705-2021_03_20_072817.jpg,472.0,96.5,0.7375,0.26805555555555555,0.028125,0.08055555555555556
9705-2021_03_20_072817.jpg,lorry_truck,16,472,640,22,360,65,2,488,87,LTAdatasets/9705/annotate/9705-2021_03_20_072817.jpg,480.0,76.0,0.75,0.2111111111111111,0.025,0.06111111111111111
9705-2021_03_20_072817.jpg,car,11,446,640,11,360,79,1,457,90,LTAdatasets/9705/annotate/9705-2021_03_20_072817.jpg,451.5,84.5,0.70546875,0.23472222222222222,0.0171875,0.030555555555555555
9705-2021_03_20_072817.jpg,bike,13,423,640,17,360,84,4,436,101,LTAdatasets/9705/annotate/9705-2021_03_20_072817.jpg,429.5,92.5,0.67109375,0.2569444444444444,0.0203125,0.04722222222222222
9705-2021_03_20_072817.jpg,lorry_truck,20,307,640,12,360,89,2,327,101,LTAdatasets/9705/annotate/9705-2021_03_20_072817.jpg,317.0,95.0,0.4953125,0.2638888888888889,0.03125,0.03333333333333333
9705-2021_03_20_072817.jpg,van,11,351,640,7,360,78,3,362,85,LTAdatasets/9705/annotate/9705-2021_03_20_072817.jpg,356.5,81.5,0.55703125,0.2263888888888889,0.0171875,0.019444444444444445
9705-2021_03_20_072817.jpg,car,14,458,640,13,360,54,1,472,67,LTAdatasets/9705/annotate/9705-2021_03_20_072817.jpg,465.0,60.5,0.7265625,0.16805555555555557,0.021875,0.03611111111111111
9705-2021_03_20_072817.jpg,car,14,386,640,8,360,54,1,400,62,LTAdatasets/9705/annotate/9705-2021_03_20_072817.jpg,393.0,58.0,0.6140625,0.16111111111111112,0.021875,0.022222222222222223
9705-2021_03_20_094904.jpg,bike,18,255,640,15,360,126,4,273,141,LTAdatasets/9705/annotate/9705-2021_03_20_094904.jpg,264.0,133.5,0.4125,0.37083333333333335,0.028125,0.041666666666666664
9705-2021_03_20_094904.jpg,bike,19,205,640,14,360,118,4,224,132,LTAdatasets/9705/annotate/9705-2021_03_20_094904.jpg,214.5,125.0,0.33515625,0.3472222222222222,0.0296875,0.03888888888888889
9705-2021_03_20_094904.jpg,car,22,317,640,20,360,100,1,339,120,LTAdatasets/9705/annotate/9705-2021_03_20_094904.jpg,328.0,110.0,0.5125,0.3055555555555556,0.034375,0.05555555555555555
9705-2021_03_20_094904.jpg,car,12,455,640,12,360,59,1,467,71,LTAdatasets/9705/annotate/9705-2021_03_20_094904.jpg,461.0,65.0,0.7203125,0.18055555555555555,0.01875,0.03333333333333333
9705-2021_03_20_094904.jpg,car,10,458,640,11,360,51,1,468,62,LTAdatasets/9705/annotate/9705-2021_03_20_094904.jpg,463.0,56.5,0.7234375,0.15694444444444444,0.015625,0.030555555555555555
9705-2021_03_20_094904.jpg,car,16,470,640,11,360,60,1,486,71,LTAdatasets/9705/annotate/9705-2021_03_20_094904.jpg,478.0,65.5,0.746875,0.18194444444444444,0.025,0.030555555555555555
9705-2021_03_20_094904.jpg,car,15,305,640,9,360,76,1,320,85,LTAdatasets/9705/annotate/9705-2021_03_20_094904.jpg,312.5,80.5,0.48828125,0.22361111111111112,0.0234375,0.025
9705-2021_03_20_094904.jpg,car,8,332,640,11,360,60,1,340,71,LTAdatasets/9705/annotate/9705-2021_03_20_094904.jpg,336.0,65.5,0.525,0.18194444444444444,0.0125,0.030555555555555555
9705-2021_03_20_180710.jpg,car,45,170,640,23,360,186,1,215,209,LTAdatasets/9705/annotate/9705-2021_03_20_180710.jpg,192.5,197.5,0.30078125,0.5486111111111112,0.0703125,0.06388888888888888
9705-2021_03_20_180710.jpg,car,18,410,640,15,360,93,1,428,108,LTAdatasets/9705/annotate/9705-2021_03_20_180710.jpg,419.0,100.5,0.6546875,0.2791666666666667,0.028125,0.041666666666666664
9705-2021_03_20_180710.jpg,car,20,433,640,22,360,99,1,453,121,LTAdatasets/9705/annotate/9705-2021_03_20_180710.jpg,443.0,110.0,0.6921875,0.3055555555555556,0.03125,0.06111111111111111
9705-2021_03_20_180710.jpg,car,16,351,640,9,360,82,1,367,91,LTAdatasets/9705/annotate/9705-2021_03_20_180710.jpg,359.0,86.5,0.5609375,0.24027777777777778,0.025,0.025
9705-2021_03_20_180710.jpg,lorry_truck,38,395,640,41,360,144,2,433,185,LTAdatasets/9705/annotate/9705-2021_03_20_180710.jpg,414.0,164.5,0.646875,0.45694444444444443,0.059375,0.11388888888888889
9705-2021_03_20_180710.jpg,lorry_truck,24,468,640,31,360,67,2,492,98,LTAdatasets/9705/annotate/9705-2021_03_20_180710.jpg,480.0,82.5,0.75,0.22916666666666666,0.0375,0.08611111111111111
9705-2021_03_20_180710.jpg,car,15,451,640,12,360,63,1,466,75,LTAdatasets/9705/annotate/9705-2021_03_20_180710.jpg,458.5,69.0,0.71640625,0.19166666666666668,0.0234375,0.03333333333333333
9705-2021_03_20_180710.jpg,car,6,476,640,10,360,60,1,482,70,LTAdatasets/9705/annotate/9705-2021_03_20_180710.jpg,479.0,65.0,0.7484375,0.18055555555555555,0.009375,0.027777777777777776
9705-2021_03_20_180710.jpg,car,13,461,640,15,360,57,1,474,72,LTAdatasets/9705/annotate/9705-2021_03_20_180710.jpg,467.5,64.5,0.73046875,0.17916666666666667,0.0203125,0.041666666666666664
9705-2021_03_20_184913.jpg,van,27,456,640,31,360,115,3,483,146,LTAdatasets/9705/annotate/9705-2021_03_20_184913.jpg,469.5,130.5,0.73359375,0.3625,0.0421875,0.08611111111111111
9705-2021_03_20_184913.jpg,car,16,434,640,15,360,91,1,450,106,LTAdatasets/9705/annotate/9705-2021_03_20_184913.jpg,442.0,98.5,0.690625,0.27361111111111114,0.025,0.041666666666666664
9705-2021_03_20_184913.jpg,car,12,441,640,11,360,66,1,453,77,LTAdatasets/9705/annotate/9705-2021_03_20_184913.jpg,447.0,71.5,0.6984375,0.1986111111111111,0.01875,0.030555555555555555
9705-2021_03_20_184913.jpg,car,10,397,640,8,360,63,1,407,71,LTAdatasets/9705/annotate/9705-2021_03_20_184913.jpg,402.0,67.0,0.628125,0.18611111111111112,0.015625,0.022222222222222223
9705-2021_03_20_184913.jpg,car,20,309,640,13,360,92,1,329,105,LTAdatasets/9705/annotate/9705-2021_03_20_184913.jpg,319.0,98.5,0.4984375,0.27361111111111114,0.03125,0.03611111111111111
9705-2021_03_20_184913.jpg,car,20,273,640,13,360,94,1,293,107,LTAdatasets/9705/annotate/9705-2021_03_20_184913.jpg,283.0,100.5,0.4421875,0.2791666666666667,0.03125,0.03611111111111111
9705-2021_03_20_184913.jpg,car,32,174,640,10,360,145,1,206,155,LTAdatasets/9705/annotate/9705-2021_03_20_184913.jpg,190.0,150.0,0.296875,0.4166666666666667,0.05,0.027777777777777776
9705-2021_03_20_184913.jpg,car,12,318,640,8,360,75,1,330,83,LTAdatasets/9705/annotate/9705-2021_03_20_184913.jpg,324.0,79.0,0.50625,0.21944444444444444,0.01875,0.022222222222222223
9705-2021_03_20_184913.jpg,lorry_truck,9,407,640,12,360,42,2,416,54,LTAdatasets/9705/annotate/9705-2021_03_20_184913.jpg,411.5,48.0,0.64296875,0.13333333333333333,0.0140625,0.03333333333333333
9705-2021_03_20_091903.jpg,lorry_truck,35,448,640,48,360,118,2,483,166,LTAdatasets/9705/annotate/9705-2021_03_20_091903.jpg,465.5,142.0,0.72734375,0.39444444444444443,0.0546875,0.13333333333333333
9705-2021_03_20_091903.jpg,lorry_truck,21,459,640,37,360,90,2,480,127,LTAdatasets/9705/annotate/9705-2021_03_20_091903.jpg,469.5,108.5,0.73359375,0.3013888888888889,0.0328125,0.10277777777777777
9705-2021_03_20_091903.jpg,lorry_truck,25,420,640,44,360,87,2,445,131,LTAdatasets/9705/annotate/9705-2021_03_20_091903.jpg,432.5,109.0,0.67578125,0.30277777777777776,0.0390625,0.12222222222222222
9705-2021_03_20_091903.jpg,lorry_truck,19,472,640,28,360,62,2,491,90,LTAdatasets/9705/annotate/9705-2021_03_20_091903.jpg,481.5,76.0,0.75234375,0.2111111111111111,0.0296875,0.07777777777777778
9705-2021_03_20_091903.jpg,car,18,309,640,14,360,99,1,327,113,LTAdatasets/9705/annotate/9705-2021_03_20_091903.jpg,318.0,106.0,0.496875,0.29444444444444445,0.028125,0.03888888888888889
9705-2021_03_20_091903.jpg,car,34,269,640,19,360,130,1,303,149,LTAdatasets/9705/annotate/9705-2021_03_20_091903.jpg,286.0,139.5,0.446875,0.3875,0.053125,0.05277777777777778
9705-2021_03_20_091903.jpg,car,45,310,640,54,360,223,1,355,277,LTAdatasets/9705/annotate/9705-2021_03_20_091903.jpg,332.5,250.0,0.51953125,0.6944444444444444,0.0703125,0.15
9705-2021_03_20_091903.jpg,car,10,386,640,12,360,61,1,396,73,LTAdatasets/9705/annotate/9705-2021_03_20_091903.jpg,391.0,67.0,0.6109375,0.18611111111111112,0.015625,0.03333333333333333
9705-2021_03_20_091903.jpg,car,11,374,640,7,360,61,1,385,68,LTAdatasets/9705/annotate/9705-2021_03_20_091903.jpg,379.5,64.5,0.59296875,0.17916666666666667,0.0171875,0.019444444444444445
9705-2021_03_20_091903.jpg,car,8,335,640,8,360,59,1,343,67,LTAdatasets/9705/annotate/9705-2021_03_20_091903.jpg,339.0,63.0,0.5296875,0.175,0.0125,0.022222222222222223
9705-2021_03_20_091903.jpg,lorry_truck,11,472,640,13,360,49,2,483,62,LTAdatasets/9705/annotate/9705-2021_03_20_091903.jpg,477.5,55.5,0.74609375,0.15416666666666667,0.0171875,0.03611111111111111
9705-2021_03_20_091903.jpg,lorry_truck,12,457,640,10,360,44,2,469,54,LTAdatasets/9705/annotate/9705-2021_03_20_091903.jpg,463.0,49.0,0.7234375,0.1361111111111111,0.01875,0.027777777777777776
9705-2021_03_20_084901.jpg,van,29,395,640,30,360,134,3,424,164,LTAdatasets/9705/annotate/9705-2021_03_20_084901.jpg,409.5,149.0,0.63984375,0.41388888888888886,0.0453125,0.08333333333333333
9705-2021_03_20_084901.jpg,lorry_truck,32,261,640,30,360,96,2,293,126,LTAdatasets/9705/annotate/9705-2021_03_20_084901.jpg,277.0,111.0,0.4328125,0.30833333333333335,0.05,0.08333333333333333
9705-2021_03_20_084901.jpg,bike,15,254,640,20,360,129,4,269,149,LTAdatasets/9705/annotate/9705-2021_03_20_084901.jpg,261.5,139.0,0.40859375,0.3861111111111111,0.0234375,0.05555555555555555
9705-2021_03_20_084901.jpg,car,17,200,640,18,360,123,1,217,141,LTAdatasets/9705/annotate/9705-2021_03_20_084901.jpg,208.5,132.0,0.32578125,0.36666666666666664,0.0265625,0.05
9705-2021_03_20_084901.jpg,bike,30,168,640,32,360,328,4,198,360,LTAdatasets/9705/annotate/9705-2021_03_20_084901.jpg,183.0,344.0,0.2859375,0.9555555555555556,0.046875,0.08888888888888889
9705-2021_03_20_084901.jpg,car,18,333,640,12,360,87,1,351,99,LTAdatasets/9705/annotate/9705-2021_03_20_084901.jpg,342.0,93.0,0.534375,0.25833333333333336,0.028125,0.03333333333333333
9705-2021_03_20_084901.jpg,car,10,370,640,12,360,70,1,380,82,LTAdatasets/9705/annotate/9705-2021_03_20_084901.jpg,375.0,76.0,0.5859375,0.2111111111111111,0.015625,0.03333333333333333
9705-2021_03_20_084901.jpg,car,9,456,640,7,360,62,1,465,69,LTAdatasets/9705/annotate/9705-2021_03_20_084901.jpg,460.5,65.5,0.71953125,0.18194444444444444,0.0140625,0.019444444444444445
9705-2021_03_20_084901.jpg,lorry_truck,12,474,640,17,360,51,2,486,68,LTAdatasets/9705/annotate/9705-2021_03_20_084901.jpg,480.0,59.5,0.75,0.16527777777777777,0.01875,0.04722222222222222
9705-2021_03_20_084901.jpg,car,13,332,640,11,360,60,1,345,71,LTAdatasets/9705/annotate/9705-2021_03_20_084901.jpg,338.5,65.5,0.52890625,0.18194444444444444,0.0203125,0.030555555555555555
9705-2021_03_20_084901.jpg,lorry_truck,11,370,640,11,360,60,2,381,71,LTAdatasets/9705/annotate/9705-2021_03_20_084901.jpg,375.5,65.5,0.58671875,0.18194444444444444,0.0171875,0.030555555555555555
9705-2021_03_20_192735.jpg,lorry_truck,19,426,640,35,360,108,2,445,143,LTAdatasets/9705/annotate/9705-2021_03_20_192735.jpg,435.5,125.5,0.68046875,0.3486111111111111,0.0296875,0.09722222222222222
9705-2021_03_20_192735.jpg,van,15,473,640,16,360,72,3,488,88,LTAdatasets/9705/annotate/9705-2021_03_20_192735.jpg,480.5,80.0,0.75078125,0.2222222222222222,0.0234375,0.044444444444444446
9705-2021_03_20_192735.jpg,bike,11,459,640,10,360,69,4,470,79,LTAdatasets/9705/annotate/9705-2021_03_20_192735.jpg,464.5,74.0,0.72578125,0.20555555555555555,0.0171875,0.027777777777777776
9705-2021_03_20_192735.jpg,car,61,275,640,85,360,275,1,336,360,LTAdatasets/9705/annotate/9705-2021_03_20_192735.jpg,305.5,317.5,0.47734375,0.8819444444444444,0.0953125,0.2361111111111111
9705-2021_03_20_192735.jpg,car,10,317,640,11,360,71,1,327,82,LTAdatasets/9705/annotate/9705-2021_03_20_192735.jpg,322.0,76.5,0.503125,0.2125,0.015625,0.030555555555555555
9705-2021_03_20_201917.jpg,car,28,0,640,30,360,247,1,28,277,LTAdatasets/9705/annotate/9705-2021_03_20_201917.jpg,14.0,262.0,0.021875,0.7277777777777777,0.04375,0.08333333333333333
9705-2021_03_20_201917.jpg,car,29,252,640,15,360,127,1,281,142,LTAdatasets/9705/annotate/9705-2021_03_20_201917.jpg,266.5,134.5,0.41640625,0.3736111111111111,0.0453125,0.041666666666666664
9705-2021_03_20_201917.jpg,car,22,440,640,18,360,87,1,462,105,LTAdatasets/9705/annotate/9705-2021_03_20_201917.jpg,451.0,96.0,0.7046875,0.26666666666666666,0.034375,0.05
9705-2021_03_20_201917.jpg,bike,12,480,640,11,360,83,4,492,94,LTAdatasets/9705/annotate/9705-2021_03_20_201917.jpg,486.0,88.5,0.759375,0.24583333333333332,0.01875,0.030555555555555555
9705-2021_03_20_201917.jpg,car,10,352,640,15,360,77,1,362,92,LTAdatasets/9705/annotate/9705-2021_03_20_201917.jpg,357.0,84.5,0.5578125,0.23472222222222222,0.015625,0.041666666666666664
9705-2021_03_20_201917.jpg,car,11,383,640,10,360,65,1,394,75,LTAdatasets/9705/annotate/9705-2021_03_20_201917.jpg,388.5,70.0,0.60703125,0.19444444444444445,0.0171875,0.027777777777777776
9705-2021_03_20_201917.jpg,car,8,374,640,10,360,62,1,382,72,LTAdatasets/9705/annotate/9705-2021_03_20_201917.jpg,378.0,67.0,0.590625,0.18611111111111112,0.0125,0.027777777777777776
9705-2021_03_20_201917.jpg,van,15,277,640,12,360,90,3,292,102,LTAdatasets/9705/annotate/9705-2021_03_20_201917.jpg,284.5,96.0,0.44453125,0.26666666666666666,0.0234375,0.03333333333333333
1503-2021_03_20_204018.jpg,car,25,195,320,16,240,122,1,220,138,LTAdatasets/1503/annotate/1503-2021_03_20_204018.jpg,207.5,130.0,0.6484375,0.5416666666666666,0.078125,0.06666666666666667
1503-2021_03_20_204018.jpg,car,17,149,320,11,240,113,1,166,124,LTAdatasets/1503/annotate/1503-2021_03_20_204018.jpg,157.5,118.5,0.4921875,0.49375,0.053125,0.04583333333333333
1503-2021_03_20_204018.jpg,car,13,127,320,11,240,113,1,140,124,LTAdatasets/1503/annotate/1503-2021_03_20_204018.jpg,133.5,118.5,0.4171875,0.49375,0.040625,0.04583333333333333
1503-2021_03_20_204018.jpg,car,20,300,320,20,240,136,1,320,156,LTAdatasets/1503/annotate/1503-2021_03_20_204018.jpg,310.0,146.0,0.96875,0.6083333333333333,0.0625,0.08333333333333333
1503-2021_03_20_095505.jpg,car,29,175,320,23,240,125,1,204,148,LTAdatasets/1503/annotate/1503-2021_03_20_095505.jpg,189.5,136.5,0.5921875,0.56875,0.090625,0.09583333333333334
1503-2021_03_20_095505.jpg,car,25,295,320,18,240,130,1,320,148,LTAdatasets/1503/annotate/1503-2021_03_20_095505.jpg,307.5,139.0,0.9609375,0.5791666666666667,0.078125,0.075
1503-2021_03_20_095505.jpg,lorry_truck,29,203,320,24,240,108,2,232,132,LTAdatasets/1503/annotate/1503-2021_03_20_095505.jpg,217.5,120.0,0.6796875,0.5,0.090625,0.1
1503-2021_03_20_095505.jpg,car,14,68,320,11,240,111,1,82,122,LTAdatasets/1503/annotate/1503-2021_03_20_095505.jpg,75.0,116.5,0.234375,0.48541666666666666,0.04375,0.04583333333333333
1503-2021_03_20_191014.jpg,car,13,154,320,10,240,103,1,167,113,LTAdatasets/1503/annotate/1503-2021_03_20_191014.jpg,160.5,108.0,0.5015625,0.45,0.040625,0.041666666666666664
1503-2021_03_20_191014.jpg,car,9,70,320,7,240,104,1,79,111,LTAdatasets/1503/annotate/1503-2021_03_20_191014.jpg,74.5,107.5,0.2328125,0.4479166666666667,0.028125,0.029166666666666667
1503-2021_03_20_191014.jpg,car,13,26,320,8,240,107,1,39,115,LTAdatasets/1503/annotate/1503-2021_03_20_191014.jpg,32.5,111.0,0.1015625,0.4625,0.040625,0.03333333333333333
1503-2021_03_20_064254.jpg,car,11,66,320,8,240,99,1,77,107,LTAdatasets/1503/annotate/1503-2021_03_20_064254.jpg,71.5,103.0,0.2234375,0.42916666666666664,0.034375,0.03333333333333333
1503-2021_03_20_064254.jpg,lorry_truck,15,148,320,10,240,108,2,163,118,LTAdatasets/1503/annotate/1503-2021_03_20_064254.jpg,155.5,113.0,0.4859375,0.4708333333333333,0.046875,0.041666666666666664
1503-2021_03_20_091302.jpg,car,23,198,320,15,240,124,1,221,139,LTAdatasets/1503/annotate/1503-2021_03_20_091302.jpg,209.5,131.5,0.6546875,0.5479166666666667,0.071875,0.0625
1503-2021_03_20_091302.jpg,lorry_truck,16,193,320,14,240,97,2,209,111,LTAdatasets/1503/annotate/1503-2021_03_20_091302.jpg,201.0,104.0,0.628125,0.43333333333333335,0.05,0.058333333333333334
1503-2021_03_20_091302.jpg,car,11,142,320,8,240,99,1,153,107,LTAdatasets/1503/annotate/1503-2021_03_20_091302.jpg,147.5,103.0,0.4609375,0.42916666666666664,0.034375,0.03333333333333333
1503-2021_03_20_091302.jpg,car,18,59,320,14,240,115,1,77,129,LTAdatasets/1503/annotate/1503-2021_03_20_091302.jpg,68.0,122.0,0.2125,0.5083333333333333,0.05625,0.058333333333333334
1503-2021_03_20_091302.jpg,lorry_truck,16,42,320,13,240,101,2,58,114,LTAdatasets/1503/annotate/1503-2021_03_20_091302.jpg,50.0,107.5,0.15625,0.4479166666666667,0.05,0.05416666666666667
1503-2021_03_20_191914.jpg,van,18,198,320,12,240,112,3,216,124,LTAdatasets/1503/annotate/1503-2021_03_20_191914.jpg,207.0,118.0,0.646875,0.49166666666666664,0.05625,0.05
1503-2021_03_20_191914.jpg,lorry_truck,15,194,320,8,240,103,2,209,111,LTAdatasets/1503/annotate/1503-2021_03_20_191914.jpg,201.5,107.0,0.6296875,0.44583333333333336,0.046875,0.03333333333333333
1503-2021_03_20_191914.jpg,lorry_truck,15,51,320,12,240,100,2,66,112,LTAdatasets/1503/annotate/1503-2021_03_20_191914.jpg,58.5,106.0,0.1828125,0.44166666666666665,0.046875,0.05
1503-2021_03_20_191914.jpg,lorry_truck,13,142,320,11,240,106,2,155,117,LTAdatasets/1503/annotate/1503-2021_03_20_191914.jpg,148.5,111.5,0.4640625,0.46458333333333335,0.040625,0.04583333333333333
1503-2021_03_20_191914.jpg,car,8,72,320,9,240,101,1,80,110,LTAdatasets/1503/annotate/1503-2021_03_20_191914.jpg,76.0,105.5,0.2375,0.4395833333333333,0.025,0.0375
1503-2021_03_20_202437.jpg,car,23,158,320,17,240,116,1,181,133,LTAdatasets/1503/annotate/1503-2021_03_20_202437.jpg,169.5,124.5,0.5296875,0.51875,0.071875,0.07083333333333333
1503-2021_03_20_202437.jpg,lorry_truck,15,40,320,17,240,101,2,55,118,LTAdatasets/1503/annotate/1503-2021_03_20_202437.jpg,47.5,109.5,0.1484375,0.45625,0.046875,0.07083333333333333
1503-2021_03_20_214302.jpg,car,50,270,320,33,240,149,1,320,182,LTAdatasets/1503/annotate/1503-2021_03_20_214302.jpg,295.0,165.5,0.921875,0.6895833333333333,0.15625,0.1375
1503-2021_03_20_214302.jpg,car,44,272,320,25,240,134,1,316,159,LTAdatasets/1503/annotate/1503-2021_03_20_214302.jpg,294.0,146.5,0.91875,0.6104166666666667,0.1375,0.10416666666666667
1503-2021_03_20_085822.jpg,lorry_truck,30,203,320,21,240,93,2,233,114,LTAdatasets/1503/annotate/1503-2021_03_20_085822.jpg,218.0,103.5,0.68125,0.43125,0.09375,0.0875
1503-2021_03_20_085822.jpg,car,11,80,320,6,240,106,1,91,112,LTAdatasets/1503/annotate/1503-2021_03_20_085822.jpg,85.5,109.0,0.2671875,0.45416666666666666,0.034375,0.025
1503-2021_03_20_085822.jpg,car,11,50,320,8,240,105,1,61,113,LTAdatasets/1503/annotate/1503-2021_03_20_085822.jpg,55.5,109.0,0.1734375,0.45416666666666666,0.034375,0.03333333333333333
1503-2021_03_20_065755.jpg,car,17,8,320,13,240,121,1,25,134,LTAdatasets/1503/annotate/1503-2021_03_20_065755.jpg,16.5,127.5,0.0515625,0.53125,0.053125,0.05416666666666667
1503-2021_03_20_074318.jpg,car,30,270,320,25,240,129,1,300,154,LTAdatasets/1503/annotate/1503-2021_03_20_074318.jpg,285.0,141.5,0.890625,0.5895833333333333,0.09375,0.10416666666666667
1503-2021_03_20_074318.jpg,car,20,21,320,16,240,122,1,41,138,LTAdatasets/1503/annotate/1503-2021_03_20_074318.jpg,31.0,130.0,0.096875,0.5416666666666666,0.0625,0.06666666666666667
1503-2021_03_20_074318.jpg,car,10,78,320,10,240,108,1,88,118,LTAdatasets/1503/annotate/1503-2021_03_20_074318.jpg,83.0,113.0,0.259375,0.4708333333333333,0.03125,0.041666666666666664
1503-2021_03_20_074318.jpg,bike,8,17,320,9,240,108,4,25,117,LTAdatasets/1503/annotate/1503-2021_03_20_074318.jpg,21.0,112.5,0.065625,0.46875,0.025,0.0375
1503-2021_03_20_205439.jpg,car,27,256,320,24,240,131,1,283,155,LTAdatasets/1503/annotate/1503-2021_03_20_205439.jpg,269.5,143.0,0.8421875,0.5958333333333333,0.084375,0.1
1503-2021_03_20_205439.jpg,car,15,118,320,8,240,104,1,133,112,LTAdatasets/1503/annotate/1503-2021_03_20_205439.jpg,125.5,108.0,0.3921875,0.45,0.046875,0.03333333333333333
1503-2021_03_20_205439.jpg,car,14,156,320,7,240,99,1,170,106,LTAdatasets/1503/annotate/1503-2021_03_20_205439.jpg,163.0,102.5,0.509375,0.4270833333333333,0.04375,0.029166666666666667
1503-2021_03_20_205439.jpg,car,14,31,320,7,240,106,1,45,113,LTAdatasets/1503/annotate/1503-2021_03_20_205439.jpg,38.0,109.5,0.11875,0.45625,0.04375,0.029166666666666667
1503-2021_03_20_083340.jpg,car,55,219,320,39,240,147,1,274,186,LTAdatasets/1503/annotate/1503-2021_03_20_083340.jpg,246.5,166.5,0.7703125,0.69375,0.171875,0.1625
1503-2021_03_20_083340.jpg,lorry_truck,18,172,320,13,240,103,2,190,116,LTAdatasets/1503/annotate/1503-2021_03_20_083340.jpg,181.0,109.5,0.565625,0.45625,0.05625,0.05416666666666667
1503-2021_03_20_083340.jpg,lorry_truck,11,142,320,6,240,99,2,153,105,LTAdatasets/1503/annotate/1503-2021_03_20_083340.jpg,147.5,102.0,0.4609375,0.425,0.034375,0.025
1503-2021_03_20_210940.jpg,car,24,220,320,13,240,114,1,244,127,LTAdatasets/1503/annotate/1503-2021_03_20_210940.jpg,232.0,120.5,0.725,0.5020833333333333,0.075,0.05416666666666667
1503-2021_03_20_210940.jpg,car,8,182,320,10,240,114,1,190,124,LTAdatasets/1503/annotate/1503-2021_03_20_210940.jpg,186.0,119.0,0.58125,0.49583333333333335,0.025,0.041666666666666664
1503-2021_03_20_100405.jpg,car,16,171,320,12,240,109,1,187,121,LTAdatasets/1503/annotate/1503-2021_03_20_100405.jpg,179.0,115.0,0.559375,0.4791666666666667,0.05,0.05
1503-2021_03_20_100405.jpg,car,23,204,320,12,240,117,1,227,129,LTAdatasets/1503/annotate/1503-2021_03_20_100405.jpg,215.5,123.0,0.6734375,0.5125,0.071875,0.05
1503-2021_03_20_100405.jpg,car,10,142,320,13,240,103,1,152,116,LTAdatasets/1503/annotate/1503-2021_03_20_100405.jpg,147.0,109.5,0.459375,0.45625,0.03125,0.05416666666666667
1503-2021_03_20_100405.jpg,car,15,67,320,11,240,113,1,82,124,LTAdatasets/1503/annotate/1503-2021_03_20_100405.jpg,74.5,118.5,0.2328125,0.49375,0.046875,0.04583333333333333
1503-2021_03_20_100405.jpg,car,21,2,320,17,240,135,1,23,152,LTAdatasets/1503/annotate/1503-2021_03_20_100405.jpg,12.5,143.5,0.0390625,0.5979166666666667,0.065625,0.07083333333333333
1503-2021_03_20_100405.jpg,car,10,66,320,7,240,106,1,76,113,LTAdatasets/1503/annotate/1503-2021_03_20_100405.jpg,71.0,109.5,0.221875,0.45625,0.03125,0.029166666666666667
1503-2021_03_20_100405.jpg,lorry_truck,22,9,320,12,240,107,2,31,119,LTAdatasets/1503/annotate/1503-2021_03_20_100405.jpg,20.0,113.0,0.0625,0.4708333333333333,0.06875,0.05
1503-2021_03_20_100405.jpg,car,11,119,320,9,240,101,1,130,110,LTAdatasets/1503/annotate/1503-2021_03_20_100405.jpg,124.5,105.5,0.3890625,0.4395833333333333,0.034375,0.0375
1503-2021_03_20_203358.jpg,car,12,47,320,10,240,110,1,59,120,LTAdatasets/1503/annotate/1503-2021_03_20_203358.jpg,53.0,115.0,0.165625,0.4791666666666667,0.0375,0.041666666666666664
1503-2021_03_20_203358.jpg,car,19,53,320,15,240,120,1,72,135,LTAdatasets/1503/annotate/1503-2021_03_20_203358.jpg,62.5,127.5,0.1953125,0.53125,0.059375,0.0625
1503-2021_03_20_202758.jpg,car,23,177,320,15,240,113,1,200,128,LTAdatasets/1503/annotate/1503-2021_03_20_202758.jpg,188.5,120.5,0.5890625,0.5020833333333333,0.071875,0.0625
1503-2021_03_20_202758.jpg,car,33,248,320,16,240,119,1,281,135,LTAdatasets/1503/annotate/1503-2021_03_20_202758.jpg,264.5,127.0,0.8265625,0.5291666666666667,0.103125,0.06666666666666667
1503-2021_03_20_202758.jpg,car,13,17,320,10,240,109,1,30,119,LTAdatasets/1503/annotate/1503-2021_03_20_202758.jpg,23.5,114.0,0.0734375,0.475,0.040625,0.041666666666666664
1503-2021_03_20_071836.jpg,car,19,158,320,11,240,108,1,177,119,LTAdatasets/1503/annotate/1503-2021_03_20_071836.jpg,167.5,113.5,0.5234375,0.47291666666666665,0.059375,0.04583333333333333
1503-2021_03_20_071236.jpg,car,11,75,320,13,240,107,1,86,120,LTAdatasets/1503/annotate/1503-2021_03_20_071236.jpg,80.5,113.5,0.2515625,0.47291666666666665,0.034375,0.05416666666666667
1503-2021_03_20_071236.jpg,car,16,25,320,11,240,106,1,41,117,LTAdatasets/1503/annotate/1503-2021_03_20_071236.jpg,33.0,111.5,0.103125,0.46458333333333335,0.05,0.04583333333333333
1503-2021_03_20_071236.jpg,car,8,59,320,6,240,103,1,67,109,LTAdatasets/1503/annotate/1503-2021_03_20_071236.jpg,63.0,106.0,0.196875,0.44166666666666665,0.025,0.025
1503-2021_03_20_071236.jpg,bus,15,158,320,12,240,92,5,173,104,LTAdatasets/1503/annotate/1503-2021_03_20_071236.jpg,165.5,98.0,0.5171875,0.4083333333333333,0.046875,0.05
1503-2021_03_20_194315.jpg,car,30,284,320,20,240,127,1,314,147,LTAdatasets/1503/annotate/1503-2021_03_20_194315.jpg,299.0,137.0,0.934375,0.5708333333333333,0.09375,0.08333333333333333
1503-2021_03_20_194315.jpg,car,16,142,320,6,240,109,1,158,115,LTAdatasets/1503/annotate/1503-2021_03_20_194315.jpg,150.0,112.0,0.46875,0.4666666666666667,0.05,0.025
1503-2021_03_20_194315.jpg,lorry_truck,13,54,320,13,240,100,2,67,113,LTAdatasets/1503/annotate/1503-2021_03_20_194315.jpg,60.5,106.5,0.1890625,0.44375,0.040625,0.05416666666666667
1503-2021_03_20_084301.jpg,car,11,181,320,8,240,99,1,192,107,LTAdatasets/1503/annotate/1503-2021_03_20_084301.jpg,186.5,103.0,0.5828125,0.42916666666666664,0.034375,0.03333333333333333
1503-2021_03_20_084301.jpg,car,11,56,320,6,240,109,1,67,115,LTAdatasets/1503/annotate/1503-2021_03_20_084301.jpg,61.5,112.0,0.1921875,0.4666666666666667,0.034375,0.025
1503-2021_03_20_084301.jpg,car,13,80,320,12,240,101,1,93,113,LTAdatasets/1503/annotate/1503-2021_03_20_084301.jpg,86.5,107.0,0.2703125,0.44583333333333336,0.040625,0.05
1503-2021_03_20_181011.jpg,car,18,230,320,14,240,111,1,248,125,LTAdatasets/1503/annotate/1503-2021_03_20_181011.jpg,239.0,118.0,0.746875,0.49166666666666664,0.05625,0.058333333333333334
1503-2021_03_20_181011.jpg,car,16,62,320,9,240,104,1,78,113,LTAdatasets/1503/annotate/1503-2021_03_20_181011.jpg,70.0,108.5,0.21875,0.45208333333333334,0.05,0.0375
1503-2021_03_20_204919.jpg,car,10,162,320,7,240,96,1,172,103,LTAdatasets/1503/annotate/1503-2021_03_20_204919.jpg,167.0,99.5,0.521875,0.41458333333333336,0.03125,0.029166666666666667
1503-2021_03_20_204919.jpg,bike,4,42,320,7,240,103,4,46,110,LTAdatasets/1503/annotate/1503-2021_03_20_204919.jpg,44.0,106.5,0.1375,0.44375,0.0125,0.029166666666666667
1503-2021_03_20_204919.jpg,bike,8,28,320,11,240,105,4,36,116,LTAdatasets/1503/annotate/1503-2021_03_20_204919.jpg,32.0,110.5,0.1,0.46041666666666664,0.025,0.04583333333333333
1503-2021_03_20_212801.jpg,car,59,202,320,41,240,139,1,261,180,LTAdatasets/1503/annotate/1503-2021_03_20_212801.jpg,231.5,159.5,0.7234375,0.6645833333333333,0.184375,0.17083333333333334
1503-2021_03_20_212801.jpg,car,37,138,320,21,240,131,1,175,152,LTAdatasets/1503/annotate/1503-2021_03_20_212801.jpg,156.5,141.5,0.4890625,0.5895833333333333,0.115625,0.0875
1503-2021_03_20_212801.jpg,car,17,156,320,11,240,104,1,173,115,LTAdatasets/1503/annotate/1503-2021_03_20_212801.jpg,164.5,109.5,0.5140625,0.45625,0.053125,0.04583333333333333
1503-2021_03_20_212801.jpg,car,11,70,320,7,240,101,1,81,108,LTAdatasets/1503/annotate/1503-2021_03_20_212801.jpg,75.5,104.5,0.2359375,0.4354166666666667,0.034375,0.029166666666666667
1503-2021_03_20_093424.jpg,car,15,67,320,11,240,108,1,82,119,LTAdatasets/1503/annotate/1503-2021_03_20_093424.jpg,74.5,113.5,0.2328125,0.47291666666666665,0.046875,0.04583333333333333
1503-2021_03_20_093424.jpg,lorry_truck,11,159,320,10,240,103,2,170,113,LTAdatasets/1503/annotate/1503-2021_03_20_093424.jpg,164.5,108.0,0.5140625,0.45,0.034375,0.041666666666666664
1503-2021_03_20_093424.jpg,lorry_truck,18,179,320,16,240,95,2,197,111,LTAdatasets/1503/annotate/1503-2021_03_20_093424.jpg,188.0,103.0,0.5875,0.42916666666666664,0.05625,0.06666666666666667
1503-2021_03_20_093424.jpg,lorry_truck,25,21,320,13,240,103,2,46,116,LTAdatasets/1503/annotate/1503-2021_03_20_093424.jpg,33.5,109.5,0.1046875,0.45625,0.078125,0.05416666666666667
1503-2021_03_20_093424.jpg,lorry_truck,9,0,320,18,240,124,2,9,142,LTAdatasets/1503/annotate/1503-2021_03_20_093424.jpg,4.5,133.0,0.0140625,0.5541666666666667,0.028125,0.075
1503-2021_03_20_083640.jpg,car,58,248,320,51,240,158,1,306,209,LTAdatasets/1503/annotate/1503-2021_03_20_083640.jpg,277.0,183.5,0.865625,0.7645833333333333,0.18125,0.2125
1503-2021_03_20_083640.jpg,car,12,145,320,8,240,99,1,157,107,LTAdatasets/1503/annotate/1503-2021_03_20_083640.jpg,151.0,103.0,0.471875,0.42916666666666664,0.0375,0.03333333333333333
1503-2021_03_20_083640.jpg,car,12,79,320,8,240,105,1,91,113,LTAdatasets/1503/annotate/1503-2021_03_20_083640.jpg,85.0,109.0,0.265625,0.45416666666666666,0.0375,0.03333333333333333
1503-2021_03_20_180410.jpg,car,10,30,320,10,240,109,1,40,119,LTAdatasets/1503/annotate/1503-2021_03_20_180410.jpg,35.0,114.0,0.109375,0.475,0.03125,0.041666666666666664
1503-2021_03_20_181851.jpg,car,56,161,320,55,240,162,1,217,217,LTAdatasets/1503/annotate/1503-2021_03_20_181851.jpg,189.0,189.5,0.590625,0.7895833333333333,0.175,0.22916666666666666
1503-2021_03_20_181851.jpg,lorry_truck,23,191,320,15,240,119,2,214,134,LTAdatasets/1503/annotate/1503-2021_03_20_181851.jpg,202.5,126.5,0.6328125,0.5270833333333333,0.071875,0.0625
1503-2021_03_20_181851.jpg,car,15,148,320,10,240,109,1,163,119,LTAdatasets/1503/annotate/1503-2021_03_20_181851.jpg,155.5,114.0,0.4859375,0.475,0.046875,0.041666666666666664
1503-2021_03_20_181851.jpg,car,15,16,320,6,240,116,1,31,122,LTAdatasets/1503/annotate/1503-2021_03_20_181851.jpg,23.5,119.0,0.0734375,0.49583333333333335,0.046875,0.025
1503-2021_03_20_181851.jpg,bike,7,194,320,11,240,102,4,201,113,LTAdatasets/1503/annotate/1503-2021_03_20_181851.jpg,197.5,107.5,0.6171875,0.4479166666666667,0.021875,0.04583333333333333
1503-2021_03_20_081319.jpg,lorry_truck,22,178,320,13,240,103,2,200,116,LTAdatasets/1503/annotate/1503-2021_03_20_081319.jpg,189.0,109.5,0.590625,0.45625,0.06875,0.05416666666666667
1503-2021_03_20_081319.jpg,van,15,154,320,11,240,101,3,169,112,LTAdatasets/1503/annotate/1503-2021_03_20_081319.jpg,161.5,106.5,0.5046875,0.44375,0.046875,0.04583333333333333
1503-2021_03_20_220943.jpg,car,18,62,320,9,240,117,1,80,126,LTAdatasets/1503/annotate/1503-2021_03_20_220943.jpg,71.0,121.5,0.221875,0.50625,0.05625,0.0375
1503-2021_03_20_220943.jpg,car,14,52,320,8,240,110,1,66,118,LTAdatasets/1503/annotate/1503-2021_03_20_220943.jpg,59.0,114.0,0.184375,0.475,0.04375,0.03333333333333333
1503-2021_03_20_220943.jpg,car,17,35,320,8,240,109,1,52,117,LTAdatasets/1503/annotate/1503-2021_03_20_220943.jpg,43.5,113.0,0.1359375,0.4708333333333333,0.053125,0.03333333333333333
1503-2021_03_20_220943.jpg,car,16,210,320,9,240,107,1,226,116,LTAdatasets/1503/annotate/1503-2021_03_20_220943.jpg,218.0,111.5,0.68125,0.46458333333333335,0.05,0.0375
1503-2021_03_20_214021.jpg,car,27,176,320,21,240,126,1,203,147,LTAdatasets/1503/annotate/1503-2021_03_20_214021.jpg,189.5,136.5,0.5921875,0.56875,0.084375,0.0875
1503-2021_03_20_214021.jpg,van,27,202,320,22,240,118,3,229,140,LTAdatasets/1503/annotate/1503-2021_03_20_214021.jpg,215.5,129.0,0.6734375,0.5375,0.084375,0.09166666666666666
1503-2021_03_20_214021.jpg,car,22,153,320,15,240,112,1,175,127,LTAdatasets/1503/annotate/1503-2021_03_20_214021.jpg,164.0,119.5,0.5125,0.4979166666666667,0.06875,0.0625
1503-2021_03_20_214021.jpg,car,17,25,320,9,240,115,1,42,124,LTAdatasets/1503/annotate/1503-2021_03_20_214021.jpg,33.5,119.5,0.1046875,0.4979166666666667,0.053125,0.0375
1503-2021_03_20_200637.jpg,car,43,200,320,41,240,142,1,243,183,LTAdatasets/1503/annotate/1503-2021_03_20_200637.jpg,221.5,162.5,0.6921875,0.6770833333333334,0.134375,0.17083333333333334
1503-2021_03_20_200637.jpg,car,28,292,320,18,240,136,1,320,154,LTAdatasets/1503/annotate/1503-2021_03_20_200637.jpg,306.0,145.0,0.95625,0.6041666666666666,0.0875,0.075
1503-2021_03_20_200637.jpg,car,13,57,320,9,240,108,1,70,117,LTAdatasets/1503/annotate/1503-2021_03_20_200637.jpg,63.5,112.5,0.1984375,0.46875,0.040625,0.0375
1503-2021_03_20_200637.jpg,car,16,202,320,13,240,103,1,218,116,LTAdatasets/1503/annotate/1503-2021_03_20_200637.jpg,210.0,109.5,0.65625,0.45625,0.05,0.05416666666666667
1503-2021_03_20_200637.jpg,car,14,155,320,11,240,103,1,169,114,LTAdatasets/1503/annotate/1503-2021_03_20_200637.jpg,162.0,108.5,0.50625,0.45208333333333334,0.04375,0.04583333333333333
1503-2021_03_20_211900.jpg,car,15,10,320,11,240,113,1,25,124,LTAdatasets/1503/annotate/1503-2021_03_20_211900.jpg,17.5,118.5,0.0546875,0.49375,0.046875,0.04583333333333333
1503-2021_03_20_211900.jpg,car,14,51,320,9,240,110,1,65,119,LTAdatasets/1503/annotate/1503-2021_03_20_211900.jpg,58.0,114.5,0.18125,0.47708333333333336,0.04375,0.0375
1503-2021_03_20_221903.jpg,car,77,194,320,56,240,162,1,271,218,LTAdatasets/1503/annotate/1503-2021_03_20_221903.jpg,232.5,190.0,0.7265625,0.7916666666666666,0.240625,0.23333333333333334
1503-2021_03_20_221903.jpg,car,29,135,320,19,240,129,1,164,148,LTAdatasets/1503/annotate/1503-2021_03_20_221903.jpg,149.5,138.5,0.4671875,0.5770833333333333,0.090625,0.07916666666666666
1503-2021_03_20_221903.jpg,car,17,147,320,12,240,111,1,164,123,LTAdatasets/1503/annotate/1503-2021_03_20_221903.jpg,155.5,117.0,0.4859375,0.4875,0.053125,0.05
1503-2021_03_20_070416.jpg,lorry_truck,20,47,320,15,240,95,2,67,110,LTAdatasets/1503/annotate/1503-2021_03_20_070416.jpg,57.0,102.5,0.178125,0.4270833333333333,0.0625,0.0625
1503-2021_03_20_094305.jpg,lorry_truck,40,231,320,29,240,107,2,271,136,LTAdatasets/1503/annotate/1503-2021_03_20_094305.jpg,251.0,121.5,0.784375,0.50625,0.125,0.12083333333333333
1503-2021_03_20_094305.jpg,car,18,126,320,17,240,112,1,144,129,LTAdatasets/1503/annotate/1503-2021_03_20_094305.jpg,135.0,120.5,0.421875,0.5020833333333333,0.05625,0.07083333333333333
1503-2021_03_20_094305.jpg,car,10,36,320,8,240,114,1,46,122,LTAdatasets/1503/annotate/1503-2021_03_20_094305.jpg,41.0,118.0,0.128125,0.49166666666666664,0.03125,0.03333333333333333
1503-2021_03_20_094305.jpg,car,10,17,320,7,240,115,1,27,122,LTAdatasets/1503/annotate/1503-2021_03_20_094305.jpg,22.0,118.5,0.06875,0.49375,0.03125,0.029166666666666667
1503-2021_03_20_100105.jpg,car,76,226,320,51,240,160,1,302,211,LTAdatasets/1503/annotate/1503-2021_03_20_100105.jpg,264.0,185.5,0.825,0.7729166666666667,0.2375,0.2125
1503-2021_03_20_100105.jpg,car,24,40,320,13,240,130,1,64,143,LTAdatasets/1503/annotate/1503-2021_03_20_100105.jpg,52.0,136.5,0.1625,0.56875,0.075,0.05416666666666667
1503-2021_03_20_100105.jpg,car,24,2,320,19,240,128,1,26,147,LTAdatasets/1503/annotate/1503-2021_03_20_100105.jpg,14.0,137.5,0.04375,0.5729166666666666,0.075,0.07916666666666666
1503-2021_03_20_100105.jpg,car,11,38,320,5,240,110,1,49,115,LTAdatasets/1503/annotate/1503-2021_03_20_100105.jpg,43.5,112.5,0.1359375,0.46875,0.034375,0.020833333333333332
1503-2021_03_20_100105.jpg,car,16,160,320,8,240,108,1,176,116,LTAdatasets/1503/annotate/1503-2021_03_20_100105.jpg,168.0,112.0,0.525,0.4666666666666667,0.05,0.03333333333333333
1503-2021_03_20_100105.jpg,car,13,120,320,9,240,102,1,133,111,LTAdatasets/1503/annotate/1503-2021_03_20_100105.jpg,126.5,106.5,0.3953125,0.44375,0.040625,0.0375
1503-2021_03_20_100105.jpg,lorry_truck,16,157,320,12,240,94,2,173,106,LTAdatasets/1503/annotate/1503-2021_03_20_100105.jpg,165.0,100.0,0.515625,0.4166666666666667,0.05,0.05
1503-2021_03_20_100105.jpg,lorry_truck,15,176,320,13,240,96,2,191,109,LTAdatasets/1503/annotate/1503-2021_03_20_100105.jpg,183.5,102.5,0.5734375,0.4270833333333333,0.046875,0.05416666666666667
1503-2021_03_20_221323.jpg,car,37,177,320,26,240,131,1,214,157,LTAdatasets/1503/annotate/1503-2021_03_20_221323.jpg,195.5,144.0,0.6109375,0.6,0.115625,0.10833333333333334
1503-2021_03_20_221323.jpg,van,38,216,320,27,240,124,3,254,151,LTAdatasets/1503/annotate/1503-2021_03_20_221323.jpg,235.0,137.5,0.734375,0.5729166666666666,0.11875,0.1125
1503-2021_03_20_205739.jpg,car,37,235,320,34,240,130,1,272,164,LTAdatasets/1503/annotate/1503-2021_03_20_205739.jpg,253.5,147.0,0.7921875,0.6125,0.115625,0.14166666666666666
1503-2021_03_20_201317.jpg,car,39,149,320,30,240,138,1,188,168,LTAdatasets/1503/annotate/1503-2021_03_20_201317.jpg,168.5,153.0,0.5265625,0.6375,0.121875,0.125
1503-2021_03_20_201317.jpg,car,14,46,320,8,240,102,1,60,110,LTAdatasets/1503/annotate/1503-2021_03_20_201317.jpg,53.0,106.0,0.165625,0.44166666666666665,0.04375,0.03333333333333333
1503-2021_03_20_081920.jpg,car,28,180,320,22,240,134,1,208,156,LTAdatasets/1503/annotate/1503-2021_03_20_081920.jpg,194.0,145.0,0.60625,0.6041666666666666,0.0875,0.09166666666666666
1503-2021_03_20_081920.jpg,car,46,268,320,34,240,151,1,314,185,LTAdatasets/1503/annotate/1503-2021_03_20_081920.jpg,291.0,168.0,0.909375,0.7,0.14375,0.14166666666666666
1503-2021_03_20_081920.jpg,van,20,223,320,19,240,110,3,243,129,LTAdatasets/1503/annotate/1503-2021_03_20_081920.jpg,233.0,119.5,0.728125,0.4979166666666667,0.0625,0.07916666666666666
1503-2021_03_20_081920.jpg,lorry_truck,19,190,320,11,240,106,2,209,117,LTAdatasets/1503/annotate/1503-2021_03_20_081920.jpg,199.5,111.5,0.6234375,0.46458333333333335,0.059375,0.04583333333333333
1503-2021_03_20_081920.jpg,car,28,183,320,18,240,117,1,211,135,LTAdatasets/1503/annotate/1503-2021_03_20_081920.jpg,197.0,126.0,0.615625,0.525,0.0875,0.075
1503-2021_03_20_081920.jpg,lorry_truck,23,0,320,34,240,121,2,23,155,LTAdatasets/1503/annotate/1503-2021_03_20_081920.jpg,11.5,138.0,0.0359375,0.575,0.071875,0.14166666666666666
1503-2021_03_20_081920.jpg,bike,11,47,320,11,240,104,4,58,115,LTAdatasets/1503/annotate/1503-2021_03_20_081920.jpg,52.5,109.5,0.1640625,0.45625,0.034375,0.04583333333333333
1503-2021_03_20_184613.jpg,car,12,72,320,11,240,108,1,84,119,LTAdatasets/1503/annotate/1503-2021_03_20_184613.jpg,78.0,113.5,0.24375,0.47291666666666665,0.0375,0.04583333333333333
1503-2021_03_20_184613.jpg,car,13,146,320,5,240,102,1,159,107,LTAdatasets/1503/annotate/1503-2021_03_20_184613.jpg,152.5,104.5,0.4765625,0.4354166666666667,0.040625,0.020833333333333332
1503-2021_03_20_184613.jpg,lorry_truck,13,171,320,12,240,96,2,184,108,LTAdatasets/1503/annotate/1503-2021_03_20_184613.jpg,177.5,102.0,0.5546875,0.425,0.040625,0.05
1503-2021_03_20_184613.jpg,lorry_truck,17,42,320,13,240,98,2,59,111,LTAdatasets/1503/annotate/1503-2021_03_20_184613.jpg,50.5,104.5,0.1578125,0.4354166666666667,0.053125,0.05416666666666667
1503-2021_03_20_194916.jpg,car,25,133,320,18,240,120,1,158,138,LTAdatasets/1503/annotate/1503-2021_03_20_194916.jpg,145.5,129.0,0.4546875,0.5375,0.078125,0.075
1503-2021_03_20_194916.jpg,car,38,282,320,31,240,140,1,320,171,LTAdatasets/1503/annotate/1503-2021_03_20_194916.jpg,301.0,155.5,0.940625,0.6479166666666667,0.11875,0.12916666666666668
1503-2021_03_20_194916.jpg,car,18,14,320,10,240,120,1,32,130,LTAdatasets/1503/annotate/1503-2021_03_20_194916.jpg,23.0,125.0,0.071875,0.5208333333333334,0.05625,0.041666666666666664
1503-2021_03_20_194916.jpg,car,16,33,320,10,240,103,1,49,113,LTAdatasets/1503/annotate/1503-2021_03_20_194916.jpg,41.0,108.0,0.128125,0.45,0.05,0.041666666666666664
1503-2021_03_20_194916.jpg,car,11,77,320,8,240,105,1,88,113,LTAdatasets/1503/annotate/1503-2021_03_20_194916.jpg,82.5,109.0,0.2578125,0.45416666666666666,0.034375,0.03333333333333333
1503-2021_03_20_194916.jpg,car,12,121,320,9,240,107,1,133,116,LTAdatasets/1503/annotate/1503-2021_03_20_194916.jpg,127.0,111.5,0.396875,0.46458333333333335,0.0375,0.0375
1503-2021_03_20_192214.jpg,van,23,297,320,26,240,130,3,320,156,LTAdatasets/1503/annotate/1503-2021_03_20_192214.jpg,308.5,143.0,0.9640625,0.5958333333333333,0.071875,0.10833333333333334
1503-2021_03_20_192214.jpg,car,17,190,320,9,240,102,1,207,111,LTAdatasets/1503/annotate/1503-2021_03_20_192214.jpg,198.5,106.5,0.6203125,0.44375,0.053125,0.0375
1503-2021_03_20_192214.jpg,car,15,62,320,13,240,112,1,77,125,LTAdatasets/1503/annotate/1503-2021_03_20_192214.jpg,69.5,118.5,0.2171875,0.49375,0.046875,0.05416666666666667
1503-2021_03_20_192214.jpg,car,16,4,320,7,240,115,1,20,122,LTAdatasets/1503/annotate/1503-2021_03_20_192214.jpg,12.0,118.5,0.0375,0.49375,0.05,0.029166666666666667
1503-2021_03_20_070936.jpg,car,12,140,320,9,240,94,1,152,103,LTAdatasets/1503/annotate/1503-2021_03_20_070936.jpg,146.0,98.5,0.45625,0.41041666666666665,0.0375,0.0375
1503-2021_03_20_092543.jpg,lorry_truck,18,213,320,15,240,103,2,231,118,LTAdatasets/1503/annotate/1503-2021_03_20_092543.jpg,222.0,110.5,0.69375,0.46041666666666664,0.05625,0.0625
1503-2021_03_20_092543.jpg,lorry_truck,26,29,320,20,240,97,2,55,117,LTAdatasets/1503/annotate/1503-2021_03_20_092543.jpg,42.0,107.0,0.13125,0.44583333333333336,0.08125,0.08333333333333333
1503-2021_03_20_094024.jpg,car,15,138,320,8,240,104,1,153,112,LTAdatasets/1503/annotate/1503-2021_03_20_094024.jpg,145.5,108.0,0.4546875,0.45,0.046875,0.03333333333333333
1503-2021_03_20_094024.jpg,car,13,193,320,8,240,102,1,206,110,LTAdatasets/1503/annotate/1503-2021_03_20_094024.jpg,199.5,106.0,0.6234375,0.44166666666666665,0.040625,0.03333333333333333
1503-2021_03_20_094024.jpg,car,18,51,320,15,240,120,1,69,135,LTAdatasets/1503/annotate/1503-2021_03_20_094024.jpg,60.0,127.5,0.1875,0.53125,0.05625,0.0625
1503-2021_03_20_101005.jpg,car,18,22,320,14,240,122,1,40,136,LTAdatasets/1503/annotate/1503-2021_03_20_101005.jpg,31.0,129.0,0.096875,0.5375,0.05625,0.058333333333333334
1503-2021_03_20_101005.jpg,car,11,148,320,10,240,99,1,159,109,LTAdatasets/1503/annotate/1503-2021_03_20_101005.jpg,153.5,104.0,0.4796875,0.43333333333333335,0.034375,0.041666666666666664
1503-2021_03_20_063954.jpg,car,18,187,320,10,240,109,1,205,119,LTAdatasets/1503/annotate/1503-2021_03_20_063954.jpg,196.0,114.0,0.6125,0.475,0.05625,0.041666666666666664
1503-2021_03_20_063954.jpg,car,15,150,320,11,240,101,1,165,112,LTAdatasets/1503/annotate/1503-2021_03_20_063954.jpg,157.5,106.5,0.4921875,0.44375,0.046875,0.04583333333333333
1503-2021_03_20_063954.jpg,car,16,22,320,10,240,118,1,38,128,LTAdatasets/1503/annotate/1503-2021_03_20_063954.jpg,30.0,123.0,0.09375,0.5125,0.05,0.041666666666666664
1503-2021_03_20_063954.jpg,bus,31,7,320,17,240,103,5,38,120,LTAdatasets/1503/annotate/1503-2021_03_20_063954.jpg,22.5,111.5,0.0703125,0.46458333333333335,0.096875,0.07083333333333333
1503-2021_03_20_191234.jpg,car,26,172,320,14,240,112,1,198,126,LTAdatasets/1503/annotate/1503-2021_03_20_191234.jpg,185.0,119.0,0.578125,0.49583333333333335,0.08125,0.058333333333333334
1503-2021_03_20_191234.jpg,car,18,43,320,14,240,110,1,61,124,LTAdatasets/1503/annotate/1503-2021_03_20_191234.jpg,52.0,117.0,0.1625,0.4875,0.05625,0.058333333333333334
1503-2021_03_20_191234.jpg,car,17,13,320,13,240,120,1,30,133,LTAdatasets/1503/annotate/1503-2021_03_20_191234.jpg,21.5,126.5,0.0671875,0.5270833333333333,0.053125,0.05416666666666667
1503-2021_03_20_182451.jpg,lorry_truck,44,198,320,37,240,104,2,242,141,LTAdatasets/1503/annotate/1503-2021_03_20_182451.jpg,220.0,122.5,0.6875,0.5104166666666666,0.1375,0.15416666666666667
1503-2021_03_20_182451.jpg,lorry_truck,29,9,320,20,240,108,2,38,128,LTAdatasets/1503/annotate/1503-2021_03_20_182451.jpg,23.5,118.0,0.0734375,0.49166666666666664,0.090625,0.08333333333333333
1503-2021_03_20_182451.jpg,car,34,286,320,26,240,144,1,320,170,LTAdatasets/1503/annotate/1503-2021_03_20_182451.jpg,303.0,157.0,0.946875,0.6541666666666667,0.10625,0.10833333333333334
1503-2021_03_20_182451.jpg,car,13,173,320,10,240,100,1,186,110,LTAdatasets/1503/annotate/1503-2021_03_20_182451.jpg,179.5,105.0,0.5609375,0.4375,0.040625,0.041666666666666664
1503-2021_03_20_201917.jpg,car,31,150,320,28,240,133,1,181,161,LTAdatasets/1503/annotate/1503-2021_03_20_201917.jpg,165.5,147.0,0.5171875,0.6125,0.096875,0.11666666666666667
1503-2021_03_20_201917.jpg,car,20,121,320,14,240,111,1,141,125,LTAdatasets/1503/annotate/1503-2021_03_20_201917.jpg,131.0,118.0,0.409375,0.49166666666666664,0.0625,0.058333333333333334
1503-2021_03_20_201917.jpg,car,15,57,320,9,240,109,1,72,118,LTAdatasets/1503/annotate/1503-2021_03_20_201917.jpg,64.5,113.5,0.2015625,0.47291666666666665,0.046875,0.0375
1503-2021_03_20_201917.jpg,car,9,53,320,8,240,103,1,62,111,LTAdatasets/1503/annotate/1503-2021_03_20_201917.jpg,57.5,107.0,0.1796875,0.44583333333333336,0.028125,0.03333333333333333
1503-2021_03_20_211300.jpg,car,56,204,320,40,240,149,1,260,189,LTAdatasets/1503/annotate/1503-2021_03_20_211300.jpg,232.0,169.0,0.725,0.7041666666666667,0.175,0.16666666666666666
1503-2021_03_20_211300.jpg,car,31,135,320,27,240,124,1,166,151,LTAdatasets/1503/annotate/1503-2021_03_20_211300.jpg,150.5,137.5,0.4703125,0.5729166666666666,0.096875,0.1125
1503-2021_03_20_211300.jpg,car,21,21,320,21,240,148,1,42,169,LTAdatasets/1503/annotate/1503-2021_03_20_211300.jpg,31.5,158.5,0.0984375,0.6604166666666667,0.065625,0.0875
1503-2021_03_20_211300.jpg,bike,10,10,320,13,240,118,4,20,131,LTAdatasets/1503/annotate/1503-2021_03_20_211300.jpg,15.0,124.5,0.046875,0.51875,0.03125,0.05416666666666667
1503-2021_03_20_211300.jpg,car,19,173,320,14,240,103,1,192,117,LTAdatasets/1503/annotate/1503-2021_03_20_211300.jpg,182.5,110.0,0.5703125,0.4583333333333333,0.059375,0.058333333333333334
1503-2021_03_20_185753.jpg,car,42,277,320,37,240,152,1,319,189,LTAdatasets/1503/annotate/1503-2021_03_20_185753.jpg,298.0,170.5,0.93125,0.7104166666666667,0.13125,0.15416666666666667
1503-2021_03_20_185753.jpg,car,23,1,320,19,240,134,1,24,153,LTAdatasets/1503/annotate/1503-2021_03_20_185753.jpg,12.5,143.5,0.0390625,0.5979166666666667,0.071875,0.07916666666666666
1503-2021_03_20_185753.jpg,car,11,163,320,7,240,99,1,174,106,LTAdatasets/1503/annotate/1503-2021_03_20_185753.jpg,168.5,102.5,0.5265625,0.4270833333333333,0.034375,0.029166666666666667
1503-2021_03_20_094904.jpg,van,44,222,320,35,240,124,3,266,159,LTAdatasets/1503/annotate/1503-2021_03_20_094904.jpg,244.0,141.5,0.7625,0.5895833333333333,0.1375,0.14583333333333334
1503-2021_03_20_094904.jpg,car,26,283,320,15,240,128,1,309,143,LTAdatasets/1503/annotate/1503-2021_03_20_094904.jpg,296.0,135.5,0.925,0.5645833333333333,0.08125,0.0625
1503-2021_03_20_094904.jpg,car,17,5,320,11,240,118,1,22,129,LTAdatasets/1503/annotate/1503-2021_03_20_094904.jpg,13.5,123.5,0.0421875,0.5145833333333333,0.053125,0.04583333333333333
1503-2021_03_20_094904.jpg,bike,15,16,320,21,240,149,4,31,170,LTAdatasets/1503/annotate/1503-2021_03_20_094904.jpg,23.5,159.5,0.0734375,0.6645833333333333,0.046875,0.0875
1503-2021_03_20_094904.jpg,lorry_truck,12,44,320,12,240,99,2,56,111,LTAdatasets/1503/annotate/1503-2021_03_20_094904.jpg,50.0,105.0,0.15625,0.4375,0.0375,0.05
1503-2021_03_20_204238.jpg,car,14,65,320,8,240,105,1,79,113,LTAdatasets/1503/annotate/1503-2021_03_20_204238.jpg,72.0,109.0,0.225,0.45416666666666666,0.04375,0.03333333333333333
1503-2021_03_20_204238.jpg,car,14,132,320,8,240,102,1,146,110,LTAdatasets/1503/annotate/1503-2021_03_20_204238.jpg,139.0,106.0,0.434375,0.44166666666666665,0.04375,0.03333333333333333
1503-2021_03_20_204238.jpg,car,13,188,320,11,240,100,1,201,111,LTAdatasets/1503/annotate/1503-2021_03_20_204238.jpg,194.5,105.5,0.6078125,0.4395833333333333,0.040625,0.04583333333333333
1503-2021_03_20_182752.jpg,car,9,117,320,5,240,98,1,126,103,LTAdatasets/1503/annotate/1503-2021_03_20_182752.jpg,121.5,100.5,0.3796875,0.41875,0.028125,0.020833333333333332
1503-2021_03_20_182752.jpg,car,11,161,320,6,240,97,1,172,103,LTAdatasets/1503/annotate/1503-2021_03_20_182752.jpg,166.5,100.0,0.5203125,0.4166666666666667,0.034375,0.025
1503-2021_03_20_200416.jpg,car,20,147,320,14,240,111,1,167,125,LTAdatasets/1503/annotate/1503-2021_03_20_200416.jpg,157.0,118.0,0.490625,0.49166666666666664,0.0625,0.058333333333333334
1503-2021_03_20_200416.jpg,car,16,120,320,9,240,106,1,136,115,LTAdatasets/1503/annotate/1503-2021_03_20_200416.jpg,128.0,110.5,0.4,0.46041666666666664,0.05,0.0375
1503-2021_03_20_200416.jpg,car,11,20,320,8,240,112,1,31,120,LTAdatasets/1503/annotate/1503-2021_03_20_200416.jpg,25.5,116.0,0.0796875,0.48333333333333334,0.034375,0.03333333333333333
1503-2021_03_20_090702.jpg,van,18,157,320,17,240,110,3,175,127,LTAdatasets/1503/annotate/1503-2021_03_20_090702.jpg,166.0,118.5,0.51875,0.49375,0.05625,0.07083333333333333
1503-2021_03_20_090702.jpg,car,11,154,320,6,240,103,1,165,109,LTAdatasets/1503/annotate/1503-2021_03_20_090702.jpg,159.5,106.0,0.4984375,0.44166666666666665,0.034375,0.025
1503-2021_03_20_195736.jpg,car,17,43,320,10,240,114,1,60,124,LTAdatasets/1503/annotate/1503-2021_03_20_195736.jpg,51.5,119.0,0.1609375,0.49583333333333335,0.053125,0.041666666666666664
1503-2021_03_20_195736.jpg,car,15,123,320,9,240,113,1,138,122,LTAdatasets/1503/annotate/1503-2021_03_20_195736.jpg,130.5,117.5,0.4078125,0.4895833333333333,0.046875,0.0375
1503-2021_03_20_195736.jpg,lorry_truck,18,1,320,20,240,104,2,19,124,LTAdatasets/1503/annotate/1503-2021_03_20_195736.jpg,10.0,114.0,0.03125,0.475,0.05625,0.08333333333333333
1503-2021_03_20_082220.jpg,car,31,132,320,23,240,133,1,163,156,LTAdatasets/1503/annotate/1503-2021_03_20_082220.jpg,147.5,144.5,0.4609375,0.6020833333333333,0.096875,0.09583333333333334
1503-2021_03_20_082220.jpg,car,27,206,320,21,240,124,1,233,145,LTAdatasets/1503/annotate/1503-2021_03_20_082220.jpg,219.5,134.5,0.6859375,0.5604166666666667,0.084375,0.0875
1503-2021_03_20_082220.jpg,car,16,58,320,12,240,120,1,74,132,LTAdatasets/1503/annotate/1503-2021_03_20_082220.jpg,66.0,126.0,0.20625,0.525,0.05,0.05
1503-2021_03_20_082220.jpg,lorry_truck,17,3,320,23,240,130,2,20,153,LTAdatasets/1503/annotate/1503-2021_03_20_082220.jpg,11.5,141.5,0.0359375,0.5895833333333333,0.053125,0.09583333333333334
1503-2021_03_20_082220.jpg,lorry_truck,24,2,320,13,240,118,2,26,131,LTAdatasets/1503/annotate/1503-2021_03_20_082220.jpg,14.0,124.5,0.04375,0.51875,0.075,0.05416666666666667
1503-2021_03_20_220403.jpg,car,23,247,320,17,240,122,1,270,139,LTAdatasets/1503/annotate/1503-2021_03_20_220403.jpg,258.5,130.5,0.8078125,0.54375,0.071875,0.07083333333333333
1503-2021_03_20_220403.jpg,car,21,228,320,10,240,113,1,249,123,LTAdatasets/1503/annotate/1503-2021_03_20_220403.jpg,238.5,118.0,0.7453125,0.49166666666666664,0.065625,0.041666666666666664
1503-2021_03_20_220403.jpg,car,47,273,320,40,240,188,1,320,228,LTAdatasets/1503/annotate/1503-2021_03_20_220403.jpg,296.5,208.0,0.9265625,0.8666666666666667,0.146875,0.16666666666666666
1503-2021_03_20_063354.jpg,lorry_truck,17,47,320,11,240,103,2,64,114,LTAdatasets/1503/annotate/1503-2021_03_20_063354.jpg,55.5,108.5,0.1734375,0.45208333333333334,0.053125,0.04583333333333333
1503-2021_03_20_214902.jpg,car,76,185,320,64,240,176,1,261,240,LTAdatasets/1503/annotate/1503-2021_03_20_214902.jpg,223.0,208.0,0.696875,0.8666666666666667,0.2375,0.26666666666666666
1503-2021_03_20_214902.jpg,bike,17,294,320,21,240,137,4,311,158,LTAdatasets/1503/annotate/1503-2021_03_20_214902.jpg,302.5,147.5,0.9453125,0.6145833333333334,0.053125,0.0875
1503-2021_03_20_214902.jpg,car,16,193,320,13,240,105,1,209,118,LTAdatasets/1503/annotate/1503-2021_03_20_214902.jpg,201.0,111.5,0.628125,0.46458333333333335,0.05,0.05416666666666667
1503-2021_03_20_214902.jpg,car,13,59,320,6,240,108,1,72,114,LTAdatasets/1503/annotate/1503-2021_03_20_214902.jpg,65.5,111.0,0.2046875,0.4625,0.040625,0.025
1503-2021_03_20_214902.jpg,car,17,5,320,9,240,110,1,22,119,LTAdatasets/1503/annotate/1503-2021_03_20_214902.jpg,13.5,114.5,0.0421875,0.47708333333333336,0.053125,0.0375
1503-2021_03_20_072817.jpg,lorry_truck,88,232,320,61,240,121,2,320,182,LTAdatasets/1503/annotate/1503-2021_03_20_072817.jpg,276.0,151.5,0.8625,0.63125,0.275,0.25416666666666665
1503-2021_03_20_072817.jpg,car,14,199,320,14,240,106,1,213,120,LTAdatasets/1503/annotate/1503-2021_03_20_072817.jpg,206.0,113.0,0.64375,0.4708333333333333,0.04375,0.058333333333333334
1503-2021_03_20_090402.jpg,lorry_truck,37,208,320,22,240,103,2,245,125,LTAdatasets/1503/annotate/1503-2021_03_20_090402.jpg,226.5,114.0,0.7078125,0.475,0.115625,0.09166666666666666
1503-2021_03_20_090402.jpg,car,14,171,320,7,240,107,1,185,114,LTAdatasets/1503/annotate/1503-2021_03_20_090402.jpg,178.0,110.5,0.55625,0.46041666666666664,0.04375,0.029166666666666667
1503-2021_03_20_090402.jpg,car,16,21,320,9,240,116,1,37,125,LTAdatasets/1503/annotate/1503-2021_03_20_090402.jpg,29.0,120.5,0.090625,0.5020833333333333,0.05,0.0375
1503-2021_03_20_090402.jpg,car,10,65,320,8,240,104,1,75,112,LTAdatasets/1503/annotate/1503-2021_03_20_090402.jpg,70.0,108.0,0.21875,0.45,0.03125,0.03333333333333333
1503-2021_03_20_213341.jpg,car,25,31,320,14,240,133,1,56,147,LTAdatasets/1503/annotate/1503-2021_03_20_213341.jpg,43.5,140.0,0.1359375,0.5833333333333334,0.078125,0.058333333333333334
1503-2021_03_20_213341.jpg,van,18,182,320,13,240,106,3,200,119,LTAdatasets/1503/annotate/1503-2021_03_20_213341.jpg,191.0,112.5,0.596875,0.46875,0.05625,0.05416666666666667
1503-2021_03_20_213341.jpg,car,19,222,320,9,240,110,1,241,119,LTAdatasets/1503/annotate/1503-2021_03_20_213341.jpg,231.5,114.5,0.7234375,0.47708333333333336,0.059375,0.0375
1503-2021_03_20_213341.jpg,car,14,144,320,10,240,110,1,158,120,LTAdatasets/1503/annotate/1503-2021_03_20_213341.jpg,151.0,115.0,0.471875,0.4791666666666667,0.04375,0.041666666666666664
1503-2021_03_20_193635.jpg,car,51,267,320,37,240,149,1,318,186,LTAdatasets/1503/annotate/1503-2021_03_20_193635.jpg,292.5,167.5,0.9140625,0.6979166666666666,0.159375,0.15416666666666667
1503-2021_03_20_193635.jpg,bike,10,170,320,16,240,120,4,180,136,LTAdatasets/1503/annotate/1503-2021_03_20_193635.jpg,175.0,128.0,0.546875,0.5333333333333333,0.03125,0.06666666666666667
1503-2021_03_20_193635.jpg,car,19,51,320,13,240,115,1,70,128,LTAdatasets/1503/annotate/1503-2021_03_20_193635.jpg,60.5,121.5,0.1890625,0.50625,0.059375,0.05416666666666667
1503-2021_03_20_193635.jpg,car,14,16,320,8,240,109,1,30,117,LTAdatasets/1503/annotate/1503-2021_03_20_193635.jpg,23.0,113.0,0.071875,0.4708333333333333,0.04375,0.03333333333333333
1503-2021_03_20_061313.jpg,car,26,158,320,15,240,118,1,184,133,LTAdatasets/1503/annotate/1503-2021_03_20_061313.jpg,171.0,125.5,0.534375,0.5229166666666667,0.08125,0.0625
1503-2021_03_20_181251.jpg,car,16,209,320,11,240,111,1,225,122,LTAdatasets/1503/annotate/1503-2021_03_20_181251.jpg,217.0,116.5,0.678125,0.48541666666666666,0.05,0.04583333333333333
1503-2021_03_20_181251.jpg,car,23,7,320,12,240,120,1,30,132,LTAdatasets/1503/annotate/1503-2021_03_20_181251.jpg,18.5,126.0,0.0578125,0.525,0.071875,0.05
1503-2021_03_20_181251.jpg,car,9,61,320,9,240,106,1,70,115,LTAdatasets/1503/annotate/1503-2021_03_20_181251.jpg,65.5,110.5,0.2046875,0.46041666666666664,0.028125,0.0375
1503-2021_03_20_181251.jpg,car,10,77,320,7,240,108,1,87,115,LTAdatasets/1503/annotate/1503-2021_03_20_181251.jpg,82.0,111.5,0.25625,0.46458333333333335,0.03125,0.029166666666666667
1503-2021_03_20_075518.jpg,car,10,140,320,10,240,106,1,150,116,LTAdatasets/1503/annotate/1503-2021_03_20_075518.jpg,145.0,111.0,0.453125,0.4625,0.03125,0.041666666666666664
1503-2021_03_20_075518.jpg,car,16,11,320,5,240,112,1,27,117,LTAdatasets/1503/annotate/1503-2021_03_20_075518.jpg,19.0,114.5,0.059375,0.47708333333333336,0.05,0.020833333333333332
1503-2021_03_20_075518.jpg,bike,6,61,320,6,240,103,4,67,109,LTAdatasets/1503/annotate/1503-2021_03_20_075518.jpg,64.0,106.0,0.2,0.44166666666666665,0.01875,0.025
1503-2021_03_20_075518.jpg,lorry_truck,13,154,320,12,240,99,2,167,111,LTAdatasets/1503/annotate/1503-2021_03_20_075518.jpg,160.5,105.0,0.5015625,0.4375,0.040625,0.05
1503-2021_03_20_075518.jpg,car,16,181,320,6,240,105,1,197,111,LTAdatasets/1503/annotate/1503-2021_03_20_075518.jpg,189.0,108.0,0.590625,0.45,0.05,0.025
1503-2021_03_20_074918.jpg,bike,15,264,320,15,240,131,4,279,146,LTAdatasets/1503/annotate/1503-2021_03_20_074918.jpg,271.5,138.5,0.8484375,0.5770833333333333,0.046875,0.0625
1503-2021_03_20_074918.jpg,car,13,60,320,15,240,114,1,73,129,LTAdatasets/1503/annotate/1503-2021_03_20_074918.jpg,66.5,121.5,0.2078125,0.50625,0.040625,0.0625
1503-2021_03_20_080419.jpg,car,31,240,320,19,240,128,1,271,147,LTAdatasets/1503/annotate/1503-2021_03_20_080419.jpg,255.5,137.5,0.7984375,0.5729166666666666,0.096875,0.07916666666666666
1503-2021_03_20_080419.jpg,car,26,152,320,16,240,119,1,178,135,LTAdatasets/1503/annotate/1503-2021_03_20_080419.jpg,165.0,127.0,0.515625,0.5291666666666667,0.08125,0.06666666666666667
1503-2021_03_20_080419.jpg,car,19,23,320,25,240,139,1,42,164,LTAdatasets/1503/annotate/1503-2021_03_20_080419.jpg,32.5,151.5,0.1015625,0.63125,0.059375,0.10416666666666667
1503-2021_03_20_080419.jpg,lorry_truck,14,175,320,10,240,104,2,189,114,LTAdatasets/1503/annotate/1503-2021_03_20_080419.jpg,182.0,109.0,0.56875,0.45416666666666666,0.04375,0.041666666666666664
1503-2021_03_20_080419.jpg,car,12,129,320,8,240,97,1,141,105,LTAdatasets/1503/annotate/1503-2021_03_20_080419.jpg,135.0,101.0,0.421875,0.42083333333333334,0.0375,0.03333333333333333
1503-2021_03_20_080419.jpg,car,12,61,320,6,240,102,1,73,108,LTAdatasets/1503/annotate/1503-2021_03_20_080419.jpg,67.0,105.0,0.209375,0.4375,0.0375,0.025
1503-2021_03_20_065455.jpg,bus,32,23,320,19,240,103,5,55,122,LTAdatasets/1503/annotate/1503-2021_03_20_065455.jpg,39.0,112.5,0.121875,0.46875,0.1,0.07916666666666666
1503-2021_03_20_212501.jpg,car,43,237,320,32,240,139,1,280,171,LTAdatasets/1503/annotate/1503-2021_03_20_212501.jpg,258.5,155.0,0.8078125,0.6458333333333334,0.134375,0.13333333333333333
1503-2021_03_20_212501.jpg,car,34,135,320,30,240,130,1,169,160,LTAdatasets/1503/annotate/1503-2021_03_20_212501.jpg,152.0,145.0,0.475,0.6041666666666666,0.10625,0.125
1503-2021_03_20_212501.jpg,car,24,221,320,12,240,108,1,245,120,LTAdatasets/1503/annotate/1503-2021_03_20_212501.jpg,233.0,114.0,0.728125,0.475,0.075,0.05
1503-2021_03_20_212501.jpg,car,14,138,320,11,240,103,1,152,114,LTAdatasets/1503/annotate/1503-2021_03_20_212501.jpg,145.0,108.5,0.453125,0.45208333333333334,0.04375,0.04583333333333333
1503-2021_03_20_212501.jpg,bus,38,282,320,54,240,113,5,320,167,LTAdatasets/1503/annotate/1503-2021_03_20_212501.jpg,301.0,140.0,0.940625,0.5833333333333334,0.11875,0.225
1503-2021_03_20_215802.jpg,car,18,165,320,10,240,109,1,183,119,LTAdatasets/1503/annotate/1503-2021_03_20_215802.jpg,174.0,114.0,0.54375,0.475,0.05625,0.041666666666666664
1503-2021_03_20_215802.jpg,car,23,257,320,15,240,115,1,280,130,LTAdatasets/1503/annotate/1503-2021_03_20_215802.jpg,268.5,122.5,0.8390625,0.5104166666666666,0.071875,0.0625
1503-2021_03_20_215802.jpg,car,14,127,320,8,240,114,1,141,122,LTAdatasets/1503/annotate/1503-2021_03_20_215802.jpg,134.0,118.0,0.41875,0.49166666666666664,0.04375,0.03333333333333333
1503-2021_03_20_192735.jpg,lorry_truck,43,210,320,25,240,103,2,253,128,LTAdatasets/1503/annotate/1503-2021_03_20_192735.jpg,231.5,115.5,0.7234375,0.48125,0.134375,0.10416666666666667
1503-2021_03_20_192735.jpg,car,37,254,320,25,240,132,1,291,157,LTAdatasets/1503/annotate/1503-2021_03_20_192735.jpg,272.5,144.5,0.8515625,0.6020833333333333,0.115625,0.10416666666666667
1503-2021_03_20_192735.jpg,car,23,283,320,16,240,125,1,306,141,LTAdatasets/1503/annotate/1503-2021_03_20_192735.jpg,294.5,133.0,0.9203125,0.5541666666666667,0.071875,0.06666666666666667
1503-2021_03_20_192735.jpg,car,12,68,320,11,240,111,1,80,122,LTAdatasets/1503/annotate/1503-2021_03_20_192735.jpg,74.0,116.5,0.23125,0.48541666666666666,0.0375,0.04583333333333333
1503-2021_03_20_183412.jpg,car,13,125,320,13,240,109,1,138,122,LTAdatasets/1503/annotate/1503-2021_03_20_183412.jpg,131.5,115.5,0.4109375,0.48125,0.040625,0.05416666666666667
1503-2021_03_20_183412.jpg,car,34,183,320,28,240,132,1,217,160,LTAdatasets/1503/annotate/1503-2021_03_20_183412.jpg,200.0,146.0,0.625,0.6083333333333333,0.10625,0.11666666666666667
1503-2021_03_20_183412.jpg,car,21,173,320,13,240,111,1,194,124,LTAdatasets/1503/annotate/1503-2021_03_20_183412.jpg,183.5,117.5,0.5734375,0.4895833333333333,0.065625,0.05416666666666667
1503-2021_03_20_183412.jpg,car,16,4,320,9,240,113,1,20,122,LTAdatasets/1503/annotate/1503-2021_03_20_183412.jpg,12.0,117.5,0.0375,0.4895833333333333,0.05,0.0375
1503-2021_03_20_183412.jpg,car,19,2,320,13,240,126,1,21,139,LTAdatasets/1503/annotate/1503-2021_03_20_183412.jpg,11.5,132.5,0.0359375,0.5520833333333334,0.059375,0.05416666666666667
1503-2021_03_20_073417.jpg,car,15,17,320,9,240,109,1,32,118,LTAdatasets/1503/annotate/1503-2021_03_20_073417.jpg,24.5,113.5,0.0765625,0.47291666666666665,0.046875,0.0375
1503-2021_03_20_073417.jpg,car,13,170,320,7,240,106,1,183,113,LTAdatasets/1503/annotate/1503-2021_03_20_073417.jpg,176.5,109.5,0.5515625,0.45625,0.040625,0.029166666666666667
1503-2021_03_20_073417.jpg,car,14,186,320,8,240,104,1,200,112,LTAdatasets/1503/annotate/1503-2021_03_20_073417.jpg,193.0,108.0,0.603125,0.45,0.04375,0.03333333333333333
1503-2021_03_20_073417.jpg,car,11,153,320,6,240,106,1,164,112,LTAdatasets/1503/annotate/1503-2021_03_20_073417.jpg,158.5,109.0,0.4953125,0.45416666666666666,0.034375,0.025
1503-2021_03_20_073417.jpg,lorry_truck,24,247,320,29,240,102,2,271,131,LTAdatasets/1503/annotate/1503-2021_03_20_073417.jpg,259.0,116.5,0.809375,0.48541666666666666,0.075,0.12083333333333333
1503-2021_03_20_190413.jpg,van,17,193,320,12,240,106,3,210,118,LTAdatasets/1503/annotate/1503-2021_03_20_190413.jpg,201.5,112.0,0.6296875,0.4666666666666667,0.053125,0.05
1503-2021_03_20_190413.jpg,car,9,44,320,11,240,101,1,53,112,LTAdatasets/1503/annotate/1503-2021_03_20_190413.jpg,48.5,106.5,0.1515625,0.44375,0.028125,0.04583333333333333
1503-2021_03_20_190413.jpg,car,19,43,320,19,240,124,1,62,143,LTAdatasets/1503/annotate/1503-2021_03_20_190413.jpg,52.5,133.5,0.1640625,0.55625,0.059375,0.07916666666666666
1503-2021_03_20_073937.jpg,lorry_truck,8,140,320,11,240,92,2,148,103,LTAdatasets/1503/annotate/1503-2021_03_20_073937.jpg,144.0,97.5,0.45,0.40625,0.025,0.04583333333333333
1503-2021_03_20_073937.jpg,lorry_truck,11,53,320,13,240,93,2,64,106,LTAdatasets/1503/annotate/1503-2021_03_20_073937.jpg,58.5,99.5,0.1828125,0.41458333333333336,0.034375,0.05416666666666667
1503-2021_03_20_185153.jpg,car,49,234,320,45,240,157,1,283,202,LTAdatasets/1503/annotate/1503-2021_03_20_185153.jpg,258.5,179.5,0.8078125,0.7479166666666667,0.153125,0.1875
1503-2021_03_20_185153.jpg,lorry_truck,30,268,320,19,240,119,2,298,138,LTAdatasets/1503/annotate/1503-2021_03_20_185153.jpg,283.0,128.5,0.884375,0.5354166666666667,0.09375,0.07916666666666666
1503-2021_03_20_185153.jpg,car,11,81,320,10,240,104,1,92,114,LTAdatasets/1503/annotate/1503-2021_03_20_185153.jpg,86.5,109.0,0.2703125,0.45416666666666666,0.034375,0.041666666666666664
1503-2021_03_20_185153.jpg,car,8,169,320,6,240,99,1,177,105,LTAdatasets/1503/annotate/1503-2021_03_20_185153.jpg,173.0,102.0,0.540625,0.425,0.025,0.025
1503-2021_03_20_185153.jpg,car,9,146,320,6,240,102,1,155,108,LTAdatasets/1503/annotate/1503-2021_03_20_185153.jpg,150.5,105.0,0.4703125,0.4375,0.028125,0.025
1503-2021_03_20_082740.jpg,van,34,283,320,26,240,127,3,317,153,LTAdatasets/1503/annotate/1503-2021_03_20_082740.jpg,300.0,140.0,0.9375,0.5833333333333334,0.10625,0.10833333333333334
1503-2021_03_20_082740.jpg,lorry_truck,25,7,320,16,240,113,2,32,129,LTAdatasets/1503/annotate/1503-2021_03_20_082740.jpg,19.5,121.0,0.0609375,0.5041666666666667,0.078125,0.06666666666666667
1503-2021_03_20_082740.jpg,bike,8,156,320,10,240,102,4,164,112,LTAdatasets/1503/annotate/1503-2021_03_20_082740.jpg,160.0,107.0,0.5,0.44583333333333336,0.025,0.041666666666666664
1503-2021_03_20_183952.jpg,car,19,203,320,15,240,116,1,222,131,LTAdatasets/1503/annotate/1503-2021_03_20_183952.jpg,212.5,123.5,0.6640625,0.5145833333333333,0.059375,0.0625
1503-2021_03_20_183952.jpg,van,16,208,320,12,240,106,3,224,118,LTAdatasets/1503/annotate/1503-2021_03_20_183952.jpg,216.0,112.0,0.675,0.4666666666666667,0.05,0.05
1503-2021_03_20_183952.jpg,car,8,133,320,8,240,103,1,141,111,LTAdatasets/1503/annotate/1503-2021_03_20_183952.jpg,137.0,107.0,0.428125,0.44583333333333336,0.025,0.03333333333333333
1503-2021_03_20_183952.jpg,car,8,180,320,6,240,99,1,188,105,LTAdatasets/1503/annotate/1503-2021_03_20_183952.jpg,184.0,102.0,0.575,0.425,0.025,0.025
1503-2021_03_20_183952.jpg,car,46,274,320,49,240,191,1,320,240,LTAdatasets/1503/annotate/1503-2021_03_20_183952.jpg,297.0,215.5,0.928125,0.8979166666666667,0.14375,0.20416666666666666
1503-2021_03_20_210420.jpg,car,20,149,320,13,240,111,1,169,124,LTAdatasets/1503/annotate/1503-2021_03_20_210420.jpg,159.0,117.5,0.496875,0.4895833333333333,0.0625,0.05416666666666667
1503-2021_03_20_210420.jpg,lorry_truck,28,1,320,25,240,113,2,29,138,LTAdatasets/1503/annotate/1503-2021_03_20_210420.jpg,15.0,125.5,0.046875,0.5229166666666667,0.0875,0.10416666666666667
1503-2021_03_20_210420.jpg,car,11,79,320,9,240,104,1,90,113,LTAdatasets/1503/annotate/1503-2021_03_20_210420.jpg,84.5,108.5,0.2640625,0.45208333333333334,0.034375,0.0375
1503-2021_03_20_210420.jpg,car,11,23,320,7,240,106,1,34,113,LTAdatasets/1503/annotate/1503-2021_03_20_210420.jpg,28.5,109.5,0.0890625,0.45625,0.034375,0.029166666666666667
1503-2021_03_20_072517.jpg,lorry_truck,14,183,320,11,240,96,2,197,107,LTAdatasets/1503/annotate/1503-2021_03_20_072517.jpg,190.0,101.5,0.59375,0.42291666666666666,0.04375,0.04583333333333333
1503-2021_03_20_085141.jpg,van,10,42,320,10,240,107,3,52,117,LTAdatasets/1503/annotate/1503-2021_03_20_085141.jpg,47.0,112.0,0.146875,0.4666666666666667,0.03125,0.041666666666666664
1503-2021_03_20_184913.jpg,bike,15,258,320,24,240,136,4,273,160,LTAdatasets/1503/annotate/1503-2021_03_20_184913.jpg,265.5,148.0,0.8296875,0.6166666666666667,0.046875,0.1
1503-2021_03_20_184913.jpg,car,18,60,320,9,240,116,1,78,125,LTAdatasets/1503/annotate/1503-2021_03_20_184913.jpg,69.0,120.5,0.215625,0.5020833333333333,0.05625,0.0375
1503-2021_03_20_184913.jpg,car,9,183,320,7,240,100,1,192,107,LTAdatasets/1503/annotate/1503-2021_03_20_184913.jpg,187.5,103.5,0.5859375,0.43125,0.028125,0.029166666666666667
1503-2021_03_20_075818.jpg,lorry_truck,49,234,320,39,240,131,2,283,170,LTAdatasets/1503/annotate/1503-2021_03_20_075818.jpg,258.5,150.5,0.8078125,0.6270833333333333,0.153125,0.1625
1503-2021_03_20_080719.jpg,bike,7,59,320,8,240,103,4,66,111,LTAdatasets/1503/annotate/1503-2021_03_20_080719.jpg,62.5,107.0,0.1953125,0.44583333333333336,0.021875,0.03333333333333333
1503-2021_03_20_193415.jpg,lorry_truck,74,223,320,48,240,127,2,297,175,LTAdatasets/1503/annotate/1503-2021_03_20_193415.jpg,260.0,151.0,0.8125,0.6291666666666667,0.23125,0.2
1503-2021_03_20_193415.jpg,car,11,54,320,6,240,104,1,65,110,LTAdatasets/1503/annotate/1503-2021_03_20_193415.jpg,59.5,107.0,0.1859375,0.44583333333333336,0.034375,0.025
1503-2021_03_20_092803.jpg,car,28,139,320,23,240,126,1,167,149,LTAdatasets/1503/annotate/1503-2021_03_20_092803.jpg,153.0,137.5,0.478125,0.5729166666666666,0.0875,0.09583333333333334
1503-2021_03_20_092803.jpg,car,12,55,320,11,240,106,1,67,117,LTAdatasets/1503/annotate/1503-2021_03_20_092803.jpg,61.0,111.5,0.190625,0.46458333333333335,0.0375,0.04583333333333333
1503-2021_03_20_092803.jpg,van,9,83,320,8,240,101,3,92,109,LTAdatasets/1503/annotate/1503-2021_03_20_092803.jpg,87.5,105.0,0.2734375,0.4375,0.028125,0.03333333333333333
1503-2021_03_20_092803.jpg,van,12,0,320,27,240,132,3,12,159,LTAdatasets/1503/annotate/1503-2021_03_20_092803.jpg,6.0,145.5,0.01875,0.60625,0.0375,0.1125
1503-2021_03_20_092803.jpg,lorry_truck,32,187,320,25,240,100,2,219,125,LTAdatasets/1503/annotate/1503-2021_03_20_092803.jpg,203.0,112.5,0.634375,0.46875,0.1,0.10416666666666667
1503-2021_03_20_084901.jpg,car,20,217,320,13,240,113,1,237,126,LTAdatasets/1503/annotate/1503-2021_03_20_084901.jpg,227.0,119.5,0.709375,0.4979166666666667,0.0625,0.05416666666666667
1503-2021_03_20_084901.jpg,car,14,38,320,14,240,116,1,52,130,LTAdatasets/1503/annotate/1503-2021_03_20_084901.jpg,45.0,123.0,0.140625,0.5125,0.04375,0.058333333333333334
8706-2021_03_20_203358.jpg,lorry_truck,50,488,640,61,360,297,2,538,358,LTAdatasets/8706/annotate/8706-2021_03_20_203358.jpg,513.0,327.5,0.8015625,0.9097222222222222,0.078125,0.16944444444444445
8706-2021_03_20_203358.jpg,car,12,250,640,17,360,121,1,262,138,LTAdatasets/8706/annotate/8706-2021_03_20_203358.jpg,256.0,129.5,0.4,0.3597222222222222,0.01875,0.04722222222222222
8706-2021_03_20_083340.jpg,lorry_truck,30,462,640,34,360,264,2,492,298,LTAdatasets/8706/annotate/8706-2021_03_20_083340.jpg,477.0,281.0,0.7453125,0.7805555555555556,0.046875,0.09444444444444444
8706-2021_03_20_083340.jpg,bike,16,448,640,21,360,290,4,464,311,LTAdatasets/8706/annotate/8706-2021_03_20_083340.jpg,456.0,300.5,0.7125,0.8347222222222223,0.025,0.058333333333333334
8706-2021_03_20_083340.jpg,van,10,173,640,12,360,108,3,183,120,LTAdatasets/8706/annotate/8706-2021_03_20_083340.jpg,178.0,114.0,0.278125,0.31666666666666665,0.015625,0.03333333333333333
8706-2021_03_20_200116.jpg,van,20,158,640,20,360,150,3,178,170,LTAdatasets/8706/annotate/8706-2021_03_20_200116.jpg,168.0,160.0,0.2625,0.4444444444444444,0.03125,0.05555555555555555
8706-2021_03_20_200116.jpg,car,15,274,640,12,360,167,1,289,179,LTAdatasets/8706/annotate/8706-2021_03_20_200116.jpg,281.5,173.0,0.43984375,0.48055555555555557,0.0234375,0.03333333333333333
8706-2021_03_20_200116.jpg,car,16,276,640,11,360,130,1,292,141,LTAdatasets/8706/annotate/8706-2021_03_20_200116.jpg,284.0,135.5,0.44375,0.3763888888888889,0.025,0.030555555555555555
8706-2021_03_20_200116.jpg,bike,13,241,640,11,360,147,4,254,158,LTAdatasets/8706/annotate/8706-2021_03_20_200116.jpg,247.5,152.5,0.38671875,0.4236111111111111,0.0203125,0.030555555555555555
8706-2021_03_20_202217.jpg,bus,16,255,640,22,360,109,5,271,131,LTAdatasets/8706/annotate/8706-2021_03_20_202217.jpg,263.0,120.0,0.4109375,0.3333333333333333,0.025,0.06111111111111111
8706-2021_03_20_202217.jpg,car,17,191,640,10,360,108,1,208,118,LTAdatasets/8706/annotate/8706-2021_03_20_202217.jpg,199.5,113.0,0.31171875,0.3138888888888889,0.0265625,0.027777777777777776
8706-2021_03_20_095205.jpg,car,11,276,640,12,360,128,1,287,140,LTAdatasets/8706/annotate/8706-2021_03_20_095205.jpg,281.5,134.0,0.43984375,0.37222222222222223,0.0171875,0.03333333333333333
8706-2021_03_20_193415.jpg,bus,16,163,640,29,360,120,5,179,149,LTAdatasets/8706/annotate/8706-2021_03_20_193415.jpg,171.0,134.5,0.2671875,0.3736111111111111,0.025,0.08055555555555556
8706-2021_03_20_193415.jpg,bike,15,208,640,13,360,169,4,223,182,LTAdatasets/8706/annotate/8706-2021_03_20_193415.jpg,215.5,175.5,0.33671875,0.4875,0.0234375,0.03611111111111111
8706-2021_03_20_193415.jpg,car,15,192,640,14,360,106,1,207,120,LTAdatasets/8706/annotate/8706-2021_03_20_193415.jpg,199.5,113.0,0.31171875,0.3138888888888889,0.0234375,0.03888888888888889
8706-2021_03_20_181251.jpg,lorry_truck,39,430,640,34,360,228,2,469,262,LTAdatasets/8706/annotate/8706-2021_03_20_181251.jpg,449.5,245.0,0.70234375,0.6805555555555556,0.0609375,0.09444444444444444
8706-2021_03_20_094305.jpg,lorry_truck,31,417,640,39,360,209,2,448,248,LTAdatasets/8706/annotate/8706-2021_03_20_094305.jpg,432.5,228.5,0.67578125,0.6347222222222222,0.0484375,0.10833333333333334
8706-2021_03_20_180410.jpg,lorry_truck,34,425,640,38,360,218,2,459,256,LTAdatasets/8706/annotate/8706-2021_03_20_180410.jpg,442.0,237.0,0.690625,0.6583333333333333,0.053125,0.10555555555555556
8706-2021_03_20_180410.jpg,bike,20,220,640,25,360,192,4,240,217,LTAdatasets/8706/annotate/8706-2021_03_20_180410.jpg,230.0,204.5,0.359375,0.5680555555555555,0.03125,0.06944444444444445
8706-2021_03_20_190413.jpg,car,12,183,640,12,360,129,1,195,141,LTAdatasets/8706/annotate/8706-2021_03_20_190413.jpg,189.0,135.0,0.2953125,0.375,0.01875,0.03333333333333333
8706-2021_03_20_075138.jpg,lorry_truck,25,462,640,33,360,276,2,487,309,LTAdatasets/8706/annotate/8706-2021_03_20_075138.jpg,474.5,292.5,0.74140625,0.8125,0.0390625,0.09166666666666666
8706-2021_03_20_075138.jpg,car,15,238,640,14,360,152,1,253,166,LTAdatasets/8706/annotate/8706-2021_03_20_075138.jpg,245.5,159.0,0.38359375,0.44166666666666665,0.0234375,0.03888888888888889
8706-2021_03_20_075138.jpg,car,13,273,640,12,360,146,1,286,158,LTAdatasets/8706/annotate/8706-2021_03_20_075138.jpg,279.5,152.0,0.43671875,0.4222222222222222,0.0203125,0.03333333333333333
8706-2021_03_20_192735.jpg,van,43,170,640,51,360,228,3,213,279,LTAdatasets/8706/annotate/8706-2021_03_20_192735.jpg,191.5,253.5,0.29921875,0.7041666666666667,0.0671875,0.14166666666666666
8706-2021_03_20_192735.jpg,car,17,164,640,17,360,156,1,181,173,LTAdatasets/8706/annotate/8706-2021_03_20_192735.jpg,172.5,164.5,0.26953125,0.45694444444444443,0.0265625,0.04722222222222222
8706-2021_03_20_192735.jpg,lorry_truck,21,389,640,29,360,176,2,410,205,LTAdatasets/8706/annotate/8706-2021_03_20_192735.jpg,399.5,190.5,0.62421875,0.5291666666666667,0.0328125,0.08055555555555556
8706-2021_03_20_073937.jpg,car,16,186,640,14,360,129,1,202,143,LTAdatasets/8706/annotate/8706-2021_03_20_073937.jpg,194.0,136.0,0.303125,0.37777777777777777,0.025,0.03888888888888889
8706-2021_03_20_073937.jpg,bike,8,438,640,18,360,231,4,446,249,LTAdatasets/8706/annotate/8706-2021_03_20_073937.jpg,442.0,240.0,0.690625,0.6666666666666666,0.0125,0.05
8706-2021_03_20_073937.jpg,bike,10,167,640,9,360,116,4,177,125,LTAdatasets/8706/annotate/8706-2021_03_20_073937.jpg,172.0,120.5,0.26875,0.3347222222222222,0.015625,0.025
8706-2021_03_20_073037.jpg,lorry_truck,40,433,640,43,360,233,2,473,276,LTAdatasets/8706/annotate/8706-2021_03_20_073037.jpg,453.0,254.5,0.7078125,0.7069444444444445,0.0625,0.11944444444444445
8706-2021_03_20_073037.jpg,lorry_truck,87,191,640,80,360,280,2,278,360,LTAdatasets/8706/annotate/8706-2021_03_20_073037.jpg,234.5,320.0,0.36640625,0.8888888888888888,0.1359375,0.2222222222222222
8706-2021_03_20_073037.jpg,lorry_truck,11,262,640,17,360,130,2,273,147,LTAdatasets/8706/annotate/8706-2021_03_20_073037.jpg,267.5,138.5,0.41796875,0.38472222222222224,0.0171875,0.04722222222222222
8706-2021_03_20_073037.jpg,car,14,163,640,17,360,118,1,177,135,LTAdatasets/8706/annotate/8706-2021_03_20_073037.jpg,170.0,126.5,0.265625,0.35138888888888886,0.021875,0.04722222222222222
8706-2021_03_20_193635.jpg,lorry_truck,81,185,640,99,360,257,2,266,356,LTAdatasets/8706/annotate/8706-2021_03_20_193635.jpg,225.5,306.5,0.35234375,0.8513888888888889,0.1265625,0.275
8706-2021_03_20_193635.jpg,car,29,196,640,22,360,176,1,225,198,LTAdatasets/8706/annotate/8706-2021_03_20_193635.jpg,210.5,187.0,0.32890625,0.5194444444444445,0.0453125,0.06111111111111111
8706-2021_03_20_193635.jpg,car,17,186,640,18,360,148,1,203,166,LTAdatasets/8706/annotate/8706-2021_03_20_193635.jpg,194.5,157.0,0.30390625,0.4361111111111111,0.0265625,0.05
8706-2021_03_20_081920.jpg,car,10,192,640,9,360,120,1,202,129,LTAdatasets/8706/annotate/8706-2021_03_20_081920.jpg,197.0,124.5,0.3078125,0.3458333333333333,0.015625,0.025
8706-2021_03_20_081920.jpg,bike,9,174,640,21,360,139,4,183,160,LTAdatasets/8706/annotate/8706-2021_03_20_081920.jpg,178.5,149.5,0.27890625,0.4152777777777778,0.0140625,0.058333333333333334
8706-2021_03_20_192214.jpg,lorry_truck,65,452,640,90,360,231,2,517,321,LTAdatasets/8706/annotate/8706-2021_03_20_192214.jpg,484.5,276.0,0.75703125,0.7666666666666667,0.1015625,0.25
8706-2021_03_20_192214.jpg,car,26,210,640,24,360,196,1,236,220,LTAdatasets/8706/annotate/8706-2021_03_20_192214.jpg,223.0,208.0,0.3484375,0.5777777777777777,0.040625,0.06666666666666667
8706-2021_03_20_192214.jpg,car,15,398,640,18,360,190,1,413,208,LTAdatasets/8706/annotate/8706-2021_03_20_192214.jpg,405.5,199.0,0.63359375,0.5527777777777778,0.0234375,0.05
8706-2021_03_20_093103.jpg,lorry_truck,34,502,640,41,360,315,2,536,356,LTAdatasets/8706/annotate/8706-2021_03_20_093103.jpg,519.0,335.5,0.8109375,0.9319444444444445,0.053125,0.11388888888888889
8706-2021_03_20_093103.jpg,car,15,272,640,12,360,170,1,287,182,LTAdatasets/8706/annotate/8706-2021_03_20_093103.jpg,279.5,176.0,0.43671875,0.4888888888888889,0.0234375,0.03333333333333333
8706-2021_03_20_093103.jpg,car,8,259,640,13,360,162,1,267,175,LTAdatasets/8706/annotate/8706-2021_03_20_093103.jpg,263.0,168.5,0.4109375,0.46805555555555556,0.0125,0.03611111111111111
8706-2021_03_20_093103.jpg,car,8,262,640,9,360,136,1,270,145,LTAdatasets/8706/annotate/8706-2021_03_20_093103.jpg,266.0,140.5,0.415625,0.3902777777777778,0.0125,0.025
8706-2021_03_20_093103.jpg,lorry_truck,14,242,640,17,360,135,2,256,152,LTAdatasets/8706/annotate/8706-2021_03_20_093103.jpg,249.0,143.5,0.3890625,0.39861111111111114,0.021875,0.04722222222222222
8706-2021_03_20_194916.jpg,car,19,259,640,14,360,158,1,278,172,LTAdatasets/8706/annotate/8706-2021_03_20_194916.jpg,268.5,165.0,0.41953125,0.4583333333333333,0.0296875,0.03888888888888889
8706-2021_03_20_194916.jpg,car,12,190,640,10,360,113,1,202,123,LTAdatasets/8706/annotate/8706-2021_03_20_194916.jpg,196.0,118.0,0.30625,0.3277777777777778,0.01875,0.027777777777777776
8706-2021_03_20_194916.jpg,lorry_truck,72,489,640,55,360,305,2,561,360,LTAdatasets/8706/annotate/8706-2021_03_20_194916.jpg,525.0,332.5,0.8203125,0.9236111111111112,0.1125,0.1527777777777778
8706-2021_03_20_083640.jpg,lorry_truck,38,477,640,45,360,287,2,515,332,LTAdatasets/8706/annotate/8706-2021_03_20_083640.jpg,496.0,309.5,0.775,0.8597222222222223,0.059375,0.125
8706-2021_03_20_083640.jpg,lorry_truck,29,441,640,29,360,242,2,470,271,LTAdatasets/8706/annotate/8706-2021_03_20_083640.jpg,455.5,256.5,0.71171875,0.7125,0.0453125,0.08055555555555556
8706-2021_03_20_083640.jpg,bike,10,182,640,24,360,169,4,192,193,LTAdatasets/8706/annotate/8706-2021_03_20_083640.jpg,187.0,181.0,0.2921875,0.5027777777777778,0.015625,0.06666666666666667
8706-2021_03_20_083640.jpg,car,16,192,640,15,360,159,1,208,174,LTAdatasets/8706/annotate/8706-2021_03_20_083640.jpg,200.0,166.5,0.3125,0.4625,0.025,0.041666666666666664
8706-2021_03_20_083640.jpg,car,10,260,640,12,360,150,1,270,162,LTAdatasets/8706/annotate/8706-2021_03_20_083640.jpg,265.0,156.0,0.4140625,0.43333333333333335,0.015625,0.03333333333333333
8706-2021_03_20_200637.jpg,van,58,193,640,73,360,271,3,251,344,LTAdatasets/8706/annotate/8706-2021_03_20_200637.jpg,222.0,307.5,0.346875,0.8541666666666666,0.090625,0.20277777777777778
8706-2021_03_20_193935.jpg,car,36,208,640,34,360,198,1,244,232,LTAdatasets/8706/annotate/8706-2021_03_20_193935.jpg,226.0,215.0,0.353125,0.5972222222222222,0.05625,0.09444444444444444
8706-2021_03_20_193935.jpg,car,15,266,640,13,360,120,1,281,133,LTAdatasets/8706/annotate/8706-2021_03_20_193935.jpg,273.5,126.5,0.42734375,0.35138888888888886,0.0234375,0.03611111111111111
8706-2021_03_20_080419.jpg,car,55,307,640,35,360,325,1,362,360,LTAdatasets/8706/annotate/8706-2021_03_20_080419.jpg,334.5,342.5,0.52265625,0.9513888888888888,0.0859375,0.09722222222222222
8706-2021_03_20_080419.jpg,lorry_truck,52,459,640,44,360,260,2,511,304,LTAdatasets/8706/annotate/8706-2021_03_20_080419.jpg,485.0,282.0,0.7578125,0.7833333333333333,0.08125,0.12222222222222222
8706-2021_03_20_080419.jpg,lorry_truck,54,157,640,75,360,182,2,211,257,LTAdatasets/8706/annotate/8706-2021_03_20_080419.jpg,184.0,219.5,0.2875,0.6097222222222223,0.084375,0.20833333333333334
8706-2021_03_20_080419.jpg,lorry_truck,27,147,640,32,360,138,2,174,170,LTAdatasets/8706/annotate/8706-2021_03_20_080419.jpg,160.5,154.0,0.25078125,0.42777777777777776,0.0421875,0.08888888888888889
8706-2021_03_20_080419.jpg,lorry_truck,15,162,640,12,360,123,2,177,135,LTAdatasets/8706/annotate/8706-2021_03_20_080419.jpg,169.5,129.0,0.26484375,0.35833333333333334,0.0234375,0.03333333333333333
8706-2021_03_20_202437.jpg,car,34,205,640,25,360,199,1,239,224,LTAdatasets/8706/annotate/8706-2021_03_20_202437.jpg,222.0,211.5,0.346875,0.5875,0.053125,0.06944444444444445
8706-2021_03_20_092803.jpg,bike,7,171,640,18,360,114,4,178,132,LTAdatasets/8706/annotate/8706-2021_03_20_092803.jpg,174.5,123.0,0.27265625,0.3416666666666667,0.0109375,0.05
8706-2021_03_20_200416.jpg,car,12,181,640,11,360,104,1,193,115,LTAdatasets/8706/annotate/8706-2021_03_20_200416.jpg,187.0,109.5,0.2921875,0.30416666666666664,0.01875,0.030555555555555555
8706-2021_03_20_183412.jpg,lorry_truck,40,457,640,59,360,243,2,497,302,LTAdatasets/8706/annotate/8706-2021_03_20_183412.jpg,477.0,272.5,0.7453125,0.7569444444444444,0.0625,0.1638888888888889
8706-2021_03_20_183412.jpg,car,32,456,640,29,360,325,1,488,354,LTAdatasets/8706/annotate/8706-2021_03_20_183412.jpg,472.0,339.5,0.7375,0.9430555555555555,0.05,0.08055555555555556
8706-2021_03_20_184613.jpg,lorry_truck,29,156,640,42,360,147,2,185,189,LTAdatasets/8706/annotate/8706-2021_03_20_184613.jpg,170.5,168.0,0.26640625,0.4666666666666667,0.0453125,0.11666666666666667
8706-2021_03_20_184613.jpg,lorry_truck,23,422,640,25,360,219,2,445,244,LTAdatasets/8706/annotate/8706-2021_03_20_184613.jpg,433.5,231.5,0.67734375,0.6430555555555556,0.0359375,0.06944444444444445
8706-2021_03_20_184613.jpg,car,28,461,640,37,360,316,1,489,353,LTAdatasets/8706/annotate/8706-2021_03_20_184613.jpg,475.0,334.5,0.7421875,0.9291666666666667,0.04375,0.10277777777777777
8706-2021_03_20_184613.jpg,car,19,190,640,13,360,150,1,209,163,LTAdatasets/8706/annotate/8706-2021_03_20_184613.jpg,199.5,156.5,0.31171875,0.43472222222222223,0.0296875,0.03611111111111111
8706-2021_03_20_184613.jpg,car,14,185,640,13,360,122,1,199,135,LTAdatasets/8706/annotate/8706-2021_03_20_184613.jpg,192.0,128.5,0.3,0.35694444444444445,0.021875,0.03611111111111111
8706-2021_03_20_184613.jpg,lorry_truck,12,245,640,19,360,130,2,257,149,LTAdatasets/8706/annotate/8706-2021_03_20_184613.jpg,251.0,139.5,0.3921875,0.3875,0.01875,0.05277777777777778
8706-2021_03_20_073417.jpg,lorry_truck,28,446,640,38,360,242,2,474,280,LTAdatasets/8706/annotate/8706-2021_03_20_073417.jpg,460.0,261.0,0.71875,0.725,0.04375,0.10555555555555556
8706-2021_03_20_090402.jpg,lorry_truck,35,439,640,47,360,233,2,474,280,LTAdatasets/8706/annotate/8706-2021_03_20_090402.jpg,456.5,256.5,0.71328125,0.7125,0.0546875,0.13055555555555556
8706-2021_03_20_090402.jpg,lorry_truck,19,389,640,25,360,173,2,408,198,LTAdatasets/8706/annotate/8706-2021_03_20_090402.jpg,398.5,185.5,0.62265625,0.5152777777777777,0.0296875,0.06944444444444445
8706-2021_03_20_090402.jpg,car,45,201,640,55,360,281,1,246,336,LTAdatasets/8706/annotate/8706-2021_03_20_090402.jpg,223.5,308.5,0.34921875,0.8569444444444444,0.0703125,0.1527777777777778
8706-2021_03_20_090402.jpg,lorry_truck,12,238,640,18,360,148,2,250,166,LTAdatasets/8706/annotate/8706-2021_03_20_090402.jpg,244.0,157.0,0.38125,0.4361111111111111,0.01875,0.05
8706-2021_03_20_090402.jpg,lorry_truck,17,192,640,17,360,100,2,209,117,LTAdatasets/8706/annotate/8706-2021_03_20_090402.jpg,200.5,108.5,0.31328125,0.3013888888888889,0.0265625,0.04722222222222222
8706-2021_03_20_185453.jpg,car,55,191,640,63,360,291,1,246,354,LTAdatasets/8706/annotate/8706-2021_03_20_185453.jpg,218.5,322.5,0.34140625,0.8958333333333334,0.0859375,0.175
8706-2021_03_20_185453.jpg,lorry_truck,33,494,640,43,360,300,2,527,343,LTAdatasets/8706/annotate/8706-2021_03_20_185453.jpg,510.5,321.5,0.79765625,0.8930555555555556,0.0515625,0.11944444444444445
8706-2021_03_20_185453.jpg,bike,22,471,640,24,360,320,4,493,344,LTAdatasets/8706/annotate/8706-2021_03_20_185453.jpg,482.0,332.0,0.753125,0.9222222222222223,0.034375,0.06666666666666667
8706-2021_03_20_185453.jpg,car,14,256,640,11,360,166,1,270,177,LTAdatasets/8706/annotate/8706-2021_03_20_185453.jpg,263.0,171.5,0.4109375,0.47638888888888886,0.021875,0.030555555555555555
8706-2021_03_20_185453.jpg,car,11,274,640,12,360,148,1,285,160,LTAdatasets/8706/annotate/8706-2021_03_20_185453.jpg,279.5,154.0,0.43671875,0.42777777777777776,0.0171875,0.03333333333333333
8706-2021_03_20_081319.jpg,car,15,257,640,22,360,167,1,272,189,LTAdatasets/8706/annotate/8706-2021_03_20_081319.jpg,264.5,178.0,0.41328125,0.49444444444444446,0.0234375,0.06111111111111111
8706-2021_03_20_081319.jpg,van,13,167,640,10,360,118,3,180,128,LTAdatasets/8706/annotate/8706-2021_03_20_081319.jpg,173.5,123.0,0.27109375,0.3416666666666667,0.0203125,0.027777777777777776
8706-2021_03_20_081319.jpg,lorry_truck,27,410,640,37,360,196,2,437,233,LTAdatasets/8706/annotate/8706-2021_03_20_081319.jpg,423.5,214.5,0.66171875,0.5958333333333333,0.0421875,0.10277777777777777
8706-2021_03_20_081319.jpg,lorry_truck,17,384,640,12,360,172,2,401,184,LTAdatasets/8706/annotate/8706-2021_03_20_081319.jpg,392.5,178.0,0.61328125,0.49444444444444446,0.0265625,0.03333333333333333
8706-2021_03_20_191234.jpg,lorry_truck,41,476,640,48,360,282,2,517,330,LTAdatasets/8706/annotate/8706-2021_03_20_191234.jpg,496.5,306.0,0.77578125,0.85,0.0640625,0.13333333333333333
8706-2021_03_20_191234.jpg,car,19,254,640,17,360,160,1,273,177,LTAdatasets/8706/annotate/8706-2021_03_20_191234.jpg,263.5,168.5,0.41171875,0.46805555555555556,0.0296875,0.04722222222222222
8706-2021_03_20_093724.jpg,lorry_truck,15,174,640,25,360,99,2,189,124,LTAdatasets/8706/annotate/8706-2021_03_20_093724.jpg,181.5,111.5,0.28359375,0.30972222222222223,0.0234375,0.06944444444444445
8706-2021_03_20_093724.jpg,lorry_truck,12,254,640,21,360,107,2,266,128,LTAdatasets/8706/annotate/8706-2021_03_20_093724.jpg,260.0,117.5,0.40625,0.3263888888888889,0.01875,0.058333333333333334
8706-2021_03_20_183112.jpg,van,24,403,640,29,360,189,3,427,218,LTAdatasets/8706/annotate/8706-2021_03_20_183112.jpg,415.0,203.5,0.6484375,0.5652777777777778,0.0375,0.08055555555555556
8706-2021_03_20_183112.jpg,car,8,194,640,8,360,111,1,202,119,LTAdatasets/8706/annotate/8706-2021_03_20_183112.jpg,198.0,115.0,0.309375,0.3194444444444444,0.0125,0.022222222222222223
8706-2021_03_20_183112.jpg,car,14,432,640,17,360,158,1,446,175,LTAdatasets/8706/annotate/8706-2021_03_20_183112.jpg,439.0,166.5,0.6859375,0.4625,0.021875,0.04722222222222222
8706-2021_03_20_183112.jpg,car,20,481,640,10,360,188,1,501,198,LTAdatasets/8706/annotate/8706-2021_03_20_183112.jpg,491.0,193.0,0.7671875,0.5361111111111111,0.03125,0.027777777777777776
8706-2021_03_20_183712.jpg,car,27,159,640,31,360,194,1,186,225,LTAdatasets/8706/annotate/8706-2021_03_20_183712.jpg,172.5,209.5,0.26953125,0.5819444444444445,0.0421875,0.08611111111111111
8706-2021_03_20_183712.jpg,car,14,183,640,9,360,108,1,197,117,LTAdatasets/8706/annotate/8706-2021_03_20_183712.jpg,190.0,112.5,0.296875,0.3125,0.021875,0.025
8706-2021_03_20_092143.jpg,lorry_truck,36,482,640,44,360,303,2,518,347,LTAdatasets/8706/annotate/8706-2021_03_20_092143.jpg,500.0,325.0,0.78125,0.9027777777777778,0.05625,0.12222222222222222
8706-2021_03_20_092143.jpg,lorry_truck,33,419,640,44,360,205,2,452,249,LTAdatasets/8706/annotate/8706-2021_03_20_092143.jpg,435.5,227.0,0.68046875,0.6305555555555555,0.0515625,0.12222222222222222
8706-2021_03_20_072817.jpg,lorry_truck,42,465,640,45,360,276,2,507,321,LTAdatasets/8706/annotate/8706-2021_03_20_072817.jpg,486.0,298.5,0.759375,0.8291666666666667,0.065625,0.125
8706-2021_03_20_072817.jpg,lorry_truck,10,179,640,16,360,102,2,189,118,LTAdatasets/8706/annotate/8706-2021_03_20_072817.jpg,184.0,110.0,0.2875,0.3055555555555556,0.015625,0.044444444444444446
8706-2021_03_20_072817.jpg,lorry_truck,18,242,640,33,360,124,2,260,157,LTAdatasets/8706/annotate/8706-2021_03_20_072817.jpg,251.0,140.5,0.3921875,0.3902777777777778,0.028125,0.09166666666666666
8706-2021_03_20_094605.jpg,lorry_truck,59,185,640,83,360,242,2,244,325,LTAdatasets/8706/annotate/8706-2021_03_20_094605.jpg,214.5,283.5,0.33515625,0.7875,0.0921875,0.23055555555555557
8706-2021_03_20_094605.jpg,car,26,216,640,28,360,196,1,242,224,LTAdatasets/8706/annotate/8706-2021_03_20_094605.jpg,229.0,210.0,0.3578125,0.5833333333333334,0.040625,0.07777777777777778
8706-2021_03_20_094605.jpg,van,26,509,640,42,360,315,3,535,357,LTAdatasets/8706/annotate/8706-2021_03_20_094605.jpg,522.0,336.0,0.815625,0.9333333333333333,0.040625,0.11666666666666667
8706-2021_03_20_094605.jpg,lorry_truck,15,243,640,29,360,131,2,258,160,LTAdatasets/8706/annotate/8706-2021_03_20_094605.jpg,250.5,145.5,0.39140625,0.4041666666666667,0.0234375,0.08055555555555556
8706-2021_03_20_085822.jpg,lorry_truck,15,242,640,23,360,135,2,257,158,LTAdatasets/8706/annotate/8706-2021_03_20_085822.jpg,249.5,146.5,0.38984375,0.40694444444444444,0.0234375,0.06388888888888888
8706-2021_03_20_085822.jpg,lorry_truck,15,247,640,15,360,121,2,262,136,LTAdatasets/8706/annotate/8706-2021_03_20_085822.jpg,254.5,128.5,0.39765625,0.35694444444444445,0.0234375,0.041666666666666664
8706-2021_03_20_085822.jpg,bus,33,404,640,38,360,202,5,437,240,LTAdatasets/8706/annotate/8706-2021_03_20_085822.jpg,420.5,221.0,0.65703125,0.6138888888888889,0.0515625,0.10555555555555556
8706-2021_03_20_095505.jpg,lorry_truck,63,167,640,81,360,215,2,230,296,LTAdatasets/8706/annotate/8706-2021_03_20_095505.jpg,198.5,255.5,0.31015625,0.7097222222222223,0.0984375,0.225
8706-2021_03_20_095505.jpg,lorry_truck,15,156,640,37,360,129,2,171,166,LTAdatasets/8706/annotate/8706-2021_03_20_095505.jpg,163.5,147.5,0.25546875,0.4097222222222222,0.0234375,0.10277777777777777
8706-2021_03_20_095505.jpg,car,15,270,640,13,360,172,1,285,185,LTAdatasets/8706/annotate/8706-2021_03_20_095505.jpg,277.5,178.5,0.43359375,0.49583333333333335,0.0234375,0.03611111111111111
8706-2021_03_20_203058.jpg,lorry_truck,35,426,640,50,360,207,2,461,257,LTAdatasets/8706/annotate/8706-2021_03_20_203058.jpg,443.5,232.0,0.69296875,0.6444444444444445,0.0546875,0.1388888888888889
8706-2021_03_20_203058.jpg,bike,14,199,640,26,360,181,4,213,207,LTAdatasets/8706/annotate/8706-2021_03_20_203058.jpg,206.0,194.0,0.321875,0.5388888888888889,0.021875,0.07222222222222222
8706-2021_03_20_203058.jpg,bike,10,199,640,17,360,152,4,209,169,LTAdatasets/8706/annotate/8706-2021_03_20_203058.jpg,204.0,160.5,0.31875,0.44583333333333336,0.015625,0.04722222222222222
8706-2021_03_20_190113.jpg,lorry_truck,19,392,640,18,360,179,2,411,197,LTAdatasets/8706/annotate/8706-2021_03_20_190113.jpg,401.5,188.0,0.62734375,0.5222222222222223,0.0296875,0.05
8706-2021_03_20_190113.jpg,lorry_truck,14,256,640,21,360,149,2,270,170,LTAdatasets/8706/annotate/8706-2021_03_20_190113.jpg,263.0,159.5,0.4109375,0.44305555555555554,0.021875,0.058333333333333334
8706-2021_03_20_190113.jpg,lorry_truck,14,248,640,14,360,130,2,262,144,LTAdatasets/8706/annotate/8706-2021_03_20_190113.jpg,255.0,137.0,0.3984375,0.38055555555555554,0.021875,0.03888888888888889
8706-2021_03_20_190113.jpg,car,8,188,640,11,360,119,1,196,130,LTAdatasets/8706/annotate/8706-2021_03_20_190113.jpg,192.0,124.5,0.3,0.3458333333333333,0.0125,0.030555555555555555
8706-2021_03_20_190113.jpg,car,9,190,640,9,360,104,1,199,113,LTAdatasets/8706/annotate/8706-2021_03_20_190113.jpg,194.5,108.5,0.30390625,0.3013888888888889,0.0140625,0.025
8706-2021_03_20_192515.jpg,car,38,220,640,45,360,225,1,258,270,LTAdatasets/8706/annotate/8706-2021_03_20_192515.jpg,239.0,247.5,0.3734375,0.6875,0.059375,0.125
8706-2021_03_20_192515.jpg,bike,15,451,640,21,360,259,4,466,280,LTAdatasets/8706/annotate/8706-2021_03_20_192515.jpg,458.5,269.5,0.71640625,0.7486111111111111,0.0234375,0.058333333333333334
8706-2021_03_20_192515.jpg,car,12,273,640,18,360,156,1,285,174,LTAdatasets/8706/annotate/8706-2021_03_20_192515.jpg,279.0,165.0,0.4359375,0.4583333333333333,0.01875,0.05
8706-2021_03_20_192515.jpg,car,7,277,640,10,360,137,1,284,147,LTAdatasets/8706/annotate/8706-2021_03_20_192515.jpg,280.5,142.0,0.43828125,0.39444444444444443,0.0109375,0.027777777777777776
8706-2021_03_20_192515.jpg,lorry_truck,18,238,640,25,360,145,2,256,170,LTAdatasets/8706/annotate/8706-2021_03_20_192515.jpg,247.0,157.5,0.3859375,0.4375,0.028125,0.06944444444444445
8706-2021_03_20_184913.jpg,car,14,165,640,11,360,135,1,179,146,LTAdatasets/8706/annotate/8706-2021_03_20_184913.jpg,172.0,140.5,0.26875,0.3902777777777778,0.021875,0.030555555555555555
8706-2021_03_20_184913.jpg,car,18,188,640,13,360,122,1,206,135,LTAdatasets/8706/annotate/8706-2021_03_20_184913.jpg,197.0,128.5,0.3078125,0.35694444444444445,0.028125,0.03611111111111111
8706-2021_03_20_184913.jpg,car,14,273,640,14,360,165,1,287,179,LTAdatasets/8706/annotate/8706-2021_03_20_184913.jpg,280.0,172.0,0.4375,0.4777777777777778,0.021875,0.03888888888888889
8706-2021_03_20_191614.jpg,lorry_truck,18,379,640,26,360,157,2,397,183,LTAdatasets/8706/annotate/8706-2021_03_20_191614.jpg,388.0,170.0,0.60625,0.4722222222222222,0.028125,0.07222222222222222
8706-2021_03_20_191614.jpg,van,8,259,640,18,360,155,3,267,173,LTAdatasets/8706/annotate/8706-2021_03_20_191614.jpg,263.0,164.0,0.4109375,0.45555555555555555,0.0125,0.05
8706-2021_03_20_191614.jpg,car,10,275,640,9,360,168,1,285,177,LTAdatasets/8706/annotate/8706-2021_03_20_191614.jpg,280.0,172.5,0.4375,0.4791666666666667,0.015625,0.025
8706-2021_03_20_191614.jpg,lorry_truck,17,245,640,19,360,124,2,262,143,LTAdatasets/8706/annotate/8706-2021_03_20_191614.jpg,253.5,133.5,0.39609375,0.37083333333333335,0.0265625,0.05277777777777778
8706-2021_03_20_091302.jpg,lorry_truck,85,195,640,59,360,301,2,280,360,LTAdatasets/8706/annotate/8706-2021_03_20_091302.jpg,237.5,330.5,0.37109375,0.9180555555555555,0.1328125,0.1638888888888889
8706-2021_03_20_091302.jpg,lorry_truck,14,163,640,21,360,134,2,177,155,LTAdatasets/8706/annotate/8706-2021_03_20_091302.jpg,170.0,144.5,0.265625,0.4013888888888889,0.021875,0.058333333333333334
8706-2021_03_20_082440.jpg,lorry_truck,34,190,640,36,360,180,2,224,216,LTAdatasets/8706/annotate/8706-2021_03_20_082440.jpg,207.0,198.0,0.3234375,0.55,0.053125,0.1
8706-2021_03_20_082440.jpg,lorry_truck,20,254,640,19,360,168,2,274,187,LTAdatasets/8706/annotate/8706-2021_03_20_082440.jpg,264.0,177.5,0.4125,0.4930555555555556,0.03125,0.05277777777777778
8706-2021_03_20_082440.jpg,car,14,178,640,13,360,119,1,192,132,LTAdatasets/8706/annotate/8706-2021_03_20_082440.jpg,185.0,125.5,0.2890625,0.3486111111111111,0.021875,0.03611111111111111
8706-2021_03_20_075818.jpg,bus,55,439,640,72,360,228,5,494,300,LTAdatasets/8706/annotate/8706-2021_03_20_075818.jpg,466.5,264.0,0.72890625,0.7333333333333333,0.0859375,0.2
8706-2021_03_20_073717.jpg,van,28,462,640,44,360,302,3,490,346,LTAdatasets/8706/annotate/8706-2021_03_20_073717.jpg,476.0,324.0,0.74375,0.9,0.04375,0.12222222222222222
8706-2021_03_20_073717.jpg,lorry_truck,24,398,640,35,360,181,2,422,216,LTAdatasets/8706/annotate/8706-2021_03_20_073717.jpg,410.0,198.5,0.640625,0.5513888888888889,0.0375,0.09722222222222222
8706-2021_03_20_090702.jpg,bike,14,450,640,28,360,299,4,464,327,LTAdatasets/8706/annotate/8706-2021_03_20_090702.jpg,457.0,313.0,0.7140625,0.8694444444444445,0.021875,0.07777777777777778
8706-2021_03_20_090702.jpg,car,9,256,640,16,360,174,1,265,190,LTAdatasets/8706/annotate/8706-2021_03_20_090702.jpg,260.5,182.0,0.40703125,0.5055555555555555,0.0140625,0.044444444444444446
8706-2021_03_20_090102.jpg,lorry_truck,12,241,640,23,360,144,2,253,167,LTAdatasets/8706/annotate/8706-2021_03_20_090102.jpg,247.0,155.5,0.3859375,0.43194444444444446,0.01875,0.06388888888888888
8706-2021_03_20_090102.jpg,car,20,186,640,20,360,161,1,206,181,LTAdatasets/8706/annotate/8706-2021_03_20_090102.jpg,196.0,171.0,0.30625,0.475,0.03125,0.05555555555555555
8706-2021_03_20_090102.jpg,bike,14,184,640,16,360,131,4,198,147,LTAdatasets/8706/annotate/8706-2021_03_20_090102.jpg,191.0,139.0,0.2984375,0.3861111111111111,0.021875,0.044444444444444446
8706-2021_03_20_080719.jpg,car,25,460,640,31,360,310,1,485,341,LTAdatasets/8706/annotate/8706-2021_03_20_080719.jpg,472.5,325.5,0.73828125,0.9041666666666667,0.0390625,0.08611111111111111
8706-2021_03_20_201917.jpg,car,25,201,640,30,360,169,1,226,199,LTAdatasets/8706/annotate/8706-2021_03_20_201917.jpg,213.5,184.0,0.33359375,0.5111111111111111,0.0390625,0.08333333333333333
8706-2021_03_20_201917.jpg,car,17,188,640,10,360,119,1,205,129,LTAdatasets/8706/annotate/8706-2021_03_20_201917.jpg,196.5,124.0,0.30703125,0.34444444444444444,0.0265625,0.027777777777777776
8706-2021_03_20_201917.jpg,bike,12,166,640,23,360,155,4,178,178,LTAdatasets/8706/annotate/8706-2021_03_20_201917.jpg,172.0,166.5,0.26875,0.4625,0.01875,0.06388888888888888
8706-2021_03_20_180710.jpg,car,35,216,640,31,360,203,1,251,234,LTAdatasets/8706/annotate/8706-2021_03_20_180710.jpg,233.5,218.5,0.36484375,0.6069444444444444,0.0546875,0.08611111111111111
8706-2021_03_20_180710.jpg,car,13,189,640,15,360,131,1,202,146,LTAdatasets/8706/annotate/8706-2021_03_20_180710.jpg,195.5,138.5,0.30546875,0.38472222222222224,0.0203125,0.041666666666666664
8706-2021_03_20_180710.jpg,lorry_truck,59,502,640,44,360,316,2,561,360,LTAdatasets/8706/annotate/8706-2021_03_20_180710.jpg,531.5,338.0,0.83046875,0.9388888888888889,0.0921875,0.12222222222222222
8706-2021_03_20_084301.jpg,car,13,165,640,13,360,123,1,178,136,LTAdatasets/8706/annotate/8706-2021_03_20_084301.jpg,171.5,129.5,0.26796875,0.3597222222222222,0.0203125,0.03611111111111111
8706-2021_03_20_080119.jpg,car,19,429,640,29,360,223,1,448,252,LTAdatasets/8706/annotate/8706-2021_03_20_080119.jpg,438.5,237.5,0.68515625,0.6597222222222222,0.0296875,0.08055555555555556
8706-2021_03_20_080119.jpg,bike,10,276,640,17,360,171,4,286,188,LTAdatasets/8706/annotate/8706-2021_03_20_080119.jpg,281.0,179.5,0.4390625,0.4986111111111111,0.015625,0.04722222222222222
8706-2021_03_20_080119.jpg,bus,11,257,640,28,360,138,5,268,166,LTAdatasets/8706/annotate/8706-2021_03_20_080119.jpg,262.5,152.0,0.41015625,0.4222222222222222,0.0171875,0.07777777777777778
8706-2021_03_20_201617.jpg,car,37,228,640,41,360,218,1,265,259,LTAdatasets/8706/annotate/8706-2021_03_20_201617.jpg,246.5,238.5,0.38515625,0.6625,0.0578125,0.11388888888888889
8706-2021_03_20_201617.jpg,car,21,189,640,23,360,158,1,210,181,LTAdatasets/8706/annotate/8706-2021_03_20_201617.jpg,199.5,169.5,0.31171875,0.4708333333333333,0.0328125,0.06388888888888888
8706-2021_03_20_201617.jpg,car,18,186,640,15,360,125,1,204,140,LTAdatasets/8706/annotate/8706-2021_03_20_201617.jpg,195.0,132.5,0.3046875,0.3680555555555556,0.028125,0.041666666666666664
8706-2021_03_20_201617.jpg,car,16,257,640,11,360,150,1,273,161,LTAdatasets/8706/annotate/8706-2021_03_20_201617.jpg,265.0,155.5,0.4140625,0.43194444444444446,0.025,0.030555555555555555
8706-2021_03_20_185753.jpg,lorry_truck,73,170,640,108,360,245,2,243,353,LTAdatasets/8706/annotate/8706-2021_03_20_185753.jpg,206.5,299.0,0.32265625,0.8305555555555556,0.1140625,0.3
8706-2021_03_20_185753.jpg,lorry_truck,17,156,640,25,360,138,2,173,163,LTAdatasets/8706/annotate/8706-2021_03_20_185753.jpg,164.5,150.5,0.25703125,0.41805555555555557,0.0265625,0.06944444444444445
8706-2021_03_20_185753.jpg,car,10,190,640,13,360,139,1,200,152,LTAdatasets/8706/annotate/8706-2021_03_20_185753.jpg,195.0,145.5,0.3046875,0.4041666666666667,0.015625,0.03611111111111111
8706-2021_03_20_185753.jpg,car,16,273,640,14,360,177,1,289,191,LTAdatasets/8706/annotate/8706-2021_03_20_185753.jpg,281.0,184.0,0.4390625,0.5111111111111111,0.025,0.03888888888888889
8706-2021_03_20_185753.jpg,car,10,191,640,11,360,111,1,201,122,LTAdatasets/8706/annotate/8706-2021_03_20_185753.jpg,196.0,116.5,0.30625,0.3236111111111111,0.015625,0.030555555555555555
8706-2021_03_20_094904.jpg,car,58,255,640,60,360,275,1,313,335,LTAdatasets/8706/annotate/8706-2021_03_20_094904.jpg,284.0,305.0,0.44375,0.8472222222222222,0.090625,0.16666666666666666
8706-2021_03_20_094904.jpg,lorry_truck,15,249,640,17,360,121,2,264,138,LTAdatasets/8706/annotate/8706-2021_03_20_094904.jpg,256.5,129.5,0.40078125,0.3597222222222222,0.0234375,0.04722222222222222
8706-2021_03_20_091623.jpg,bike,10,190,640,15,360,112,4,200,127,LTAdatasets/8706/annotate/8706-2021_03_20_091623.jpg,195.0,119.5,0.3046875,0.33194444444444443,0.015625,0.041666666666666664
8706-2021_03_20_084901.jpg,van,28,475,640,26,360,334,3,503,360,LTAdatasets/8706/annotate/8706-2021_03_20_084901.jpg,489.0,347.0,0.7640625,0.9638888888888889,0.04375,0.07222222222222222
8706-2021_03_20_084901.jpg,lorry_truck,12,252,640,16,360,112,2,264,128,LTAdatasets/8706/annotate/8706-2021_03_20_084901.jpg,258.0,120.0,0.403125,0.3333333333333333,0.01875,0.044444444444444446
8706-2021_03_20_181851.jpg,bike,14,512,640,25,360,331,4,526,356,LTAdatasets/8706/annotate/8706-2021_03_20_181851.jpg,519.0,343.5,0.8109375,0.9541666666666667,0.021875,0.06944444444444445
8706-2021_03_20_181851.jpg,van,9,255,640,15,360,164,3,264,179,LTAdatasets/8706/annotate/8706-2021_03_20_181851.jpg,259.5,171.5,0.40546875,0.47638888888888886,0.0140625,0.041666666666666664
8706-2021_03_20_181851.jpg,car,11,263,640,8,360,134,1,274,142,LTAdatasets/8706/annotate/8706-2021_03_20_181851.jpg,268.5,138.0,0.41953125,0.38333333333333336,0.0171875,0.022222222222222223
8706-2021_03_20_182151.jpg,lorry_truck,14,250,640,21,360,115,2,264,136,LTAdatasets/8706/annotate/8706-2021_03_20_182151.jpg,257.0,125.5,0.4015625,0.3486111111111111,0.021875,0.058333333333333334
8706-2021_03_20_190634.jpg,bus,25,417,640,43,360,200,5,442,243,LTAdatasets/8706/annotate/8706-2021_03_20_190634.jpg,429.5,221.5,0.67109375,0.6152777777777778,0.0390625,0.11944444444444445
8706-2021_03_20_190634.jpg,van,14,202,640,29,360,150,3,216,179,LTAdatasets/8706/annotate/8706-2021_03_20_190634.jpg,209.0,164.5,0.3265625,0.45694444444444443,0.021875,0.08055555555555556
8706-2021_03_20_190634.jpg,van,16,163,640,17,360,150,3,179,167,LTAdatasets/8706/annotate/8706-2021_03_20_190634.jpg,171.0,158.5,0.2671875,0.44027777777777777,0.025,0.04722222222222222
8706-2021_03_20_190634.jpg,lorry_truck,16,169,640,21,360,110,2,185,131,LTAdatasets/8706/annotate/8706-2021_03_20_190634.jpg,177.0,120.5,0.2765625,0.3347222222222222,0.025,0.058333333333333334
8706-2021_03_20_190634.jpg,car,11,274,640,13,360,174,1,285,187,LTAdatasets/8706/annotate/8706-2021_03_20_190634.jpg,279.5,180.5,0.43671875,0.5013888888888889,0.0171875,0.03611111111111111
8706-2021_03_20_084001.jpg,car,16,269,640,17,360,171,1,285,188,LTAdatasets/8706/annotate/8706-2021_03_20_084001.jpg,277.0,179.5,0.4328125,0.4986111111111111,0.025,0.04722222222222222
8706-2021_03_20_194616.jpg,van,28,165,640,29,360,208,3,193,237,LTAdatasets/8706/annotate/8706-2021_03_20_194616.jpg,179.0,222.5,0.2796875,0.6180555555555556,0.04375,0.08055555555555556
8706-2021_03_20_194616.jpg,bus,77,471,640,79,360,281,5,548,360,LTAdatasets/8706/annotate/8706-2021_03_20_194616.jpg,509.5,320.5,0.79609375,0.8902777777777777,0.1203125,0.21944444444444444
8706-2021_03_20_191014.jpg,car,22,205,640,23,360,176,1,227,199,LTAdatasets/8706/annotate/8706-2021_03_20_191014.jpg,216.0,187.5,0.3375,0.5208333333333334,0.034375,0.06388888888888888
8706-2021_03_20_191014.jpg,car,14,192,640,15,360,141,1,206,156,LTAdatasets/8706/annotate/8706-2021_03_20_191014.jpg,199.0,148.5,0.3109375,0.4125,0.021875,0.041666666666666664
8706-2021_03_20_191014.jpg,car,26,171,640,40,360,192,1,197,232,LTAdatasets/8706/annotate/8706-2021_03_20_191014.jpg,184.0,212.0,0.2875,0.5888888888888889,0.040625,0.1111111111111111
8706-2021_03_20_191014.jpg,bike,11,170,640,11,360,130,4,181,141,LTAdatasets/8706/annotate/8706-2021_03_20_191014.jpg,175.5,135.5,0.27421875,0.3763888888888889,0.0171875,0.030555555555555555
8706-2021_03_20_191014.jpg,van,12,161,640,21,360,144,3,173,165,LTAdatasets/8706/annotate/8706-2021_03_20_191014.jpg,167.0,154.5,0.2609375,0.42916666666666664,0.01875,0.058333333333333334
8706-2021_03_20_074618.jpg,van,89,276,640,61,360,299,3,365,360,LTAdatasets/8706/annotate/8706-2021_03_20_074618.jpg,320.5,329.5,0.50078125,0.9152777777777777,0.1390625,0.16944444444444445
8706-2021_03_20_074618.jpg,lorry_truck,28,422,640,34,360,210,2,450,244,LTAdatasets/8706/annotate/8706-2021_03_20_074618.jpg,436.0,227.0,0.68125,0.6305555555555555,0.04375,0.09444444444444444
8706-2021_03_20_074618.jpg,car,14,187,640,11,360,126,1,201,137,LTAdatasets/8706/annotate/8706-2021_03_20_074618.jpg,194.0,131.5,0.303125,0.36527777777777776,0.021875,0.030555555555555555
8706-2021_03_20_185153.jpg,bike,30,176,640,36,360,316,4,206,352,LTAdatasets/8706/annotate/8706-2021_03_20_185153.jpg,191.0,334.0,0.2984375,0.9277777777777778,0.046875,0.1
8706-2021_03_20_084601.jpg,van,20,408,640,25,360,193,3,428,218,LTAdatasets/8706/annotate/8706-2021_03_20_084601.jpg,418.0,205.5,0.653125,0.5708333333333333,0.03125,0.06944444444444445
8706-2021_03_20_202758.jpg,van,20,162,640,16,360,144,3,182,160,LTAdatasets/8706/annotate/8706-2021_03_20_202758.jpg,172.0,152.0,0.26875,0.4222222222222222,0.03125,0.044444444444444446
8706-2021_03_20_194315.jpg,lorry_truck,28,383,640,26,360,169,2,411,195,LTAdatasets/8706/annotate/8706-2021_03_20_194315.jpg,397.0,182.0,0.6203125,0.5055555555555555,0.04375,0.07222222222222222
8706-2021_03_20_183952.jpg,bike,20,446,640,23,360,288,4,466,311,LTAdatasets/8706/annotate/8706-2021_03_20_183952.jpg,456.0,299.5,0.7125,0.8319444444444445,0.03125,0.06388888888888888
8706-2021_03_20_183952.jpg,car,38,224,640,38,360,212,1,262,250,LTAdatasets/8706/annotate/8706-2021_03_20_183952.jpg,243.0,231.0,0.3796875,0.6416666666666667,0.059375,0.10555555555555556
8706-2021_03_20_183952.jpg,car,22,158,640,25,360,178,1,180,203,LTAdatasets/8706/annotate/8706-2021_03_20_183952.jpg,169.0,190.5,0.2640625,0.5291666666666667,0.034375,0.06944444444444445
8706-2021_03_20_183952.jpg,car,15,192,640,13,360,144,1,207,157,LTAdatasets/8706/annotate/8706-2021_03_20_183952.jpg,199.5,150.5,0.31171875,0.41805555555555557,0.0234375,0.03611111111111111
8706-2021_03_20_183952.jpg,car,11,189,640,10,360,124,1,200,134,LTAdatasets/8706/annotate/8706-2021_03_20_183952.jpg,194.5,129.0,0.30390625,0.35833333333333334,0.0171875,0.027777777777777776
8706-2021_03_20_183952.jpg,lorry_truck,19,155,640,25,360,136,2,174,161,LTAdatasets/8706/annotate/8706-2021_03_20_183952.jpg,164.5,148.5,0.25703125,0.4125,0.0296875,0.06944444444444445
8706-2021_03_20_075518.jpg,lorry_truck,50,463,640,67,360,260,2,513,327,LTAdatasets/8706/annotate/8706-2021_03_20_075518.jpg,488.0,293.5,0.7625,0.8152777777777778,0.078125,0.18611111111111112
8706-2021_03_20_075518.jpg,car,12,186,640,9,360,124,1,198,133,LTAdatasets/8706/annotate/8706-2021_03_20_075518.jpg,192.0,128.5,0.3,0.35694444444444445,0.01875,0.025
8706-2021_03_20_075518.jpg,bike,10,167,640,11,360,125,4,177,136,LTAdatasets/8706/annotate/8706-2021_03_20_075518.jpg,172.0,130.5,0.26875,0.3625,0.015625,0.030555555555555555
8706-2021_03_20_075518.jpg,car,10,194,640,9,360,108,1,204,117,LTAdatasets/8706/annotate/8706-2021_03_20_075518.jpg,199.0,112.5,0.3109375,0.3125,0.015625,0.025
8706-2021_03_20_092543.jpg,car,16,273,640,21,360,177,1,289,198,LTAdatasets/8706/annotate/8706-2021_03_20_092543.jpg,281.0,187.5,0.4390625,0.5208333333333334,0.025,0.058333333333333334
8706-2021_03_20_092543.jpg,car,8,256,640,17,360,151,1,264,168,LTAdatasets/8706/annotate/8706-2021_03_20_092543.jpg,260.0,159.5,0.40625,0.44305555555555554,0.0125,0.04722222222222222
8706-2021_03_20_092543.jpg,car,10,275,640,11,360,129,1,285,140,LTAdatasets/8706/annotate/8706-2021_03_20_092543.jpg,280.0,134.5,0.4375,0.3736111111111111,0.015625,0.030555555555555555
8706-2021_03_20_080939.jpg,car,31,172,640,38,360,214,1,203,252,LTAdatasets/8706/annotate/8706-2021_03_20_080939.jpg,187.5,233.0,0.29296875,0.6472222222222223,0.0484375,0.10555555555555556
8706-2021_03_20_080939.jpg,car,11,252,640,12,360,155,1,263,167,LTAdatasets/8706/annotate/8706-2021_03_20_080939.jpg,257.5,161.0,0.40234375,0.44722222222222224,0.0171875,0.03333333333333333
8706-2021_03_20_080939.jpg,van,11,270,640,19,360,144,3,281,163,LTAdatasets/8706/annotate/8706-2021_03_20_080939.jpg,275.5,153.5,0.43046875,0.4263888888888889,0.0171875,0.05277777777777778
8706-2021_03_20_080939.jpg,lorry_truck,10,248,640,13,360,135,2,258,148,LTAdatasets/8706/annotate/8706-2021_03_20_080939.jpg,253.0,141.5,0.3953125,0.39305555555555555,0.015625,0.03611111111111111
8706-2021_03_20_085141.jpg,lorry_truck,33,437,640,44,360,228,2,470,272,LTAdatasets/8706/annotate/8706-2021_03_20_085141.jpg,453.5,250.0,0.70859375,0.6944444444444444,0.0515625,0.12222222222222222
8706-2021_03_20_085141.jpg,bike,7,256,640,11,360,155,4,263,166,LTAdatasets/8706/annotate/8706-2021_03_20_085141.jpg,259.5,160.5,0.40546875,0.44583333333333336,0.0109375,0.030555555555555555
8706-2021_03_20_085141.jpg,lorry_truck,11,182,640,14,360,100,2,193,114,LTAdatasets/8706/annotate/8706-2021_03_20_085141.jpg,187.5,107.0,0.29296875,0.2972222222222222,0.0171875,0.03888888888888889
8706-2021_03_20_085501.jpg,lorry_truck,47,468,640,65,360,259,2,515,324,LTAdatasets/8706/annotate/8706-2021_03_20_085501.jpg,491.5,291.5,0.76796875,0.8097222222222222,0.0734375,0.18055555555555555
8706-2021_03_20_085501.jpg,lorry_truck,14,242,640,17,360,143,2,256,160,LTAdatasets/8706/annotate/8706-2021_03_20_085501.jpg,249.0,151.5,0.3890625,0.42083333333333334,0.021875,0.04722222222222222
8706-2021_03_20_085501.jpg,car,19,272,640,17,360,186,1,291,203,LTAdatasets/8706/annotate/8706-2021_03_20_085501.jpg,281.5,194.5,0.43984375,0.5402777777777777,0.0296875,0.04722222222222222
8706-2021_03_20_082220.jpg,car,16,271,640,14,360,135,1,287,149,LTAdatasets/8706/annotate/8706-2021_03_20_082220.jpg,279.0,142.0,0.4359375,0.39444444444444443,0.025,0.03888888888888889
8706-2021_03_20_082220.jpg,bike,11,172,640,13,360,112,4,183,125,LTAdatasets/8706/annotate/8706-2021_03_20_082220.jpg,177.5,118.5,0.27734375,0.32916666666666666,0.0171875,0.03611111111111111
8706-2021_03_20_200937.jpg,car,14,273,640,15,360,151,1,287,166,LTAdatasets/8706/annotate/8706-2021_03_20_200937.jpg,280.0,158.5,0.4375,0.44027777777777777,0.021875,0.041666666666666664
8706-2021_03_20_200937.jpg,van,12,182,640,11,360,102,3,194,113,LTAdatasets/8706/annotate/8706-2021_03_20_200937.jpg,188.0,107.5,0.29375,0.2986111111111111,0.01875,0.030555555555555555
8706-2021_03_20_182451.jpg,car,35,462,640,36,360,308,1,497,344,LTAdatasets/8706/annotate/8706-2021_03_20_182451.jpg,479.5,326.0,0.74921875,0.9055555555555556,0.0546875,0.1
8706-2021_03_20_182451.jpg,car,14,271,640,15,360,181,1,285,196,LTAdatasets/8706/annotate/8706-2021_03_20_182451.jpg,278.0,188.5,0.434375,0.5236111111111111,0.021875,0.041666666666666664
8706-2021_03_20_182451.jpg,van,16,186,640,13,360,130,3,202,143,LTAdatasets/8706/annotate/8706-2021_03_20_182451.jpg,194.0,136.5,0.303125,0.37916666666666665,0.025,0.03611111111111111
8706-2021_03_20_182451.jpg,lorry_truck,8,261,640,19,360,145,2,269,164,LTAdatasets/8706/annotate/8706-2021_03_20_182451.jpg,265.0,154.5,0.4140625,0.42916666666666664,0.0125,0.05277777777777778
8706-2021_03_20_182451.jpg,bike,9,172,640,13,360,122,4,181,135,LTAdatasets/8706/annotate/8706-2021_03_20_182451.jpg,176.5,128.5,0.27578125,0.35694444444444445,0.0140625,0.03611111111111111
8706-2021_03_20_180110.jpg,lorry_truck,22,159,640,32,360,135,2,181,167,LTAdatasets/8706/annotate/8706-2021_03_20_180110.jpg,170.0,151.0,0.265625,0.41944444444444445,0.034375,0.08888888888888889
8706-2021_03_20_180110.jpg,car,57,239,640,41,360,269,1,296,310,LTAdatasets/8706/annotate/8706-2021_03_20_180110.jpg,267.5,289.5,0.41796875,0.8041666666666667,0.0890625,0.11388888888888889
8706-2021_03_20_180110.jpg,lorry_truck,16,242,640,27,360,130,2,258,157,LTAdatasets/8706/annotate/8706-2021_03_20_180110.jpg,250.0,143.5,0.390625,0.39861111111111114,0.025,0.075
8706-2021_03_20_180110.jpg,car,11,171,640,8,360,115,1,182,123,LTAdatasets/8706/annotate/8706-2021_03_20_180110.jpg,176.5,119.0,0.27578125,0.33055555555555555,0.0171875,0.022222222222222223
8706-2021_03_20_180110.jpg,car,10,191,640,12,360,115,1,201,127,LTAdatasets/8706/annotate/8706-2021_03_20_180110.jpg,196.0,121.0,0.30625,0.33611111111111114,0.015625,0.03333333333333333
8706-2021_03_20_180110.jpg,lorry_truck,12,259,640,20,360,157,2,271,177,LTAdatasets/8706/annotate/8706-2021_03_20_180110.jpg,265.0,167.0,0.4140625,0.4638888888888889,0.01875,0.05555555555555555
8706-2021_03_20_091903.jpg,van,45,207,640,34,360,199,3,252,233,LTAdatasets/8706/annotate/8706-2021_03_20_091903.jpg,229.5,216.0,0.35859375,0.6,0.0703125,0.09444444444444444
8706-2021_03_20_100105.jpg,car,26,211,640,28,360,194,1,237,222,LTAdatasets/8706/annotate/8706-2021_03_20_100105.jpg,224.0,208.0,0.35,0.5777777777777777,0.040625,0.07777777777777778
8706-2021_03_20_100105.jpg,lorry_truck,16,185,640,24,360,124,2,201,148,LTAdatasets/8706/annotate/8706-2021_03_20_100105.jpg,193.0,136.0,0.3015625,0.37777777777777777,0.025,0.06666666666666667
8706-2021_03_20_074918.jpg,car,43,238,640,34,360,251,1,281,285,LTAdatasets/8706/annotate/8706-2021_03_20_074918.jpg,259.5,268.0,0.40546875,0.7444444444444445,0.0671875,0.09444444444444444
8706-2021_03_20_074918.jpg,bus,35,395,640,38,360,179,5,430,217,LTAdatasets/8706/annotate/8706-2021_03_20_074918.jpg,412.5,198.0,0.64453125,0.55,0.0546875,0.10555555555555556
8706-2021_03_20_181011.jpg,lorry_truck,26,452,640,34,360,249,2,478,283,LTAdatasets/8706/annotate/8706-2021_03_20_181011.jpg,465.0,266.0,0.7265625,0.7388888888888889,0.040625,0.09444444444444444
8706-2021_03_20_181011.jpg,car,45,236,640,36,360,232,1,281,268,LTAdatasets/8706/annotate/8706-2021_03_20_181011.jpg,258.5,250.0,0.40390625,0.6944444444444444,0.0703125,0.1
8706-2021_03_20_181011.jpg,car,18,200,640,21,360,162,1,218,183,LTAdatasets/8706/annotate/8706-2021_03_20_181011.jpg,209.0,172.5,0.3265625,0.4791666666666667,0.028125,0.058333333333333334
8706-2021_03_20_181011.jpg,car,13,185,640,10,360,129,1,198,139,LTAdatasets/8706/annotate/8706-2021_03_20_181011.jpg,191.5,134.0,0.29921875,0.37222222222222223,0.0203125,0.027777777777777776
8706-2021_03_20_181011.jpg,lorry_truck,18,241,640,22,360,149,2,259,171,LTAdatasets/8706/annotate/8706-2021_03_20_181011.jpg,250.0,160.0,0.390625,0.4444444444444444,0.028125,0.06111111111111111
8706-2021_03_20_195136.jpg,lorry_truck,25,204,640,25,360,179,2,229,204,LTAdatasets/8706/annotate/8706-2021_03_20_195136.jpg,216.5,191.5,0.33828125,0.5319444444444444,0.0390625,0.06944444444444445
8706-2021_03_20_195136.jpg,lorry_truck,18,159,640,15,360,131,2,177,146,LTAdatasets/8706/annotate/8706-2021_03_20_195136.jpg,168.0,138.5,0.2625,0.38472222222222224,0.028125,0.041666666666666664
8706-2021_03_20_195136.jpg,car,16,275,640,14,360,138,1,291,152,LTAdatasets/8706/annotate/8706-2021_03_20_195136.jpg,283.0,145.0,0.4421875,0.4027777777777778,0.025,0.03888888888888889
8706-2021_03_20_201317.jpg,van,37,464,640,44,360,270,3,501,314,LTAdatasets/8706/annotate/8706-2021_03_20_201317.jpg,482.5,292.0,0.75390625,0.8111111111111111,0.0578125,0.12222222222222222
8706-2021_03_20_201317.jpg,car,16,186,640,12,360,139,1,202,151,LTAdatasets/8706/annotate/8706-2021_03_20_201317.jpg,194.0,145.0,0.303125,0.4027777777777778,0.025,0.03333333333333333
8706-2021_03_20_181551.jpg,lorry_truck,26,152,640,33,360,125,2,178,158,LTAdatasets/8706/annotate/8706-2021_03_20_181551.jpg,165.0,141.5,0.2578125,0.39305555555555555,0.040625,0.09166666666666666
8706-2021_03_20_082740.jpg,van,36,167,640,41,360,229,3,203,270,LTAdatasets/8706/annotate/8706-2021_03_20_082740.jpg,185.0,249.5,0.2890625,0.6930555555555555,0.05625,0.11388888888888889
8706-2021_03_20_082740.jpg,car,17,269,640,14,360,188,1,286,202,LTAdatasets/8706/annotate/8706-2021_03_20_082740.jpg,277.5,195.0,0.43359375,0.5416666666666666,0.0265625,0.03888888888888889
8706-2021_03_20_195736.jpg,bike,12,163,640,10,360,126,4,175,136,LTAdatasets/8706/annotate/8706-2021_03_20_195736.jpg,169.0,131.0,0.2640625,0.3638888888888889,0.01875,0.027777777777777776
8706-2021_03_20_195736.jpg,car,12,260,640,14,360,137,1,272,151,LTAdatasets/8706/annotate/8706-2021_03_20_195736.jpg,266.0,144.0,0.415625,0.4,0.01875,0.03888888888888889
8706-2021_03_20_083120.jpg,car,44,245,640,44,360,247,1,289,291,LTAdatasets/8706/annotate/8706-2021_03_20_083120.jpg,267.0,269.0,0.4171875,0.7472222222222222,0.06875,0.12222222222222222
8706-2021_03_20_083120.jpg,lorry_truck,19,159,640,23,360,118,2,178,141,LTAdatasets/8706/annotate/8706-2021_03_20_083120.jpg,168.5,129.5,0.26328125,0.3597222222222222,0.0296875,0.06388888888888888
8706-2021_03_20_083120.jpg,van,12,241,640,11,360,156,3,253,167,LTAdatasets/8706/annotate/8706-2021_03_20_083120.jpg,247.0,161.5,0.3859375,0.4486111111111111,0.01875,0.030555555555555555
8706-2021_03_20_193115.jpg,car,21,193,640,17,360,159,1,214,176,LTAdatasets/8706/annotate/8706-2021_03_20_193115.jpg,203.5,167.5,0.31796875,0.4652777777777778,0.0328125,0.04722222222222222
8706-2021_03_20_193115.jpg,bike,8,167,640,17,360,134,4,175,151,LTAdatasets/8706/annotate/8706-2021_03_20_193115.jpg,171.0,142.5,0.2671875,0.3958333333333333,0.0125,0.04722222222222222
8706-2021_03_20_193115.jpg,car,12,276,640,9,360,164,1,288,173,LTAdatasets/8706/annotate/8706-2021_03_20_193115.jpg,282.0,168.5,0.440625,0.46805555555555556,0.01875,0.025
8706-2021_03_20_091002.jpg,car,15,166,640,8,360,122,1,181,130,LTAdatasets/8706/annotate/8706-2021_03_20_091002.jpg,173.5,126.0,0.27109375,0.35,0.0234375,0.022222222222222223
8706-2021_03_20_091002.jpg,car,12,190,640,7,360,109,1,202,116,LTAdatasets/8706/annotate/8706-2021_03_20_091002.jpg,196.0,112.5,0.30625,0.3125,0.01875,0.019444444444444445
2705-2021_03_20_191234.jpg,car,50,500,640,30,360,95,1,550,125,LTAdatasets/2705/annotate/2705-2021_03_20_191234.jpg,525.0,110.0,0.8203125,0.3055555555555556,0.078125,0.08333333333333333
2705-2021_03_20_191234.jpg,bike,19,411,640,20,360,71,4,430,91,LTAdatasets/2705/annotate/2705-2021_03_20_191234.jpg,420.5,81.0,0.65703125,0.225,0.0296875,0.05555555555555555
2705-2021_03_20_191234.jpg,car,28,371,640,12,360,59,1,399,71,LTAdatasets/2705/annotate/2705-2021_03_20_191234.jpg,385.0,65.0,0.6015625,0.18055555555555555,0.04375,0.03333333333333333
2705-2021_03_20_191234.jpg,car,18,233,640,10,360,58,1,251,68,LTAdatasets/2705/annotate/2705-2021_03_20_191234.jpg,242.0,63.0,0.378125,0.175,0.028125,0.027777777777777776
2705-2021_03_20_191234.jpg,car,16,218,640,9,360,72,1,234,81,LTAdatasets/2705/annotate/2705-2021_03_20_191234.jpg,226.0,76.5,0.353125,0.2125,0.025,0.025
2705-2021_03_20_191234.jpg,car,22,257,640,14,360,79,1,279,93,LTAdatasets/2705/annotate/2705-2021_03_20_191234.jpg,268.0,86.0,0.41875,0.2388888888888889,0.034375,0.03888888888888889
2705-2021_03_20_191234.jpg,lorry_truck,38,211,640,44,360,131,2,249,175,LTAdatasets/2705/annotate/2705-2021_03_20_191234.jpg,230.0,153.0,0.359375,0.425,0.059375,0.12222222222222222
2705-2021_03_20_191234.jpg,lorry_truck,28,191,640,31,360,84,2,219,115,LTAdatasets/2705/annotate/2705-2021_03_20_191234.jpg,205.0,99.5,0.3203125,0.2763888888888889,0.04375,0.08611111111111111
2705-2021_03_20_191234.jpg,lorry_truck,15,229,640,17,360,81,2,244,98,LTAdatasets/2705/annotate/2705-2021_03_20_191234.jpg,236.5,89.5,0.36953125,0.24861111111111112,0.0234375,0.04722222222222222
2705-2021_03_20_075518.jpg,car,32,449,640,25,360,92,1,481,117,LTAdatasets/2705/annotate/2705-2021_03_20_075518.jpg,465.0,104.5,0.7265625,0.2902777777777778,0.05,0.06944444444444445
2705-2021_03_20_075518.jpg,car,16,225,640,18,360,73,1,241,91,LTAdatasets/2705/annotate/2705-2021_03_20_075518.jpg,233.0,82.0,0.3640625,0.22777777777777777,0.025,0.05
2705-2021_03_20_075518.jpg,car,41,301,640,30,360,113,1,342,143,LTAdatasets/2705/annotate/2705-2021_03_20_075518.jpg,321.5,128.0,0.50234375,0.35555555555555557,0.0640625,0.08333333333333333
2705-2021_03_20_075518.jpg,car,90,476,640,65,360,270,1,566,335,LTAdatasets/2705/annotate/2705-2021_03_20_075518.jpg,521.0,302.5,0.8140625,0.8402777777777778,0.140625,0.18055555555555555
2705-2021_03_20_075518.jpg,car,20,195,640,16,360,73,1,215,89,LTAdatasets/2705/annotate/2705-2021_03_20_075518.jpg,205.0,81.0,0.3203125,0.225,0.03125,0.044444444444444446
2705-2021_03_20_075518.jpg,car,15,190,640,9,360,62,1,205,71,LTAdatasets/2705/annotate/2705-2021_03_20_075518.jpg,197.5,66.5,0.30859375,0.18472222222222223,0.0234375,0.025
2705-2021_03_20_193635.jpg,car,25,261,640,17,360,81,1,286,98,LTAdatasets/2705/annotate/2705-2021_03_20_193635.jpg,273.5,89.5,0.42734375,0.24861111111111112,0.0390625,0.04722222222222222
2705-2021_03_20_193635.jpg,car,26,215,640,14,360,64,1,241,78,LTAdatasets/2705/annotate/2705-2021_03_20_193635.jpg,228.0,71.0,0.35625,0.19722222222222222,0.040625,0.03888888888888889
2705-2021_03_20_193635.jpg,bike,12,408,640,21,360,73,4,420,94,LTAdatasets/2705/annotate/2705-2021_03_20_193635.jpg,414.0,83.5,0.646875,0.23194444444444445,0.01875,0.058333333333333334
2705-2021_03_20_193635.jpg,bike,15,374,640,15,360,77,4,389,92,LTAdatasets/2705/annotate/2705-2021_03_20_193635.jpg,381.5,84.5,0.59609375,0.23472222222222222,0.0234375,0.041666666666666664
2705-2021_03_20_193635.jpg,car,103,379,640,80,360,277,1,482,357,LTAdatasets/2705/annotate/2705-2021_03_20_193635.jpg,430.5,317.0,0.67265625,0.8805555555555555,0.1609375,0.2222222222222222
2705-2021_03_20_193635.jpg,lorry_truck,56,192,640,59,360,103,2,248,162,LTAdatasets/2705/annotate/2705-2021_03_20_193635.jpg,220.0,132.5,0.34375,0.3680555555555556,0.0875,0.1638888888888889
2705-2021_03_20_184613.jpg,car,55,285,640,33,360,176,1,340,209,LTAdatasets/2705/annotate/2705-2021_03_20_184613.jpg,312.5,192.5,0.48828125,0.5347222222222222,0.0859375,0.09166666666666666
2705-2021_03_20_184613.jpg,car,57,358,640,36,360,155,1,415,191,LTAdatasets/2705/annotate/2705-2021_03_20_184613.jpg,386.5,173.0,0.60390625,0.48055555555555557,0.0890625,0.1
2705-2021_03_20_184613.jpg,car,37,290,640,24,360,111,1,327,135,LTAdatasets/2705/annotate/2705-2021_03_20_184613.jpg,308.5,123.0,0.48203125,0.3416666666666667,0.0578125,0.06666666666666667
2705-2021_03_20_184613.jpg,bike,10,215,640,15,360,83,4,225,98,LTAdatasets/2705/annotate/2705-2021_03_20_184613.jpg,220.0,90.5,0.34375,0.2513888888888889,0.015625,0.041666666666666664
2705-2021_03_20_184613.jpg,lorry_truck,28,407,640,26,360,62,2,435,88,LTAdatasets/2705/annotate/2705-2021_03_20_184613.jpg,421.0,75.0,0.6578125,0.20833333333333334,0.04375,0.07222222222222222
2705-2021_03_20_184613.jpg,bus,154,255,640,71,360,289,5,409,360,LTAdatasets/2705/annotate/2705-2021_03_20_184613.jpg,332.0,324.5,0.51875,0.9013888888888889,0.240625,0.19722222222222222
2705-2021_03_20_185153.jpg,car,63,402,640,48,360,202,1,465,250,LTAdatasets/2705/annotate/2705-2021_03_20_185153.jpg,433.5,226.0,0.67734375,0.6277777777777778,0.0984375,0.13333333333333333
2705-2021_03_20_185153.jpg,car,22,223,640,16,360,73,1,245,89,LTAdatasets/2705/annotate/2705-2021_03_20_185153.jpg,234.0,81.0,0.365625,0.225,0.034375,0.044444444444444446
2705-2021_03_20_185153.jpg,car,11,211,640,10,360,58,1,222,68,LTAdatasets/2705/annotate/2705-2021_03_20_185153.jpg,216.5,63.0,0.33828125,0.175,0.0171875,0.027777777777777776
2705-2021_03_20_185153.jpg,car,25,243,640,19,360,101,1,268,120,LTAdatasets/2705/annotate/2705-2021_03_20_185153.jpg,255.5,110.5,0.39921875,0.30694444444444446,0.0390625,0.05277777777777778
2705-2021_03_20_185153.jpg,bike,9,237,640,11,360,58,4,246,69,LTAdatasets/2705/annotate/2705-2021_03_20_185153.jpg,241.5,63.5,0.37734375,0.1763888888888889,0.0140625,0.030555555555555555
2705-2021_03_20_185153.jpg,lorry_truck,21,187,640,24,360,71,2,208,95,LTAdatasets/2705/annotate/2705-2021_03_20_185153.jpg,197.5,83.0,0.30859375,0.23055555555555557,0.0328125,0.06666666666666667
2705-2021_03_20_185153.jpg,lorry_truck,71,192,640,99,360,110,2,263,209,LTAdatasets/2705/annotate/2705-2021_03_20_185153.jpg,227.5,159.5,0.35546875,0.44305555555555554,0.1109375,0.275
2705-2021_03_20_181851.jpg,car,57,321,640,47,360,213,1,378,260,LTAdatasets/2705/annotate/2705-2021_03_20_181851.jpg,349.5,236.5,0.54609375,0.6569444444444444,0.0890625,0.13055555555555556
2705-2021_03_20_181851.jpg,bike,20,489,640,25,360,98,4,509,123,LTAdatasets/2705/annotate/2705-2021_03_20_181851.jpg,499.0,110.5,0.7796875,0.30694444444444446,0.03125,0.06944444444444445
2705-2021_03_20_181851.jpg,bike,18,397,640,16,360,79,4,415,95,LTAdatasets/2705/annotate/2705-2021_03_20_181851.jpg,406.0,87.0,0.634375,0.24166666666666667,0.028125,0.044444444444444446
2705-2021_03_20_181851.jpg,car,31,247,640,20,360,110,1,278,130,LTAdatasets/2705/annotate/2705-2021_03_20_181851.jpg,262.5,120.0,0.41015625,0.3333333333333333,0.0484375,0.05555555555555555
2705-2021_03_20_181851.jpg,car,25,268,640,15,360,87,1,293,102,LTAdatasets/2705/annotate/2705-2021_03_20_181851.jpg,280.5,94.5,0.43828125,0.2625,0.0390625,0.041666666666666664
2705-2021_03_20_181851.jpg,car,15,367,640,18,360,78,1,382,96,LTAdatasets/2705/annotate/2705-2021_03_20_181851.jpg,374.5,87.0,0.58515625,0.24166666666666667,0.0234375,0.05
2705-2021_03_20_181851.jpg,van,24,375,640,16,360,68,3,399,84,LTAdatasets/2705/annotate/2705-2021_03_20_181851.jpg,387.0,76.0,0.6046875,0.2111111111111111,0.0375,0.044444444444444446
2705-2021_03_20_181851.jpg,lorry_truck,20,222,640,18,360,70,2,242,88,LTAdatasets/2705/annotate/2705-2021_03_20_181851.jpg,232.0,79.0,0.3625,0.21944444444444444,0.03125,0.05
2705-2021_03_20_082740.jpg,car,84,417,640,35,360,325,1,501,360,LTAdatasets/2705/annotate/2705-2021_03_20_082740.jpg,459.0,342.5,0.7171875,0.9513888888888888,0.13125,0.09722222222222222
2705-2021_03_20_202437.jpg,car,73,348,640,74,360,237,1,421,311,LTAdatasets/2705/annotate/2705-2021_03_20_202437.jpg,384.5,274.0,0.60078125,0.7611111111111111,0.1140625,0.20555555555555555
2705-2021_03_20_185453.jpg,car,54,534,640,35,360,149,1,588,184,LTAdatasets/2705/annotate/2705-2021_03_20_185453.jpg,561.0,166.5,0.8765625,0.4625,0.084375,0.09722222222222222
2705-2021_03_20_185453.jpg,car,36,455,640,26,360,78,1,491,104,LTAdatasets/2705/annotate/2705-2021_03_20_185453.jpg,473.0,91.0,0.7390625,0.25277777777777777,0.05625,0.07222222222222222
2705-2021_03_20_185453.jpg,car,56,401,640,45,360,190,1,457,235,LTAdatasets/2705/annotate/2705-2021_03_20_185453.jpg,429.0,212.5,0.6703125,0.5902777777777778,0.0875,0.125
2705-2021_03_20_185453.jpg,car,62,234,640,65,360,255,1,296,320,LTAdatasets/2705/annotate/2705-2021_03_20_185453.jpg,265.0,287.5,0.4140625,0.7986111111111112,0.096875,0.18055555555555555
2705-2021_03_20_185453.jpg,car,35,265,640,21,360,137,1,300,158,LTAdatasets/2705/annotate/2705-2021_03_20_185453.jpg,282.5,147.5,0.44140625,0.4097222222222222,0.0546875,0.058333333333333334
2705-2021_03_20_185453.jpg,car,25,286,640,18,360,100,1,311,118,LTAdatasets/2705/annotate/2705-2021_03_20_185453.jpg,298.5,109.0,0.46640625,0.30277777777777776,0.0390625,0.05
2705-2021_03_20_185453.jpg,car,22,243,640,21,360,96,1,265,117,LTAdatasets/2705/annotate/2705-2021_03_20_185453.jpg,254.0,106.5,0.396875,0.29583333333333334,0.034375,0.058333333333333334
2705-2021_03_20_185453.jpg,car,16,196,640,10,360,80,1,212,90,LTAdatasets/2705/annotate/2705-2021_03_20_185453.jpg,204.0,85.0,0.31875,0.2361111111111111,0.025,0.027777777777777776
2705-2021_03_20_185453.jpg,car,19,246,640,11,360,69,1,265,80,LTAdatasets/2705/annotate/2705-2021_03_20_185453.jpg,255.5,74.5,0.39921875,0.20694444444444443,0.0296875,0.030555555555555555
2705-2021_03_20_185453.jpg,car,14,217,640,12,360,62,1,231,74,LTAdatasets/2705/annotate/2705-2021_03_20_185453.jpg,224.0,68.0,0.35,0.18888888888888888,0.021875,0.03333333333333333
2705-2021_03_20_185453.jpg,lorry_truck,55,509,640,32,360,108,2,564,140,LTAdatasets/2705/annotate/2705-2021_03_20_185453.jpg,536.5,124.0,0.83828125,0.34444444444444444,0.0859375,0.08888888888888889
2705-2021_03_20_192214.jpg,car,36,285,640,26,360,150,1,321,176,LTAdatasets/2705/annotate/2705-2021_03_20_192214.jpg,303.0,163.0,0.4734375,0.4527777777777778,0.05625,0.07222222222222222
2705-2021_03_20_192214.jpg,car,32,511,640,29,360,98,1,543,127,LTAdatasets/2705/annotate/2705-2021_03_20_192214.jpg,527.0,112.5,0.8234375,0.3125,0.05,0.08055555555555556
2705-2021_03_20_192214.jpg,car,15,227,640,17,360,78,1,242,95,LTAdatasets/2705/annotate/2705-2021_03_20_192214.jpg,234.5,86.5,0.36640625,0.24027777777777778,0.0234375,0.04722222222222222
2705-2021_03_20_192214.jpg,car,18,192,640,13,360,85,1,210,98,LTAdatasets/2705/annotate/2705-2021_03_20_192214.jpg,201.0,91.5,0.3140625,0.25416666666666665,0.028125,0.03611111111111111
2705-2021_03_20_192214.jpg,car,16,225,640,9,360,53,1,241,62,LTAdatasets/2705/annotate/2705-2021_03_20_192214.jpg,233.0,57.5,0.3640625,0.1597222222222222,0.025,0.025
2705-2021_03_20_090402.jpg,lorry_truck,73,261,640,89,360,250,2,334,339,LTAdatasets/2705/annotate/2705-2021_03_20_090402.jpg,297.5,294.5,0.46484375,0.8180555555555555,0.1140625,0.24722222222222223
2705-2021_03_20_090402.jpg,lorry_truck,31,205,640,34,360,96,2,236,130,LTAdatasets/2705/annotate/2705-2021_03_20_090402.jpg,220.5,113.0,0.34453125,0.3138888888888889,0.0484375,0.09444444444444444
2705-2021_03_20_090402.jpg,lorry_truck,26,189,640,23,360,71,2,215,94,LTAdatasets/2705/annotate/2705-2021_03_20_090402.jpg,202.0,82.5,0.315625,0.22916666666666666,0.040625,0.06388888888888888
2705-2021_03_20_090402.jpg,van,29,450,640,24,360,72,3,479,96,LTAdatasets/2705/annotate/2705-2021_03_20_090402.jpg,464.5,84.0,0.72578125,0.23333333333333334,0.0453125,0.06666666666666667
2705-2021_03_20_090402.jpg,car,56,369,640,37,360,166,1,425,203,LTAdatasets/2705/annotate/2705-2021_03_20_090402.jpg,397.0,184.5,0.6203125,0.5125,0.0875,0.10277777777777777
2705-2021_03_20_090402.jpg,car,32,303,640,23,360,113,1,335,136,LTAdatasets/2705/annotate/2705-2021_03_20_090402.jpg,319.0,124.5,0.4984375,0.3458333333333333,0.05,0.06388888888888888
2705-2021_03_20_090402.jpg,car,16,252,640,15,360,69,1,268,84,LTAdatasets/2705/annotate/2705-2021_03_20_090402.jpg,260.0,76.5,0.40625,0.2125,0.025,0.041666666666666664
2705-2021_03_20_090402.jpg,car,11,224,640,16,360,72,1,235,88,LTAdatasets/2705/annotate/2705-2021_03_20_090402.jpg,229.5,80.0,0.35859375,0.2222222222222222,0.0171875,0.044444444444444446
2705-2021_03_20_090402.jpg,bike,8,225,640,9,360,55,4,233,64,LTAdatasets/2705/annotate/2705-2021_03_20_090402.jpg,229.0,59.5,0.3578125,0.16527777777777777,0.0125,0.025
2705-2021_03_20_090402.jpg,bike,7,217,640,15,360,61,4,224,76,LTAdatasets/2705/annotate/2705-2021_03_20_090402.jpg,220.5,68.5,0.34453125,0.19027777777777777,0.0109375,0.041666666666666664
2705-2021_03_20_090402.jpg,car,10,210,640,9,360,55,1,220,64,LTAdatasets/2705/annotate/2705-2021_03_20_090402.jpg,215.0,59.5,0.3359375,0.16527777777777777,0.015625,0.025
2705-2021_03_20_202758.jpg,car,48,461,640,24,360,122,1,509,146,LTAdatasets/2705/annotate/2705-2021_03_20_202758.jpg,485.0,134.0,0.7578125,0.37222222222222223,0.075,0.06666666666666667
2705-2021_03_20_202758.jpg,car,38,466,640,21,360,99,1,504,120,LTAdatasets/2705/annotate/2705-2021_03_20_202758.jpg,485.0,109.5,0.7578125,0.30416666666666664,0.059375,0.058333333333333334
2705-2021_03_20_202758.jpg,car,26,385,640,15,360,64,1,411,79,LTAdatasets/2705/annotate/2705-2021_03_20_202758.jpg,398.0,71.5,0.621875,0.1986111111111111,0.040625,0.041666666666666664
2705-2021_03_20_202758.jpg,lorry_truck,49,468,640,28,360,72,2,517,100,LTAdatasets/2705/annotate/2705-2021_03_20_202758.jpg,492.5,86.0,0.76953125,0.2388888888888889,0.0765625,0.07777777777777778
2705-2021_03_20_202758.jpg,bike,10,211,640,20,360,92,4,221,112,LTAdatasets/2705/annotate/2705-2021_03_20_202758.jpg,216.0,102.0,0.3375,0.2833333333333333,0.015625,0.05555555555555555
2705-2021_03_20_202758.jpg,lorry_truck,25,229,640,24,360,77,2,254,101,LTAdatasets/2705/annotate/2705-2021_03_20_202758.jpg,241.5,89.0,0.37734375,0.24722222222222223,0.0390625,0.06666666666666667
2705-2021_03_20_202758.jpg,car,14,207,640,7,360,52,1,221,59,LTAdatasets/2705/annotate/2705-2021_03_20_202758.jpg,214.0,55.5,0.334375,0.15416666666666667,0.021875,0.019444444444444445
2705-2021_03_20_081539.jpg,van,75,336,640,63,360,233,3,411,296,LTAdatasets/2705/annotate/2705-2021_03_20_081539.jpg,373.5,264.5,0.58359375,0.7347222222222223,0.1171875,0.175
2705-2021_03_20_081539.jpg,van,23,390,640,21,360,58,3,413,79,LTAdatasets/2705/annotate/2705-2021_03_20_081539.jpg,401.5,68.5,0.62734375,0.19027777777777777,0.0359375,0.058333333333333334
2705-2021_03_20_081539.jpg,car,28,374,640,12,360,85,1,402,97,LTAdatasets/2705/annotate/2705-2021_03_20_081539.jpg,388.0,91.0,0.60625,0.25277777777777777,0.04375,0.03333333333333333
2705-2021_03_20_081539.jpg,car,21,235,640,18,360,84,1,256,102,LTAdatasets/2705/annotate/2705-2021_03_20_081539.jpg,245.5,93.0,0.38359375,0.25833333333333336,0.0328125,0.05
2705-2021_03_20_081539.jpg,car,12,238,640,11,360,60,1,250,71,LTAdatasets/2705/annotate/2705-2021_03_20_081539.jpg,244.0,65.5,0.38125,0.18194444444444444,0.01875,0.030555555555555555
2705-2021_03_20_081539.jpg,car,12,210,640,9,360,59,1,222,68,LTAdatasets/2705/annotate/2705-2021_03_20_081539.jpg,216.0,63.5,0.3375,0.1763888888888889,0.01875,0.025
2705-2021_03_20_081539.jpg,lorry_truck,25,186,640,25,360,59,2,211,84,LTAdatasets/2705/annotate/2705-2021_03_20_081539.jpg,198.5,71.5,0.31015625,0.1986111111111111,0.0390625,0.06944444444444445
2705-2021_03_20_081539.jpg,lorry_truck,17,189,640,13,360,45,2,206,58,LTAdatasets/2705/annotate/2705-2021_03_20_081539.jpg,197.5,51.5,0.30859375,0.14305555555555555,0.0265625,0.03611111111111111
2705-2021_03_20_194315.jpg,car,29,399,640,17,360,78,1,428,95,LTAdatasets/2705/annotate/2705-2021_03_20_194315.jpg,413.5,86.5,0.64609375,0.24027777777777778,0.0453125,0.04722222222222222
2705-2021_03_20_194315.jpg,car,24,433,640,21,360,74,1,457,95,LTAdatasets/2705/annotate/2705-2021_03_20_194315.jpg,445.0,84.5,0.6953125,0.23472222222222222,0.0375,0.058333333333333334
2705-2021_03_20_194315.jpg,car,34,288,640,33,360,138,1,322,171,LTAdatasets/2705/annotate/2705-2021_03_20_194315.jpg,305.0,154.5,0.4765625,0.42916666666666664,0.053125,0.09166666666666666
2705-2021_03_20_194315.jpg,car,37,215,640,35,360,165,1,252,200,LTAdatasets/2705/annotate/2705-2021_03_20_194315.jpg,233.5,182.5,0.36484375,0.5069444444444444,0.0578125,0.09722222222222222
2705-2021_03_20_194315.jpg,bike,11,203,640,15,360,82,4,214,97,LTAdatasets/2705/annotate/2705-2021_03_20_194315.jpg,208.5,89.5,0.32578125,0.24861111111111112,0.0171875,0.041666666666666664
2705-2021_03_20_194315.jpg,bike,12,235,640,19,360,73,4,247,92,LTAdatasets/2705/annotate/2705-2021_03_20_194315.jpg,241.0,82.5,0.3765625,0.22916666666666666,0.01875,0.05277777777777778
2705-2021_03_20_194315.jpg,van,12,219,640,20,360,64,3,231,84,LTAdatasets/2705/annotate/2705-2021_03_20_194315.jpg,225.0,74.0,0.3515625,0.20555555555555555,0.01875,0.05555555555555555
2705-2021_03_20_201317.jpg,car,39,255,640,22,360,121,1,294,143,LTAdatasets/2705/annotate/2705-2021_03_20_201317.jpg,274.5,132.0,0.42890625,0.36666666666666664,0.0609375,0.06111111111111111
2705-2021_03_20_201317.jpg,car,56,303,640,40,360,177,1,359,217,LTAdatasets/2705/annotate/2705-2021_03_20_201317.jpg,331.0,197.0,0.5171875,0.5472222222222223,0.0875,0.1111111111111111
2705-2021_03_20_201317.jpg,car,24,381,640,25,360,75,1,405,100,LTAdatasets/2705/annotate/2705-2021_03_20_201317.jpg,393.0,87.5,0.6140625,0.24305555555555555,0.0375,0.06944444444444445
2705-2021_03_20_201317.jpg,car,26,404,640,21,360,75,1,430,96,LTAdatasets/2705/annotate/2705-2021_03_20_201317.jpg,417.0,85.5,0.6515625,0.2375,0.040625,0.058333333333333334
2705-2021_03_20_180110.jpg,car,43,503,640,42,360,126,1,546,168,LTAdatasets/2705/annotate/2705-2021_03_20_180110.jpg,524.5,147.0,0.81953125,0.4083333333333333,0.0671875,0.11666666666666667
2705-2021_03_20_180110.jpg,car,29,291,640,23,360,96,1,320,119,LTAdatasets/2705/annotate/2705-2021_03_20_180110.jpg,305.5,107.5,0.47734375,0.2986111111111111,0.0453125,0.06388888888888888
2705-2021_03_20_180110.jpg,car,28,238,640,16,360,99,1,266,115,LTAdatasets/2705/annotate/2705-2021_03_20_180110.jpg,252.0,107.0,0.39375,0.2972222222222222,0.04375,0.044444444444444446
2705-2021_03_20_180110.jpg,van,15,192,640,14,360,62,3,207,76,LTAdatasets/2705/annotate/2705-2021_03_20_180110.jpg,199.5,69.0,0.31171875,0.19166666666666668,0.0234375,0.03888888888888889
2705-2021_03_20_180110.jpg,van,32,406,640,25,360,69,3,438,94,LTAdatasets/2705/annotate/2705-2021_03_20_180110.jpg,422.0,81.5,0.659375,0.2263888888888889,0.05,0.06944444444444445
2705-2021_03_20_180110.jpg,car,14,227,640,6,360,52,1,241,58,LTAdatasets/2705/annotate/2705-2021_03_20_180110.jpg,234.0,55.0,0.365625,0.1527777777777778,0.021875,0.016666666666666666
2705-2021_03_20_180110.jpg,lorry_truck,20,188,640,13,360,51,2,208,64,LTAdatasets/2705/annotate/2705-2021_03_20_180110.jpg,198.0,57.5,0.309375,0.1597222222222222,0.03125,0.03611111111111111
2705-2021_03_20_191014.jpg,car,26,224,640,17,360,83,1,250,100,LTAdatasets/2705/annotate/2705-2021_03_20_191014.jpg,237.0,91.5,0.3703125,0.25416666666666665,0.040625,0.04722222222222222
2705-2021_03_20_191014.jpg,car,30,263,640,16,360,102,1,293,118,LTAdatasets/2705/annotate/2705-2021_03_20_191014.jpg,278.0,110.0,0.434375,0.3055555555555556,0.046875,0.044444444444444446
2705-2021_03_20_191014.jpg,car,16,248,640,11,360,67,1,264,78,LTAdatasets/2705/annotate/2705-2021_03_20_191014.jpg,256.0,72.5,0.4,0.2013888888888889,0.025,0.030555555555555555
2705-2021_03_20_191014.jpg,car,46,456,640,25,360,119,1,502,144,LTAdatasets/2705/annotate/2705-2021_03_20_191014.jpg,479.0,131.5,0.7484375,0.36527777777777776,0.071875,0.06944444444444445
2705-2021_03_20_191014.jpg,car,10,206,640,9,360,47,1,216,56,LTAdatasets/2705/annotate/2705-2021_03_20_191014.jpg,211.0,51.5,0.3296875,0.14305555555555555,0.015625,0.025
2705-2021_03_20_074618.jpg,car,39,470,640,28,360,95,1,509,123,LTAdatasets/2705/annotate/2705-2021_03_20_074618.jpg,489.5,109.0,0.76484375,0.30277777777777776,0.0609375,0.07777777777777778
2705-2021_03_20_074618.jpg,car,49,549,640,36,360,152,1,598,188,LTAdatasets/2705/annotate/2705-2021_03_20_074618.jpg,573.5,170.0,0.89609375,0.4722222222222222,0.0765625,0.1
2705-2021_03_20_074618.jpg,car,27,363,640,19,360,78,1,390,97,LTAdatasets/2705/annotate/2705-2021_03_20_074618.jpg,376.5,87.5,0.58828125,0.24305555555555555,0.0421875,0.05277777777777778
2705-2021_03_20_074618.jpg,car,22,284,640,27,360,96,1,306,123,LTAdatasets/2705/annotate/2705-2021_03_20_074618.jpg,295.0,109.5,0.4609375,0.30416666666666664,0.034375,0.075
2705-2021_03_20_074618.jpg,car,12,229,640,9,360,54,1,241,63,LTAdatasets/2705/annotate/2705-2021_03_20_074618.jpg,235.0,58.5,0.3671875,0.1625,0.01875,0.025
2705-2021_03_20_074618.jpg,van,10,192,640,11,360,52,3,202,63,LTAdatasets/2705/annotate/2705-2021_03_20_074618.jpg,197.0,57.5,0.3078125,0.1597222222222222,0.015625,0.030555555555555555
2705-2021_03_20_194916.jpg,lorry_truck,34,234,640,38,360,84,2,268,122,LTAdatasets/2705/annotate/2705-2021_03_20_194916.jpg,251.0,103.0,0.3921875,0.2861111111111111,0.053125,0.10555555555555556
2705-2021_03_20_194916.jpg,bus,34,189,640,31,360,79,5,223,110,LTAdatasets/2705/annotate/2705-2021_03_20_194916.jpg,206.0,94.5,0.321875,0.2625,0.053125,0.08611111111111111
2705-2021_03_20_194916.jpg,lorry_truck,20,188,640,19,360,48,2,208,67,LTAdatasets/2705/annotate/2705-2021_03_20_194916.jpg,198.0,57.5,0.309375,0.1597222222222222,0.03125,0.05277777777777778
2705-2021_03_20_204018.jpg,lorry_truck,42,505,640,33,360,89,2,547,122,LTAdatasets/2705/annotate/2705-2021_03_20_204018.jpg,526.0,105.5,0.821875,0.29305555555555557,0.065625,0.09166666666666666
2705-2021_03_20_204018.jpg,car,36,477,640,17,360,85,1,513,102,LTAdatasets/2705/annotate/2705-2021_03_20_204018.jpg,495.0,93.5,0.7734375,0.25972222222222224,0.05625,0.04722222222222222
2705-2021_03_20_204018.jpg,car,32,409,640,22,360,79,1,441,101,LTAdatasets/2705/annotate/2705-2021_03_20_204018.jpg,425.0,90.0,0.6640625,0.25,0.05,0.06111111111111111
2705-2021_03_20_204018.jpg,car,41,445,640,34,360,107,1,486,141,LTAdatasets/2705/annotate/2705-2021_03_20_204018.jpg,465.5,124.0,0.72734375,0.34444444444444444,0.0640625,0.09444444444444444
2705-2021_03_20_204018.jpg,car,37,283,640,29,360,148,1,320,177,LTAdatasets/2705/annotate/2705-2021_03_20_204018.jpg,301.5,162.5,0.47109375,0.4513888888888889,0.0578125,0.08055555555555556
2705-2021_03_20_204018.jpg,car,19,222,640,16,360,72,1,241,88,LTAdatasets/2705/annotate/2705-2021_03_20_204018.jpg,231.5,80.0,0.36171875,0.2222222222222222,0.0296875,0.044444444444444446
2705-2021_03_20_204018.jpg,car,17,210,640,7,360,60,1,227,67,LTAdatasets/2705/annotate/2705-2021_03_20_204018.jpg,218.5,63.5,0.34140625,0.1763888888888889,0.0265625,0.019444444444444445
2705-2021_03_20_204018.jpg,lorry_truck,21,188,640,24,360,57,2,209,81,LTAdatasets/2705/annotate/2705-2021_03_20_204018.jpg,198.5,69.0,0.31015625,0.19166666666666668,0.0328125,0.06666666666666667
2705-2021_03_20_204018.jpg,bike,9,441,640,16,360,70,4,450,86,LTAdatasets/2705/annotate/2705-2021_03_20_204018.jpg,445.5,78.0,0.69609375,0.21666666666666667,0.0140625,0.044444444444444446
2705-2021_03_20_091002.jpg,bus,56,204,640,106,360,98,5,260,204,LTAdatasets/2705/annotate/2705-2021_03_20_091002.jpg,232.0,151.0,0.3625,0.41944444444444445,0.0875,0.29444444444444445
2705-2021_03_20_091002.jpg,car,41,532,640,20,360,121,1,573,141,LTAdatasets/2705/annotate/2705-2021_03_20_091002.jpg,552.5,131.0,0.86328125,0.3638888888888889,0.0640625,0.05555555555555555
2705-2021_03_20_091002.jpg,car,29,415,640,19,360,84,1,444,103,LTAdatasets/2705/annotate/2705-2021_03_20_091002.jpg,429.5,93.5,0.67109375,0.25972222222222224,0.0453125,0.05277777777777778
2705-2021_03_20_091002.jpg,car,18,192,640,17,360,79,1,210,96,LTAdatasets/2705/annotate/2705-2021_03_20_091002.jpg,201.0,87.5,0.3140625,0.24305555555555555,0.028125,0.04722222222222222
2705-2021_03_20_091002.jpg,car,15,215,640,9,360,63,1,230,72,LTAdatasets/2705/annotate/2705-2021_03_20_091002.jpg,222.5,67.5,0.34765625,0.1875,0.0234375,0.025
2705-2021_03_20_091002.jpg,car,12,190,640,9,360,59,1,202,68,LTAdatasets/2705/annotate/2705-2021_03_20_091002.jpg,196.0,63.5,0.30625,0.1763888888888889,0.01875,0.025
2705-2021_03_20_091002.jpg,bike,11,230,640,13,360,73,4,241,86,LTAdatasets/2705/annotate/2705-2021_03_20_091002.jpg,235.5,79.5,0.36796875,0.22083333333333333,0.0171875,0.03611111111111111
2705-2021_03_20_091002.jpg,bike,12,279,640,19,360,98,4,291,117,LTAdatasets/2705/annotate/2705-2021_03_20_091002.jpg,285.0,107.5,0.4453125,0.2986111111111111,0.01875,0.05277777777777778
2705-2021_03_20_091623.jpg,car,29,277,640,19,360,103,1,306,122,LTAdatasets/2705/annotate/2705-2021_03_20_091623.jpg,291.5,112.5,0.45546875,0.3125,0.0453125,0.05277777777777778
2705-2021_03_20_091623.jpg,car,40,473,640,36,360,95,1,513,131,LTAdatasets/2705/annotate/2705-2021_03_20_091623.jpg,493.0,113.0,0.7703125,0.3138888888888889,0.0625,0.1
2705-2021_03_20_091623.jpg,van,27,447,640,25,360,75,3,474,100,LTAdatasets/2705/annotate/2705-2021_03_20_091623.jpg,460.5,87.5,0.71953125,0.24305555555555555,0.0421875,0.06944444444444445
2705-2021_03_20_091623.jpg,lorry_truck,31,193,640,26,360,84,2,224,110,LTAdatasets/2705/annotate/2705-2021_03_20_091623.jpg,208.5,97.0,0.32578125,0.26944444444444443,0.0484375,0.07222222222222222
2705-2021_03_20_091623.jpg,car,19,242,640,14,360,62,1,261,76,LTAdatasets/2705/annotate/2705-2021_03_20_091623.jpg,251.5,69.0,0.39296875,0.19166666666666668,0.0296875,0.03888888888888889
2705-2021_03_20_091623.jpg,car,11,217,640,11,360,62,1,228,73,LTAdatasets/2705/annotate/2705-2021_03_20_091623.jpg,222.5,67.5,0.34765625,0.1875,0.0171875,0.030555555555555555
2705-2021_03_20_091623.jpg,lorry_truck,14,188,640,16,360,53,2,202,69,LTAdatasets/2705/annotate/2705-2021_03_20_091623.jpg,195.0,61.0,0.3046875,0.16944444444444445,0.021875,0.044444444444444446
2705-2021_03_20_094024.jpg,lorry_truck,32,191,640,43,360,78,2,223,121,LTAdatasets/2705/annotate/2705-2021_03_20_094024.jpg,207.0,99.5,0.3234375,0.2763888888888889,0.05,0.11944444444444445
2705-2021_03_20_094024.jpg,car,30,425,640,19,360,85,1,455,104,LTAdatasets/2705/annotate/2705-2021_03_20_094024.jpg,440.0,94.5,0.6875,0.2625,0.046875,0.05277777777777778
2705-2021_03_20_094024.jpg,car,62,390,640,47,360,181,1,452,228,LTAdatasets/2705/annotate/2705-2021_03_20_094024.jpg,421.0,204.5,0.6578125,0.5680555555555555,0.096875,0.13055555555555556
2705-2021_03_20_094024.jpg,lorry_truck,73,236,640,85,360,232,2,309,317,LTAdatasets/2705/annotate/2705-2021_03_20_094024.jpg,272.5,274.5,0.42578125,0.7625,0.1140625,0.2361111111111111
2705-2021_03_20_094024.jpg,car,33,275,640,15,360,96,1,308,111,LTAdatasets/2705/annotate/2705-2021_03_20_094024.jpg,291.5,103.5,0.45546875,0.2875,0.0515625,0.041666666666666664
2705-2021_03_20_094024.jpg,car,19,230,640,18,360,81,1,249,99,LTAdatasets/2705/annotate/2705-2021_03_20_094024.jpg,239.5,90.0,0.37421875,0.25,0.0296875,0.05
2705-2021_03_20_094024.jpg,car,15,208,640,10,360,55,1,223,65,LTAdatasets/2705/annotate/2705-2021_03_20_094024.jpg,215.5,60.0,0.33671875,0.16666666666666666,0.0234375,0.027777777777777776
2705-2021_03_20_091302.jpg,van,45,298,640,34,360,162,3,343,196,LTAdatasets/2705/annotate/2705-2021_03_20_091302.jpg,320.5,179.0,0.50078125,0.49722222222222223,0.0703125,0.09444444444444444
2705-2021_03_20_091302.jpg,car,60,372,640,43,360,165,1,432,208,LTAdatasets/2705/annotate/2705-2021_03_20_091302.jpg,402.0,186.5,0.628125,0.5180555555555556,0.09375,0.11944444444444445
2705-2021_03_20_091302.jpg,car,28,281,640,19,360,99,1,309,118,LTAdatasets/2705/annotate/2705-2021_03_20_091302.jpg,295.0,108.5,0.4609375,0.3013888888888889,0.04375,0.05277777777777778
2705-2021_03_20_091302.jpg,car,21,214,640,17,360,70,1,235,87,LTAdatasets/2705/annotate/2705-2021_03_20_091302.jpg,224.5,78.5,0.35078125,0.21805555555555556,0.0328125,0.04722222222222222
2705-2021_03_20_091302.jpg,car,19,251,640,19,360,104,1,270,123,LTAdatasets/2705/annotate/2705-2021_03_20_091302.jpg,260.5,113.5,0.40703125,0.31527777777777777,0.0296875,0.05277777777777778
2705-2021_03_20_091302.jpg,van,41,225,640,46,360,168,3,266,214,LTAdatasets/2705/annotate/2705-2021_03_20_091302.jpg,245.5,191.0,0.38359375,0.5305555555555556,0.0640625,0.12777777777777777
2705-2021_03_20_091302.jpg,car,15,231,640,8,360,56,1,246,64,LTAdatasets/2705/annotate/2705-2021_03_20_091302.jpg,238.5,60.0,0.37265625,0.16666666666666666,0.0234375,0.022222222222222223
2705-2021_03_20_183412.jpg,car,83,452,640,56,360,239,1,535,295,LTAdatasets/2705/annotate/2705-2021_03_20_183412.jpg,493.5,267.0,0.77109375,0.7416666666666667,0.1296875,0.15555555555555556
2705-2021_03_20_183412.jpg,car,84,410,640,54,360,306,1,494,360,LTAdatasets/2705/annotate/2705-2021_03_20_183412.jpg,452.0,333.0,0.70625,0.925,0.13125,0.15
2705-2021_03_20_183412.jpg,car,32,286,640,22,360,101,1,318,123,LTAdatasets/2705/annotate/2705-2021_03_20_183412.jpg,302.0,112.0,0.471875,0.3111111111111111,0.05,0.06111111111111111
2705-2021_03_20_183412.jpg,car,18,210,640,11,360,61,1,228,72,LTAdatasets/2705/annotate/2705-2021_03_20_183412.jpg,219.0,66.5,0.3421875,0.18472222222222223,0.028125,0.030555555555555555
2705-2021_03_20_183412.jpg,lorry_truck,38,229,640,38,360,95,2,267,133,LTAdatasets/2705/annotate/2705-2021_03_20_183412.jpg,248.0,114.0,0.3875,0.31666666666666665,0.059375,0.10555555555555556
2705-2021_03_20_183412.jpg,lorry_truck,33,467,640,29,360,92,2,500,121,LTAdatasets/2705/annotate/2705-2021_03_20_183412.jpg,483.5,106.5,0.75546875,0.29583333333333334,0.0515625,0.08055555555555556
2705-2021_03_20_183412.jpg,lorry_truck,30,413,640,25,360,78,2,443,103,LTAdatasets/2705/annotate/2705-2021_03_20_183412.jpg,428.0,90.5,0.66875,0.2513888888888889,0.046875,0.06944444444444445
2705-2021_03_20_183412.jpg,lorry_truck,25,432,640,16,360,65,2,457,81,LTAdatasets/2705/annotate/2705-2021_03_20_183412.jpg,444.5,73.0,0.69453125,0.20277777777777778,0.0390625,0.044444444444444446
2705-2021_03_20_183412.jpg,van,83,255,640,81,360,279,3,338,360,LTAdatasets/2705/annotate/2705-2021_03_20_183412.jpg,296.5,319.5,0.46328125,0.8875,0.1296875,0.225
2705-2021_03_20_193415.jpg,bike,24,297,640,32,360,172,4,321,204,LTAdatasets/2705/annotate/2705-2021_03_20_193415.jpg,309.0,188.0,0.4828125,0.5222222222222223,0.0375,0.08888888888888889
2705-2021_03_20_193415.jpg,car,23,246,640,15,360,106,1,269,121,LTAdatasets/2705/annotate/2705-2021_03_20_193415.jpg,257.5,113.5,0.40234375,0.31527777777777777,0.0359375,0.041666666666666664
2705-2021_03_20_193415.jpg,car,18,233,640,18,360,75,1,251,93,LTAdatasets/2705/annotate/2705-2021_03_20_193415.jpg,242.0,84.0,0.378125,0.23333333333333334,0.028125,0.05
2705-2021_03_20_193415.jpg,car,16,247,640,10,360,68,1,263,78,LTAdatasets/2705/annotate/2705-2021_03_20_193415.jpg,255.0,73.0,0.3984375,0.20277777777777778,0.025,0.027777777777777776
2705-2021_03_20_193415.jpg,car,22,383,640,12,360,62,1,405,74,LTAdatasets/2705/annotate/2705-2021_03_20_193415.jpg,394.0,68.0,0.615625,0.18888888888888888,0.034375,0.03333333333333333
2705-2021_03_20_193415.jpg,bike,10,221,640,12,360,67,4,231,79,LTAdatasets/2705/annotate/2705-2021_03_20_193415.jpg,226.0,73.0,0.353125,0.20277777777777778,0.015625,0.03333333333333333
2705-2021_03_20_193415.jpg,van,21,189,640,21,360,82,3,210,103,LTAdatasets/2705/annotate/2705-2021_03_20_193415.jpg,199.5,92.5,0.31171875,0.2569444444444444,0.0328125,0.058333333333333334
2705-2021_03_20_193415.jpg,car,14,190,640,9,360,55,1,204,64,LTAdatasets/2705/annotate/2705-2021_03_20_193415.jpg,197.0,59.5,0.3078125,0.16527777777777777,0.021875,0.025
2705-2021_03_20_074918.jpg,car,33,323,640,26,360,128,1,356,154,LTAdatasets/2705/annotate/2705-2021_03_20_074918.jpg,339.5,141.0,0.53046875,0.39166666666666666,0.0515625,0.07222222222222222
2705-2021_03_20_074918.jpg,car,34,267,640,27,360,130,1,301,157,LTAdatasets/2705/annotate/2705-2021_03_20_074918.jpg,284.0,143.5,0.44375,0.39861111111111114,0.053125,0.075
2705-2021_03_20_074918.jpg,lorry_truck,36,205,640,38,360,126,2,241,164,LTAdatasets/2705/annotate/2705-2021_03_20_074918.jpg,223.0,145.0,0.3484375,0.4027777777777778,0.05625,0.10555555555555556
2705-2021_03_20_074918.jpg,lorry_truck,86,489,640,48,360,82,2,575,130,LTAdatasets/2705/annotate/2705-2021_03_20_074918.jpg,532.0,106.0,0.83125,0.29444444444444445,0.134375,0.13333333333333333
2705-2021_03_20_074918.jpg,lorry_truck,15,212,640,17,360,53,2,227,70,LTAdatasets/2705/annotate/2705-2021_03_20_074918.jpg,219.5,61.5,0.34296875,0.17083333333333334,0.0234375,0.04722222222222222
2705-2021_03_20_074918.jpg,car,13,239,640,11,360,59,1,252,70,LTAdatasets/2705/annotate/2705-2021_03_20_074918.jpg,245.5,64.5,0.38359375,0.17916666666666667,0.0203125,0.030555555555555555
2705-2021_03_20_074918.jpg,car,17,190,640,12,360,74,1,207,86,LTAdatasets/2705/annotate/2705-2021_03_20_074918.jpg,198.5,80.0,0.31015625,0.2222222222222222,0.0265625,0.03333333333333333
2705-2021_03_20_090702.jpg,car,45,337,640,28,360,140,1,382,168,LTAdatasets/2705/annotate/2705-2021_03_20_090702.jpg,359.5,154.0,0.56171875,0.42777777777777776,0.0703125,0.07777777777777778
2705-2021_03_20_090702.jpg,car,22,242,640,18,360,97,1,264,115,LTAdatasets/2705/annotate/2705-2021_03_20_090702.jpg,253.0,106.0,0.3953125,0.29444444444444445,0.034375,0.05
2705-2021_03_20_090702.jpg,car,24,266,640,13,360,86,1,290,99,LTAdatasets/2705/annotate/2705-2021_03_20_090702.jpg,278.0,92.5,0.434375,0.2569444444444444,0.0375,0.03611111111111111
2705-2021_03_20_090702.jpg,van,18,188,640,14,360,69,3,206,83,LTAdatasets/2705/annotate/2705-2021_03_20_090702.jpg,197.0,76.0,0.3078125,0.2111111111111111,0.028125,0.03888888888888889
2705-2021_03_20_090702.jpg,van,81,360,640,80,360,230,3,441,310,LTAdatasets/2705/annotate/2705-2021_03_20_090702.jpg,400.5,270.0,0.62578125,0.75,0.1265625,0.2222222222222222
2705-2021_03_20_090702.jpg,lorry_truck,121,241,640,116,360,244,2,362,360,LTAdatasets/2705/annotate/2705-2021_03_20_090702.jpg,301.5,302.0,0.47109375,0.8388888888888889,0.1890625,0.32222222222222224
2705-2021_03_20_091903.jpg,lorry_truck,49,221,640,58,360,162,2,270,220,LTAdatasets/2705/annotate/2705-2021_03_20_091903.jpg,245.5,191.0,0.38359375,0.5305555555555556,0.0765625,0.16111111111111112
2705-2021_03_20_091903.jpg,car,74,437,640,53,360,223,1,511,276,LTAdatasets/2705/annotate/2705-2021_03_20_091903.jpg,474.0,249.5,0.740625,0.6930555555555555,0.115625,0.14722222222222223
2705-2021_03_20_091903.jpg,car,98,399,640,39,360,321,1,497,360,LTAdatasets/2705/annotate/2705-2021_03_20_091903.jpg,448.0,340.5,0.7,0.9458333333333333,0.153125,0.10833333333333334
2705-2021_03_20_091903.jpg,car,33,542,640,26,360,121,1,575,147,LTAdatasets/2705/annotate/2705-2021_03_20_091903.jpg,558.5,134.0,0.87265625,0.37222222222222223,0.0515625,0.07222222222222222
2705-2021_03_20_091903.jpg,car,29,369,640,18,360,81,1,398,99,LTAdatasets/2705/annotate/2705-2021_03_20_091903.jpg,383.5,90.0,0.59921875,0.25,0.0453125,0.05
2705-2021_03_20_091903.jpg,car,23,375,640,16,360,65,1,398,81,LTAdatasets/2705/annotate/2705-2021_03_20_091903.jpg,386.5,73.0,0.60390625,0.20277777777777778,0.0359375,0.044444444444444446
2705-2021_03_20_091903.jpg,car,34,272,640,36,360,130,1,306,166,LTAdatasets/2705/annotate/2705-2021_03_20_091903.jpg,289.0,148.0,0.4515625,0.4111111111111111,0.053125,0.1
2705-2021_03_20_091903.jpg,car,25,281,640,17,360,99,1,306,116,LTAdatasets/2705/annotate/2705-2021_03_20_091903.jpg,293.5,107.5,0.45859375,0.2986111111111111,0.0390625,0.04722222222222222
2705-2021_03_20_091903.jpg,van,16,223,640,16,360,72,3,239,88,LTAdatasets/2705/annotate/2705-2021_03_20_091903.jpg,231.0,80.0,0.3609375,0.2222222222222222,0.025,0.044444444444444446
2705-2021_03_20_091903.jpg,car,16,247,640,14,360,69,1,263,83,LTAdatasets/2705/annotate/2705-2021_03_20_091903.jpg,255.0,76.0,0.3984375,0.2111111111111111,0.025,0.03888888888888889
2705-2021_03_20_091903.jpg,car,24,211,640,18,360,91,1,235,109,LTAdatasets/2705/annotate/2705-2021_03_20_091903.jpg,223.0,100.0,0.3484375,0.2777777777777778,0.0375,0.05
2705-2021_03_20_091903.jpg,van,16,214,640,12,360,62,3,230,74,LTAdatasets/2705/annotate/2705-2021_03_20_091903.jpg,222.0,68.0,0.346875,0.18888888888888888,0.025,0.03333333333333333
2705-2021_03_20_091903.jpg,car,16,231,640,9,360,58,1,247,67,LTAdatasets/2705/annotate/2705-2021_03_20_091903.jpg,239.0,62.5,0.3734375,0.1736111111111111,0.025,0.025
2705-2021_03_20_091903.jpg,lorry_truck,24,189,640,26,360,67,2,213,93,LTAdatasets/2705/annotate/2705-2021_03_20_091903.jpg,201.0,80.0,0.3140625,0.2222222222222222,0.0375,0.07222222222222222
2705-2021_03_20_074318.jpg,bus,44,210,640,123,360,105,5,254,228,LTAdatasets/2705/annotate/2705-2021_03_20_074318.jpg,232.0,166.5,0.3625,0.4625,0.06875,0.3416666666666667
2705-2021_03_20_074318.jpg,car,110,496,640,88,360,258,1,606,346,LTAdatasets/2705/annotate/2705-2021_03_20_074318.jpg,551.0,302.0,0.8609375,0.8388888888888889,0.171875,0.24444444444444444
2705-2021_03_20_074318.jpg,car,24,390,640,19,360,72,1,414,91,LTAdatasets/2705/annotate/2705-2021_03_20_074318.jpg,402.0,81.5,0.628125,0.2263888888888889,0.0375,0.05277777777777778
2705-2021_03_20_074318.jpg,lorry_truck,51,296,640,53,360,153,2,347,206,LTAdatasets/2705/annotate/2705-2021_03_20_074318.jpg,321.5,179.5,0.50234375,0.4986111111111111,0.0796875,0.14722222222222223
2705-2021_03_20_074318.jpg,lorry_truck,31,192,640,31,360,75,2,223,106,LTAdatasets/2705/annotate/2705-2021_03_20_074318.jpg,207.5,90.5,0.32421875,0.2513888888888889,0.0484375,0.08611111111111111
2705-2021_03_20_074318.jpg,lorry_truck,12,189,640,28,360,45,2,201,73,LTAdatasets/2705/annotate/2705-2021_03_20_074318.jpg,195.0,59.0,0.3046875,0.1638888888888889,0.01875,0.07777777777777778
2705-2021_03_20_074318.jpg,car,18,262,640,15,360,87,1,280,102,LTAdatasets/2705/annotate/2705-2021_03_20_074318.jpg,271.0,94.5,0.4234375,0.2625,0.028125,0.041666666666666664
2705-2021_03_20_074318.jpg,car,12,231,640,10,360,54,1,243,64,LTAdatasets/2705/annotate/2705-2021_03_20_074318.jpg,237.0,59.0,0.3703125,0.1638888888888889,0.01875,0.027777777777777776
2705-2021_03_20_074318.jpg,bike,10,248,640,10,360,74,4,258,84,LTAdatasets/2705/annotate/2705-2021_03_20_074318.jpg,253.0,79.0,0.3953125,0.21944444444444444,0.015625,0.027777777777777776
2705-2021_03_20_074318.jpg,bike,12,235,640,16,360,91,4,247,107,LTAdatasets/2705/annotate/2705-2021_03_20_074318.jpg,241.0,99.0,0.3765625,0.275,0.01875,0.044444444444444446
2705-2021_03_20_074318.jpg,bike,12,259,640,20,360,100,4,271,120,LTAdatasets/2705/annotate/2705-2021_03_20_074318.jpg,265.0,110.0,0.4140625,0.3055555555555556,0.01875,0.05555555555555555
2705-2021_03_20_075138.jpg,car,52,246,640,54,360,249,1,298,303,LTAdatasets/2705/annotate/2705-2021_03_20_075138.jpg,272.0,276.0,0.425,0.7666666666666667,0.08125,0.15
2705-2021_03_20_075138.jpg,car,25,243,640,19,360,101,1,268,120,LTAdatasets/2705/annotate/2705-2021_03_20_075138.jpg,255.5,110.5,0.39921875,0.30694444444444446,0.0390625,0.05277777777777778
2705-2021_03_20_075138.jpg,car,23,257,640,13,360,75,1,280,88,LTAdatasets/2705/annotate/2705-2021_03_20_075138.jpg,268.5,81.5,0.41953125,0.2263888888888889,0.0359375,0.03611111111111111
2705-2021_03_20_075138.jpg,lorry_truck,22,226,640,16,360,73,2,248,89,LTAdatasets/2705/annotate/2705-2021_03_20_075138.jpg,237.0,81.0,0.3703125,0.225,0.034375,0.044444444444444446
2705-2021_03_20_075138.jpg,lorry_truck,33,188,640,30,360,79,2,221,109,LTAdatasets/2705/annotate/2705-2021_03_20_075138.jpg,204.5,94.0,0.31953125,0.2611111111111111,0.0515625,0.08333333333333333
2705-2021_03_20_075138.jpg,car,14,235,640,9,360,56,1,249,65,LTAdatasets/2705/annotate/2705-2021_03_20_075138.jpg,242.0,60.5,0.378125,0.16805555555555557,0.021875,0.025
2705-2021_03_20_075138.jpg,car,11,215,640,15,360,65,1,226,80,LTAdatasets/2705/annotate/2705-2021_03_20_075138.jpg,220.5,72.5,0.34453125,0.2013888888888889,0.0171875,0.041666666666666664
2705-2021_03_20_092143.jpg,car,70,460,640,59,360,230,1,530,289,LTAdatasets/2705/annotate/2705-2021_03_20_092143.jpg,495.0,259.5,0.7734375,0.7208333333333333,0.109375,0.1638888888888889
2705-2021_03_20_092143.jpg,car,45,542,640,32,360,123,1,587,155,LTAdatasets/2705/annotate/2705-2021_03_20_092143.jpg,564.5,139.0,0.88203125,0.3861111111111111,0.0703125,0.08888888888888889
2705-2021_03_20_092143.jpg,bike,18,299,640,24,360,115,4,317,139,LTAdatasets/2705/annotate/2705-2021_03_20_092143.jpg,308.0,127.0,0.48125,0.3527777777777778,0.028125,0.06666666666666667
2705-2021_03_20_092143.jpg,car,20,241,640,18,360,110,1,261,128,LTAdatasets/2705/annotate/2705-2021_03_20_092143.jpg,251.0,119.0,0.3921875,0.33055555555555555,0.03125,0.05
2705-2021_03_20_092143.jpg,car,30,217,640,24,360,139,1,247,163,LTAdatasets/2705/annotate/2705-2021_03_20_092143.jpg,232.0,151.0,0.3625,0.41944444444444445,0.046875,0.06666666666666667
2705-2021_03_20_092143.jpg,van,22,233,640,16,360,87,3,255,103,LTAdatasets/2705/annotate/2705-2021_03_20_092143.jpg,244.0,95.0,0.38125,0.2638888888888889,0.034375,0.044444444444444446
2705-2021_03_20_092143.jpg,car,18,259,640,18,360,75,1,277,93,LTAdatasets/2705/annotate/2705-2021_03_20_092143.jpg,268.0,84.0,0.41875,0.23333333333333334,0.028125,0.05
2705-2021_03_20_092143.jpg,car,17,221,640,11,360,77,1,238,88,LTAdatasets/2705/annotate/2705-2021_03_20_092143.jpg,229.5,82.5,0.35859375,0.22916666666666666,0.0265625,0.030555555555555555
2705-2021_03_20_092143.jpg,car,16,200,640,12,360,69,1,216,81,LTAdatasets/2705/annotate/2705-2021_03_20_092143.jpg,208.0,75.0,0.325,0.20833333333333334,0.025,0.03333333333333333
2705-2021_03_20_092143.jpg,van,15,242,640,14,360,60,3,257,74,LTAdatasets/2705/annotate/2705-2021_03_20_092143.jpg,249.5,67.0,0.38984375,0.18611111111111112,0.0234375,0.03888888888888889
2705-2021_03_20_092143.jpg,van,17,208,640,12,360,57,3,225,69,LTAdatasets/2705/annotate/2705-2021_03_20_092143.jpg,216.5,63.0,0.33828125,0.175,0.0265625,0.03333333333333333
2705-2021_03_20_093724.jpg,van,30,268,640,30,360,117,3,298,147,LTAdatasets/2705/annotate/2705-2021_03_20_093724.jpg,283.0,132.0,0.4421875,0.36666666666666664,0.046875,0.08333333333333333
2705-2021_03_20_093724.jpg,lorry_truck,20,191,640,25,360,76,2,211,101,LTAdatasets/2705/annotate/2705-2021_03_20_093724.jpg,201.0,88.5,0.3140625,0.24583333333333332,0.03125,0.06944444444444445
2705-2021_03_20_093724.jpg,car,24,389,640,15,360,64,1,413,79,LTAdatasets/2705/annotate/2705-2021_03_20_093724.jpg,401.0,71.5,0.6265625,0.1986111111111111,0.0375,0.041666666666666664
2705-2021_03_20_093724.jpg,bike,7,228,640,14,360,52,4,235,66,LTAdatasets/2705/annotate/2705-2021_03_20_093724.jpg,231.5,59.0,0.36171875,0.1638888888888889,0.0109375,0.03888888888888889
2705-2021_03_20_093724.jpg,lorry_truck,9,193,640,15,360,59,2,202,74,LTAdatasets/2705/annotate/2705-2021_03_20_093724.jpg,197.5,66.5,0.30859375,0.18472222222222223,0.0140625,0.041666666666666664
2705-2021_03_20_084301.jpg,lorry_truck,68,338,640,76,360,201,2,406,277,LTAdatasets/2705/annotate/2705-2021_03_20_084301.jpg,372.0,239.0,0.58125,0.6638888888888889,0.10625,0.2111111111111111
2705-2021_03_20_084301.jpg,lorry_truck,67,249,640,70,360,237,2,316,307,LTAdatasets/2705/annotate/2705-2021_03_20_084301.jpg,282.5,272.0,0.44140625,0.7555555555555555,0.1046875,0.19444444444444445
2705-2021_03_20_084301.jpg,lorry_truck,47,524,640,29,360,114,2,571,143,LTAdatasets/2705/annotate/2705-2021_03_20_084301.jpg,547.5,128.5,0.85546875,0.35694444444444445,0.0734375,0.08055555555555556
2705-2021_03_20_084301.jpg,lorry_truck,16,199,640,23,360,95,2,215,118,LTAdatasets/2705/annotate/2705-2021_03_20_084301.jpg,207.0,106.5,0.3234375,0.29583333333333334,0.025,0.06388888888888888
2705-2021_03_20_084301.jpg,lorry_truck,10,188,640,22,360,55,2,198,77,LTAdatasets/2705/annotate/2705-2021_03_20_084301.jpg,193.0,66.0,0.3015625,0.18333333333333332,0.015625,0.06111111111111111
2705-2021_03_20_084301.jpg,van,15,215,640,14,360,63,3,230,77,LTAdatasets/2705/annotate/2705-2021_03_20_084301.jpg,222.5,70.0,0.34765625,0.19444444444444445,0.0234375,0.03888888888888889
2705-2021_03_20_084301.jpg,bike,14,314,640,25,360,124,4,328,149,LTAdatasets/2705/annotate/2705-2021_03_20_084301.jpg,321.0,136.5,0.5015625,0.37916666666666665,0.021875,0.06944444444444445
2705-2021_03_20_203358.jpg,bike,22,439,640,20,360,100,4,461,120,LTAdatasets/2705/annotate/2705-2021_03_20_203358.jpg,450.0,110.0,0.703125,0.3055555555555556,0.034375,0.05555555555555555
2705-2021_03_20_203358.jpg,van,38,474,640,23,360,84,3,512,107,LTAdatasets/2705/annotate/2705-2021_03_20_203358.jpg,493.0,95.5,0.7703125,0.2652777777777778,0.059375,0.06388888888888888
2705-2021_03_20_203358.jpg,car,50,509,640,32,360,113,1,559,145,LTAdatasets/2705/annotate/2705-2021_03_20_203358.jpg,534.0,129.0,0.834375,0.35833333333333334,0.078125,0.08888888888888889
2705-2021_03_20_203358.jpg,car,30,399,640,18,360,70,1,429,88,LTAdatasets/2705/annotate/2705-2021_03_20_203358.jpg,414.0,79.0,0.646875,0.21944444444444444,0.046875,0.05
2705-2021_03_20_203358.jpg,car,43,348,640,35,360,147,1,391,182,LTAdatasets/2705/annotate/2705-2021_03_20_203358.jpg,369.5,164.5,0.57734375,0.45694444444444443,0.0671875,0.09722222222222222
2705-2021_03_20_203358.jpg,car,46,239,640,52,360,183,1,285,235,LTAdatasets/2705/annotate/2705-2021_03_20_203358.jpg,262.0,209.0,0.409375,0.5805555555555556,0.071875,0.14444444444444443
2705-2021_03_20_203358.jpg,car,21,201,640,20,360,104,1,222,124,LTAdatasets/2705/annotate/2705-2021_03_20_203358.jpg,211.5,114.0,0.33046875,0.31666666666666665,0.0328125,0.05555555555555555
2705-2021_03_20_203358.jpg,car,20,232,640,15,360,72,1,252,87,LTAdatasets/2705/annotate/2705-2021_03_20_203358.jpg,242.0,79.5,0.378125,0.22083333333333333,0.03125,0.041666666666666664
2705-2021_03_20_203358.jpg,car,14,218,640,10,360,64,1,232,74,LTAdatasets/2705/annotate/2705-2021_03_20_203358.jpg,225.0,69.0,0.3515625,0.19166666666666668,0.021875,0.027777777777777776
2705-2021_03_20_203358.jpg,lorry_truck,21,188,640,19,360,66,2,209,85,LTAdatasets/2705/annotate/2705-2021_03_20_203358.jpg,198.5,75.5,0.31015625,0.20972222222222223,0.0328125,0.05277777777777778
2705-2021_03_20_083340.jpg,van,36,273,640,37,360,134,3,309,171,LTAdatasets/2705/annotate/2705-2021_03_20_083340.jpg,291.0,152.5,0.4546875,0.4236111111111111,0.05625,0.10277777777777777
2705-2021_03_20_083340.jpg,car,46,337,640,35,360,158,1,383,193,LTAdatasets/2705/annotate/2705-2021_03_20_083340.jpg,360.0,175.5,0.5625,0.4875,0.071875,0.09722222222222222
2705-2021_03_20_083340.jpg,car,24,267,640,17,360,84,1,291,101,LTAdatasets/2705/annotate/2705-2021_03_20_083340.jpg,279.0,92.5,0.4359375,0.2569444444444444,0.0375,0.04722222222222222
2705-2021_03_20_083340.jpg,car,23,398,640,17,360,75,1,421,92,LTAdatasets/2705/annotate/2705-2021_03_20_083340.jpg,409.5,83.5,0.63984375,0.23194444444444445,0.0359375,0.04722222222222222
2705-2021_03_20_083340.jpg,car,13,242,640,8,360,65,1,255,73,LTAdatasets/2705/annotate/2705-2021_03_20_083340.jpg,248.5,69.0,0.38828125,0.19166666666666668,0.0203125,0.022222222222222223
2705-2021_03_20_083340.jpg,lorry_truck,38,185,640,58,360,74,2,223,132,LTAdatasets/2705/annotate/2705-2021_03_20_083340.jpg,204.0,103.0,0.31875,0.2861111111111111,0.059375,0.16111111111111112
2705-2021_03_20_083340.jpg,lorry_truck,28,380,640,22,360,53,2,408,75,LTAdatasets/2705/annotate/2705-2021_03_20_083340.jpg,394.0,64.0,0.615625,0.17777777777777778,0.04375,0.06111111111111111
2705-2021_03_20_083340.jpg,bike,7,219,640,12,360,66,4,226,78,LTAdatasets/2705/annotate/2705-2021_03_20_083340.jpg,222.5,72.0,0.34765625,0.2,0.0109375,0.03333333333333333
2705-2021_03_20_193935.jpg,car,50,365,640,36,360,167,1,415,203,LTAdatasets/2705/annotate/2705-2021_03_20_193935.jpg,390.0,185.0,0.609375,0.5138888888888888,0.078125,0.1
2705-2021_03_20_193935.jpg,lorry_truck,35,264,640,32,360,122,2,299,154,LTAdatasets/2705/annotate/2705-2021_03_20_193935.jpg,281.5,138.0,0.43984375,0.38333333333333336,0.0546875,0.08888888888888889
2705-2021_03_20_193935.jpg,car,36,565,640,28,360,115,1,601,143,LTAdatasets/2705/annotate/2705-2021_03_20_193935.jpg,583.0,129.0,0.9109375,0.35833333333333334,0.05625,0.07777777777777778
2705-2021_03_20_193935.jpg,car,29,246,640,17,360,112,1,275,129,LTAdatasets/2705/annotate/2705-2021_03_20_193935.jpg,260.5,120.5,0.40703125,0.3347222222222222,0.0453125,0.04722222222222222
2705-2021_03_20_193935.jpg,car,21,265,640,18,360,81,1,286,99,LTAdatasets/2705/annotate/2705-2021_03_20_193935.jpg,275.5,90.0,0.43046875,0.25,0.0328125,0.05
2705-2021_03_20_092803.jpg,car,36,368,640,32,360,160,1,404,192,LTAdatasets/2705/annotate/2705-2021_03_20_092803.jpg,386.0,176.0,0.603125,0.4888888888888889,0.05625,0.08888888888888889
2705-2021_03_20_092803.jpg,car,24,252,640,18,360,112,1,276,130,LTAdatasets/2705/annotate/2705-2021_03_20_092803.jpg,264.0,121.0,0.4125,0.33611111111111114,0.0375,0.05
2705-2021_03_20_092803.jpg,car,25,275,640,20,360,92,1,300,112,LTAdatasets/2705/annotate/2705-2021_03_20_092803.jpg,287.5,102.0,0.44921875,0.2833333333333333,0.0390625,0.05555555555555555
2705-2021_03_20_092803.jpg,car,19,365,640,18,360,63,1,384,81,LTAdatasets/2705/annotate/2705-2021_03_20_092803.jpg,374.5,72.0,0.58515625,0.2,0.0296875,0.05
2705-2021_03_20_092803.jpg,lorry_truck,41,519,640,26,360,95,2,560,121,LTAdatasets/2705/annotate/2705-2021_03_20_092803.jpg,539.5,108.0,0.84296875,0.3,0.0640625,0.07222222222222222
2705-2021_03_20_092803.jpg,lorry_truck,39,195,640,46,360,96,2,234,142,LTAdatasets/2705/annotate/2705-2021_03_20_092803.jpg,214.5,119.0,0.33515625,0.33055555555555555,0.0609375,0.12777777777777777
2705-2021_03_20_092803.jpg,car,15,228,640,14,360,51,1,243,65,LTAdatasets/2705/annotate/2705-2021_03_20_092803.jpg,235.5,58.0,0.36796875,0.16111111111111112,0.0234375,0.03888888888888889
2705-2021_03_20_182752.jpg,car,52,383,640,40,360,169,1,435,209,LTAdatasets/2705/annotate/2705-2021_03_20_182752.jpg,409.0,189.0,0.6390625,0.525,0.08125,0.1111111111111111
2705-2021_03_20_182752.jpg,car,22,276,640,20,360,92,1,298,112,LTAdatasets/2705/annotate/2705-2021_03_20_182752.jpg,287.0,102.0,0.4484375,0.2833333333333333,0.034375,0.05555555555555555
2705-2021_03_20_182752.jpg,car,33,238,640,21,360,102,1,271,123,LTAdatasets/2705/annotate/2705-2021_03_20_182752.jpg,254.5,112.5,0.39765625,0.3125,0.0515625,0.058333333333333334
2705-2021_03_20_182752.jpg,car,43,461,640,23,360,123,1,504,146,LTAdatasets/2705/annotate/2705-2021_03_20_182752.jpg,482.5,134.5,0.75390625,0.3736111111111111,0.0671875,0.06388888888888888
2705-2021_03_20_182752.jpg,car,37,491,640,20,360,110,1,528,130,LTAdatasets/2705/annotate/2705-2021_03_20_182752.jpg,509.5,120.0,0.79609375,0.3333333333333333,0.0578125,0.05555555555555555
2705-2021_03_20_182752.jpg,car,30,436,640,20,360,75,1,466,95,LTAdatasets/2705/annotate/2705-2021_03_20_182752.jpg,451.0,85.0,0.7046875,0.2361111111111111,0.046875,0.05555555555555555
2705-2021_03_20_182752.jpg,car,29,384,640,18,360,77,1,413,95,LTAdatasets/2705/annotate/2705-2021_03_20_182752.jpg,398.5,86.0,0.62265625,0.2388888888888889,0.0453125,0.05
2705-2021_03_20_182752.jpg,bike,31,319,640,43,360,317,4,350,360,LTAdatasets/2705/annotate/2705-2021_03_20_182752.jpg,334.5,338.5,0.52265625,0.9402777777777778,0.0484375,0.11944444444444445
2705-2021_03_20_182752.jpg,lorry_truck,116,352,640,119,360,227,2,468,346,LTAdatasets/2705/annotate/2705-2021_03_20_182752.jpg,410.0,286.5,0.640625,0.7958333333333333,0.18125,0.33055555555555555
2705-2021_03_20_182752.jpg,lorry_truck,40,215,640,41,360,144,2,255,185,LTAdatasets/2705/annotate/2705-2021_03_20_182752.jpg,235.0,164.5,0.3671875,0.45694444444444443,0.0625,0.11388888888888889
2705-2021_03_20_182752.jpg,car,16,236,640,10,360,62,1,252,72,LTAdatasets/2705/annotate/2705-2021_03_20_182752.jpg,244.0,67.0,0.38125,0.18611111111111112,0.025,0.027777777777777776
2705-2021_03_20_182752.jpg,car,9,227,640,9,360,51,1,236,60,LTAdatasets/2705/annotate/2705-2021_03_20_182752.jpg,231.5,55.5,0.36171875,0.15416666666666667,0.0140625,0.025
2705-2021_03_20_203058.jpg,lorry_truck,46,491,640,28,360,92,2,537,120,LTAdatasets/2705/annotate/2705-2021_03_20_203058.jpg,514.0,106.0,0.803125,0.29444444444444445,0.071875,0.07777777777777778
2705-2021_03_20_203058.jpg,car,20,191,640,12,360,81,1,211,93,LTAdatasets/2705/annotate/2705-2021_03_20_203058.jpg,201.0,87.0,0.3140625,0.24166666666666667,0.03125,0.03333333333333333
2705-2021_03_20_203058.jpg,car,11,192,640,9,360,65,1,203,74,LTAdatasets/2705/annotate/2705-2021_03_20_203058.jpg,197.5,69.5,0.30859375,0.19305555555555556,0.0171875,0.025
2705-2021_03_20_203058.jpg,bike,13,212,640,16,360,70,4,225,86,LTAdatasets/2705/annotate/2705-2021_03_20_203058.jpg,218.5,78.0,0.34140625,0.21666666666666667,0.0203125,0.044444444444444446
2705-2021_03_20_084001.jpg,van,57,312,640,57,360,183,3,369,240,LTAdatasets/2705/annotate/2705-2021_03_20_084001.jpg,340.5,211.5,0.53203125,0.5875,0.0890625,0.15833333333333333
2705-2021_03_20_084001.jpg,van,12,207,640,8,360,52,3,219,60,LTAdatasets/2705/annotate/2705-2021_03_20_084001.jpg,213.0,56.0,0.3328125,0.15555555555555556,0.01875,0.022222222222222223
2705-2021_03_20_084001.jpg,car,15,257,640,15,360,74,1,272,89,LTAdatasets/2705/annotate/2705-2021_03_20_084001.jpg,264.5,81.5,0.41328125,0.2263888888888889,0.0234375,0.041666666666666664
2705-2021_03_20_084001.jpg,car,32,456,640,25,360,114,1,488,139,LTAdatasets/2705/annotate/2705-2021_03_20_084001.jpg,472.0,126.5,0.7375,0.35138888888888886,0.05,0.06944444444444445
2705-2021_03_20_084001.jpg,car,38,316,640,23,360,124,1,354,147,LTAdatasets/2705/annotate/2705-2021_03_20_084001.jpg,335.0,135.5,0.5234375,0.3763888888888889,0.059375,0.06388888888888888
2705-2021_03_20_084001.jpg,lorry_truck,33,408,640,17,360,67,2,441,84,LTAdatasets/2705/annotate/2705-2021_03_20_084001.jpg,424.5,75.5,0.66328125,0.20972222222222223,0.0515625,0.04722222222222222
2705-2021_03_20_084001.jpg,lorry_truck,123,244,640,77,360,283,2,367,360,LTAdatasets/2705/annotate/2705-2021_03_20_084001.jpg,305.5,321.5,0.47734375,0.8930555555555556,0.1921875,0.21388888888888888
2705-2021_03_20_204238.jpg,van,41,227,640,50,360,158,3,268,208,LTAdatasets/2705/annotate/2705-2021_03_20_204238.jpg,247.5,183.0,0.38671875,0.5083333333333333,0.0640625,0.1388888888888889
2705-2021_03_20_204238.jpg,car,46,346,640,29,360,151,1,392,180,LTAdatasets/2705/annotate/2705-2021_03_20_204238.jpg,369.0,165.5,0.5765625,0.4597222222222222,0.071875,0.08055555555555556
2705-2021_03_20_204238.jpg,car,21,195,640,19,360,109,1,216,128,LTAdatasets/2705/annotate/2705-2021_03_20_204238.jpg,205.5,118.5,0.32109375,0.32916666666666666,0.0328125,0.05277777777777778
2705-2021_03_20_204238.jpg,car,22,197,640,17,360,86,1,219,103,LTAdatasets/2705/annotate/2705-2021_03_20_204238.jpg,208.0,94.5,0.325,0.2625,0.034375,0.04722222222222222
2705-2021_03_20_204238.jpg,car,21,373,640,16,360,71,1,394,87,LTAdatasets/2705/annotate/2705-2021_03_20_204238.jpg,383.5,79.0,0.59921875,0.21944444444444444,0.0328125,0.044444444444444446
2705-2021_03_20_204238.jpg,bike,13,458,640,16,360,74,4,471,90,LTAdatasets/2705/annotate/2705-2021_03_20_204238.jpg,464.5,82.0,0.72578125,0.22777777777777777,0.0203125,0.044444444444444446
2705-2021_03_20_072817.jpg,car,55,415,640,55,360,205,1,470,260,LTAdatasets/2705/annotate/2705-2021_03_20_072817.jpg,442.5,232.5,0.69140625,0.6458333333333334,0.0859375,0.1527777777777778
2705-2021_03_20_072817.jpg,car,66,352,640,59,360,230,1,418,289,LTAdatasets/2705/annotate/2705-2021_03_20_072817.jpg,385.0,259.5,0.6015625,0.7208333333333333,0.103125,0.1638888888888889
2705-2021_03_20_072817.jpg,car,35,337,640,31,360,135,1,372,166,LTAdatasets/2705/annotate/2705-2021_03_20_072817.jpg,354.5,150.5,0.55390625,0.41805555555555557,0.0546875,0.08611111111111111
2705-2021_03_20_072817.jpg,van,25,399,640,21,360,72,3,424,93,LTAdatasets/2705/annotate/2705-2021_03_20_072817.jpg,411.5,82.5,0.64296875,0.22916666666666666,0.0390625,0.058333333333333334
2705-2021_03_20_072817.jpg,van,39,222,640,41,360,140,3,261,181,LTAdatasets/2705/annotate/2705-2021_03_20_072817.jpg,241.5,160.5,0.37734375,0.44583333333333336,0.0609375,0.11388888888888889
2705-2021_03_20_072817.jpg,car,15,226,640,14,360,78,1,241,92,LTAdatasets/2705/annotate/2705-2021_03_20_072817.jpg,233.5,85.0,0.36484375,0.2361111111111111,0.0234375,0.03888888888888889
2705-2021_03_20_072817.jpg,lorry_truck,26,189,640,29,360,74,2,215,103,LTAdatasets/2705/annotate/2705-2021_03_20_072817.jpg,202.0,88.5,0.315625,0.24583333333333332,0.040625,0.08055555555555556
2705-2021_03_20_072817.jpg,car,10,217,640,11,360,63,1,227,74,LTAdatasets/2705/annotate/2705-2021_03_20_072817.jpg,222.0,68.5,0.346875,0.19027777777777777,0.015625,0.030555555555555555
2705-2021_03_20_072817.jpg,car,21,578,640,21,360,116,1,599,137,LTAdatasets/2705/annotate/2705-2021_03_20_072817.jpg,588.5,126.5,0.91953125,0.35138888888888886,0.0328125,0.058333333333333334
2705-2021_03_20_200637.jpg,car,38,555,640,28,360,122,1,593,150,LTAdatasets/2705/annotate/2705-2021_03_20_200637.jpg,574.0,136.0,0.896875,0.37777777777777777,0.059375,0.07777777777777778
2705-2021_03_20_200637.jpg,bus,57,402,640,50,360,42,5,459,92,LTAdatasets/2705/annotate/2705-2021_03_20_200637.jpg,430.5,67.0,0.67265625,0.18611111111111112,0.0890625,0.1388888888888889
2705-2021_03_20_200637.jpg,car,17,269,640,20,360,83,1,286,103,LTAdatasets/2705/annotate/2705-2021_03_20_200637.jpg,277.5,93.0,0.43359375,0.25833333333333336,0.0265625,0.05555555555555555
2705-2021_03_20_200637.jpg,car,18,223,640,11,360,76,1,241,87,LTAdatasets/2705/annotate/2705-2021_03_20_200637.jpg,232.0,81.5,0.3625,0.2263888888888889,0.028125,0.030555555555555555
2705-2021_03_20_200637.jpg,car,17,189,640,9,360,66,1,206,75,LTAdatasets/2705/annotate/2705-2021_03_20_200637.jpg,197.5,70.5,0.30859375,0.19583333333333333,0.0265625,0.025
2705-2021_03_20_200637.jpg,car,15,207,640,13,360,60,1,222,73,LTAdatasets/2705/annotate/2705-2021_03_20_200637.jpg,214.5,66.5,0.33515625,0.18472222222222223,0.0234375,0.03611111111111111
2705-2021_03_20_200637.jpg,car,25,376,640,16,360,85,1,401,101,LTAdatasets/2705/annotate/2705-2021_03_20_200637.jpg,388.5,93.0,0.60703125,0.25833333333333336,0.0390625,0.044444444444444446
2705-2021_03_20_194616.jpg,car,30,264,640,33,360,116,1,294,149,LTAdatasets/2705/annotate/2705-2021_03_20_194616.jpg,279.0,132.5,0.4359375,0.3680555555555556,0.046875,0.09166666666666666
2705-2021_03_20_194616.jpg,van,27,388,640,17,360,70,3,415,87,LTAdatasets/2705/annotate/2705-2021_03_20_194616.jpg,401.5,78.5,0.62734375,0.21805555555555556,0.0421875,0.04722222222222222
2705-2021_03_20_194616.jpg,car,22,361,640,18,360,75,1,383,93,LTAdatasets/2705/annotate/2705-2021_03_20_194616.jpg,372.0,84.0,0.58125,0.23333333333333334,0.034375,0.05
2705-2021_03_20_093424.jpg,car,60,402,640,47,360,203,1,462,250,LTAdatasets/2705/annotate/2705-2021_03_20_093424.jpg,432.0,226.5,0.675,0.6291666666666667,0.09375,0.13055555555555556
2705-2021_03_20_093424.jpg,car,42,456,640,39,360,112,1,498,151,LTAdatasets/2705/annotate/2705-2021_03_20_093424.jpg,477.0,131.5,0.7453125,0.36527777777777776,0.065625,0.10833333333333334
2705-2021_03_20_093424.jpg,car,32,452,640,23,360,94,1,484,117,LTAdatasets/2705/annotate/2705-2021_03_20_093424.jpg,468.0,105.5,0.73125,0.29305555555555557,0.05,0.06388888888888888
2705-2021_03_20_093424.jpg,bike,18,305,640,31,360,150,4,323,181,LTAdatasets/2705/annotate/2705-2021_03_20_093424.jpg,314.0,165.5,0.490625,0.4597222222222222,0.028125,0.08611111111111111
2705-2021_03_20_093424.jpg,car,34,210,640,25,360,158,1,244,183,LTAdatasets/2705/annotate/2705-2021_03_20_093424.jpg,227.0,170.5,0.3546875,0.4736111111111111,0.053125,0.06944444444444445
2705-2021_03_20_093424.jpg,car,28,308,640,20,360,118,1,336,138,LTAdatasets/2705/annotate/2705-2021_03_20_093424.jpg,322.0,128.0,0.503125,0.35555555555555557,0.04375,0.05555555555555555
2705-2021_03_20_093424.jpg,car,25,243,640,21,360,101,1,268,122,LTAdatasets/2705/annotate/2705-2021_03_20_093424.jpg,255.5,111.5,0.39921875,0.30972222222222223,0.0390625,0.058333333333333334
2705-2021_03_20_093424.jpg,car,11,245,640,14,360,61,1,256,75,LTAdatasets/2705/annotate/2705-2021_03_20_093424.jpg,250.5,68.0,0.39140625,0.18888888888888888,0.0171875,0.03888888888888889
2705-2021_03_20_093424.jpg,van,19,221,640,18,360,73,3,240,91,LTAdatasets/2705/annotate/2705-2021_03_20_093424.jpg,230.5,82.0,0.36015625,0.22777777777777777,0.0296875,0.05
2705-2021_03_20_093424.jpg,lorry_truck,24,185,640,26,360,61,2,209,87,LTAdatasets/2705/annotate/2705-2021_03_20_093424.jpg,197.0,74.0,0.3078125,0.20555555555555555,0.0375,0.07222222222222222
2705-2021_03_20_093424.jpg,lorry_truck,28,381,640,19,360,55,2,409,74,LTAdatasets/2705/annotate/2705-2021_03_20_093424.jpg,395.0,64.5,0.6171875,0.17916666666666667,0.04375,0.05277777777777778
2705-2021_03_20_190113.jpg,bus,26,191,640,41,360,72,5,217,113,LTAdatasets/2705/annotate/2705-2021_03_20_190113.jpg,204.0,92.5,0.31875,0.2569444444444444,0.040625,0.11388888888888889
2705-2021_03_20_190113.jpg,car,51,501,640,35,360,127,1,552,162,LTAdatasets/2705/annotate/2705-2021_03_20_190113.jpg,526.5,144.5,0.82265625,0.4013888888888889,0.0796875,0.09722222222222222
2705-2021_03_20_190113.jpg,van,25,394,640,22,360,62,3,419,84,LTAdatasets/2705/annotate/2705-2021_03_20_190113.jpg,406.5,73.0,0.63515625,0.20277777777777778,0.0390625,0.06111111111111111
2705-2021_03_20_190113.jpg,car,25,294,640,22,360,101,1,319,123,LTAdatasets/2705/annotate/2705-2021_03_20_190113.jpg,306.5,112.0,0.47890625,0.3111111111111111,0.0390625,0.06111111111111111
2705-2021_03_20_182451.jpg,lorry_truck,43,510,640,37,360,88,2,553,125,LTAdatasets/2705/annotate/2705-2021_03_20_182451.jpg,531.5,106.5,0.83046875,0.29583333333333334,0.0671875,0.10277777777777777
2705-2021_03_20_182451.jpg,car,29,278,640,18,360,99,1,307,117,LTAdatasets/2705/annotate/2705-2021_03_20_182451.jpg,292.5,108.0,0.45703125,0.3,0.0453125,0.05
2705-2021_03_20_182451.jpg,car,29,409,640,17,360,85,1,438,102,LTAdatasets/2705/annotate/2705-2021_03_20_182451.jpg,423.5,93.5,0.66171875,0.25972222222222224,0.0453125,0.04722222222222222
2705-2021_03_20_182451.jpg,car,20,418,640,13,360,74,1,438,87,LTAdatasets/2705/annotate/2705-2021_03_20_182451.jpg,428.0,80.5,0.66875,0.22361111111111112,0.03125,0.03611111111111111
2705-2021_03_20_182451.jpg,car,88,453,640,74,360,261,1,541,335,LTAdatasets/2705/annotate/2705-2021_03_20_182451.jpg,497.0,298.0,0.7765625,0.8277777777777777,0.1375,0.20555555555555555
2705-2021_03_20_182451.jpg,car,17,219,640,19,360,74,1,236,93,LTAdatasets/2705/annotate/2705-2021_03_20_182451.jpg,227.5,83.5,0.35546875,0.23194444444444445,0.0265625,0.05277777777777778
2705-2021_03_20_182451.jpg,car,16,234,640,8,360,62,1,250,70,LTAdatasets/2705/annotate/2705-2021_03_20_182451.jpg,242.0,66.0,0.378125,0.18333333333333332,0.025,0.022222222222222223
2705-2021_03_20_182451.jpg,car,15,211,640,12,360,60,1,226,72,LTAdatasets/2705/annotate/2705-2021_03_20_182451.jpg,218.5,66.0,0.34140625,0.18333333333333332,0.0234375,0.03333333333333333
2705-2021_03_20_182451.jpg,bike,9,225,640,12,360,55,4,234,67,LTAdatasets/2705/annotate/2705-2021_03_20_182451.jpg,229.5,61.0,0.35859375,0.16944444444444445,0.0140625,0.03333333333333333
2705-2021_03_20_073717.jpg,car,33,486,640,28,360,96,1,519,124,LTAdatasets/2705/annotate/2705-2021_03_20_073717.jpg,502.5,110.0,0.78515625,0.3055555555555556,0.0515625,0.07777777777777778
2705-2021_03_20_073717.jpg,bike,23,423,640,38,360,180,4,446,218,LTAdatasets/2705/annotate/2705-2021_03_20_073717.jpg,434.5,199.0,0.67890625,0.5527777777777778,0.0359375,0.10555555555555556
2705-2021_03_20_073717.jpg,lorry_truck,51,291,640,44,360,152,2,342,196,LTAdatasets/2705/annotate/2705-2021_03_20_073717.jpg,316.5,174.0,0.49453125,0.48333333333333334,0.0796875,0.12222222222222222
2705-2021_03_20_073717.jpg,lorry_truck,37,209,640,45,360,146,2,246,191,LTAdatasets/2705/annotate/2705-2021_03_20_073717.jpg,227.5,168.5,0.35546875,0.46805555555555556,0.0578125,0.125
2705-2021_03_20_073717.jpg,car,25,261,640,22,360,106,1,286,128,LTAdatasets/2705/annotate/2705-2021_03_20_073717.jpg,273.5,117.0,0.42734375,0.325,0.0390625,0.06111111111111111
2705-2021_03_20_073717.jpg,car,15,217,640,14,360,70,1,232,84,LTAdatasets/2705/annotate/2705-2021_03_20_073717.jpg,224.5,77.0,0.35078125,0.21388888888888888,0.0234375,0.03888888888888889
2705-2021_03_20_073717.jpg,car,15,212,640,13,360,53,1,227,66,LTAdatasets/2705/annotate/2705-2021_03_20_073717.jpg,219.5,59.5,0.34296875,0.16527777777777777,0.0234375,0.03611111111111111
2705-2021_03_20_191914.jpg,car,26,408,640,16,360,97,1,434,113,LTAdatasets/2705/annotate/2705-2021_03_20_191914.jpg,421.0,105.0,0.6578125,0.2916666666666667,0.040625,0.044444444444444446
2705-2021_03_20_191914.jpg,van,39,552,640,31,360,105,3,591,136,LTAdatasets/2705/annotate/2705-2021_03_20_191914.jpg,571.5,120.5,0.89296875,0.3347222222222222,0.0609375,0.08611111111111111
2705-2021_03_20_191914.jpg,lorry_truck,38,505,640,39,360,104,2,543,143,LTAdatasets/2705/annotate/2705-2021_03_20_191914.jpg,524.0,123.5,0.81875,0.34305555555555556,0.059375,0.10833333333333334
2705-2021_03_20_191914.jpg,car,15,195,640,14,360,80,1,210,94,LTAdatasets/2705/annotate/2705-2021_03_20_191914.jpg,202.5,87.0,0.31640625,0.24166666666666667,0.0234375,0.03888888888888889
2705-2021_03_20_191914.jpg,car,13,242,640,11,360,61,1,255,72,LTAdatasets/2705/annotate/2705-2021_03_20_191914.jpg,248.5,66.5,0.38828125,0.18472222222222223,0.0203125,0.030555555555555555
2705-2021_03_20_191914.jpg,car,9,197,640,7,360,62,1,206,69,LTAdatasets/2705/annotate/2705-2021_03_20_191914.jpg,201.5,65.5,0.31484375,0.18194444444444444,0.0140625,0.019444444444444445
2705-2021_03_20_093103.jpg,van,55,325,640,51,360,183,3,380,234,LTAdatasets/2705/annotate/2705-2021_03_20_093103.jpg,352.5,208.5,0.55078125,0.5791666666666667,0.0859375,0.14166666666666666
2705-2021_03_20_093103.jpg,car,98,503,640,74,360,272,1,601,346,LTAdatasets/2705/annotate/2705-2021_03_20_093103.jpg,552.0,309.0,0.8625,0.8583333333333333,0.153125,0.20555555555555555
2705-2021_03_20_093103.jpg,car,23,318,640,22,360,118,1,341,140,LTAdatasets/2705/annotate/2705-2021_03_20_093103.jpg,329.5,129.0,0.51484375,0.35833333333333334,0.0359375,0.06111111111111111
2705-2021_03_20_093103.jpg,car,29,261,640,25,360,125,1,290,150,LTAdatasets/2705/annotate/2705-2021_03_20_093103.jpg,275.5,137.5,0.43046875,0.3819444444444444,0.0453125,0.06944444444444445
2705-2021_03_20_093103.jpg,car,28,395,640,16,360,78,1,423,94,LTAdatasets/2705/annotate/2705-2021_03_20_093103.jpg,409.0,86.0,0.6390625,0.2388888888888889,0.04375,0.044444444444444446
2705-2021_03_20_093103.jpg,lorry_truck,16,488,640,24,360,93,2,504,117,LTAdatasets/2705/annotate/2705-2021_03_20_093103.jpg,496.0,105.0,0.775,0.2916666666666667,0.025,0.06666666666666667
2705-2021_03_20_093103.jpg,lorry_truck,12,284,640,19,360,103,2,296,122,LTAdatasets/2705/annotate/2705-2021_03_20_093103.jpg,290.0,112.5,0.453125,0.3125,0.01875,0.05277777777777778
2705-2021_03_20_093103.jpg,car,21,234,640,19,360,84,1,255,103,LTAdatasets/2705/annotate/2705-2021_03_20_093103.jpg,244.5,93.5,0.38203125,0.25972222222222224,0.0328125,0.05277777777777778
2705-2021_03_20_093103.jpg,lorry_truck,22,190,640,46,360,83,2,212,129,LTAdatasets/2705/annotate/2705-2021_03_20_093103.jpg,201.0,106.0,0.3140625,0.29444444444444445,0.034375,0.12777777777777777
2705-2021_03_20_093103.jpg,lorry_truck,27,397,640,17,360,58,2,424,75,LTAdatasets/2705/annotate/2705-2021_03_20_093103.jpg,410.5,66.5,0.64140625,0.18472222222222223,0.0421875,0.04722222222222222
2705-2021_03_20_093103.jpg,van,14,217,640,18,360,66,3,231,84,LTAdatasets/2705/annotate/2705-2021_03_20_093103.jpg,224.0,75.0,0.35,0.20833333333333334,0.021875,0.05
2705-2021_03_20_093103.jpg,car,16,246,640,12,360,65,1,262,77,LTAdatasets/2705/annotate/2705-2021_03_20_093103.jpg,254.0,71.0,0.396875,0.19722222222222222,0.025,0.03333333333333333
2705-2021_03_20_093103.jpg,lorry_truck,17,192,640,23,360,50,2,209,73,LTAdatasets/2705/annotate/2705-2021_03_20_093103.jpg,200.5,61.5,0.31328125,0.17083333333333334,0.0265625,0.06388888888888888
2705-2021_03_20_182151.jpg,lorry_truck,65,243,640,97,360,235,2,308,332,LTAdatasets/2705/annotate/2705-2021_03_20_182151.jpg,275.5,283.5,0.43046875,0.7875,0.1015625,0.26944444444444443
2705-2021_03_20_182151.jpg,car,27,379,640,23,360,86,1,406,109,LTAdatasets/2705/annotate/2705-2021_03_20_182151.jpg,392.5,97.5,0.61328125,0.2708333333333333,0.0421875,0.06388888888888888
2705-2021_03_20_182151.jpg,car,22,424,640,19,360,84,1,446,103,LTAdatasets/2705/annotate/2705-2021_03_20_182151.jpg,435.0,93.5,0.6796875,0.25972222222222224,0.034375,0.05277777777777778
2705-2021_03_20_182151.jpg,car,21,228,640,15,360,81,1,249,96,LTAdatasets/2705/annotate/2705-2021_03_20_182151.jpg,238.5,88.5,0.37265625,0.24583333333333332,0.0328125,0.041666666666666664
2705-2021_03_20_182151.jpg,car,16,246,640,12,360,67,1,262,79,LTAdatasets/2705/annotate/2705-2021_03_20_182151.jpg,254.0,73.0,0.396875,0.20277777777777778,0.025,0.03333333333333333
2705-2021_03_20_182151.jpg,bike,12,281,640,24,360,94,4,293,118,LTAdatasets/2705/annotate/2705-2021_03_20_182151.jpg,287.0,106.0,0.4484375,0.29444444444444445,0.01875,0.06666666666666667
2705-2021_03_20_182151.jpg,car,17,369,640,13,360,66,1,386,79,LTAdatasets/2705/annotate/2705-2021_03_20_182151.jpg,377.5,72.5,0.58984375,0.2013888888888889,0.0265625,0.03611111111111111
2705-2021_03_20_182151.jpg,bus,43,193,640,48,360,89,5,236,137,LTAdatasets/2705/annotate/2705-2021_03_20_182151.jpg,214.5,113.0,0.33515625,0.3138888888888889,0.0671875,0.13333333333333333
2705-2021_03_20_182151.jpg,bike,10,220,640,11,360,50,4,230,61,LTAdatasets/2705/annotate/2705-2021_03_20_182151.jpg,225.0,55.5,0.3515625,0.15416666666666667,0.015625,0.030555555555555555
2705-2021_03_20_201617.jpg,bike,15,421,640,30,360,95,4,436,125,LTAdatasets/2705/annotate/2705-2021_03_20_201617.jpg,428.5,110.0,0.66953125,0.3055555555555556,0.0234375,0.08333333333333333
2705-2021_03_20_201617.jpg,car,28,265,640,17,360,90,1,293,107,LTAdatasets/2705/annotate/2705-2021_03_20_201617.jpg,279.0,98.5,0.4359375,0.27361111111111114,0.04375,0.04722222222222222
2705-2021_03_20_201617.jpg,car,97,427,640,46,360,314,1,524,360,LTAdatasets/2705/annotate/2705-2021_03_20_201617.jpg,475.5,337.0,0.74296875,0.9361111111111111,0.1515625,0.12777777777777777
2705-2021_03_20_201617.jpg,bus,103,468,640,70,360,71,5,571,141,LTAdatasets/2705/annotate/2705-2021_03_20_201617.jpg,519.5,106.0,0.81171875,0.29444444444444445,0.1609375,0.19444444444444445
2705-2021_03_20_201617.jpg,lorry_truck,18,446,640,33,360,66,2,464,99,LTAdatasets/2705/annotate/2705-2021_03_20_201617.jpg,455.0,82.5,0.7109375,0.22916666666666666,0.028125,0.09166666666666666
2705-2021_03_20_090102.jpg,lorry_truck,33,455,640,40,360,78,2,488,118,LTAdatasets/2705/annotate/2705-2021_03_20_090102.jpg,471.5,98.0,0.73671875,0.2722222222222222,0.0515625,0.1111111111111111
2705-2021_03_20_090102.jpg,lorry_truck,12,490,640,22,360,80,2,502,102,LTAdatasets/2705/annotate/2705-2021_03_20_090102.jpg,496.0,91.0,0.775,0.25277777777777777,0.01875,0.06111111111111111
2705-2021_03_20_090102.jpg,lorry_truck,56,314,640,76,360,169,2,370,245,LTAdatasets/2705/annotate/2705-2021_03_20_090102.jpg,342.0,207.0,0.534375,0.575,0.0875,0.2111111111111111
2705-2021_03_20_090102.jpg,bike,28,297,640,41,360,316,4,325,357,LTAdatasets/2705/annotate/2705-2021_03_20_090102.jpg,311.0,336.5,0.4859375,0.9347222222222222,0.04375,0.11388888888888889
2705-2021_03_20_090102.jpg,car,12,220,640,10,360,60,1,232,70,LTAdatasets/2705/annotate/2705-2021_03_20_090102.jpg,226.0,65.0,0.353125,0.18055555555555555,0.01875,0.027777777777777776
2705-2021_03_20_094305.jpg,car,82,482,640,73,360,256,1,564,329,LTAdatasets/2705/annotate/2705-2021_03_20_094305.jpg,523.0,292.5,0.8171875,0.8125,0.128125,0.20277777777777778
2705-2021_03_20_094305.jpg,car,26,428,640,19,360,105,1,454,124,LTAdatasets/2705/annotate/2705-2021_03_20_094305.jpg,441.0,114.5,0.6890625,0.31805555555555554,0.040625,0.05277777777777778
2705-2021_03_20_094305.jpg,lorry_truck,37,455,640,37,360,66,2,492,103,LTAdatasets/2705/annotate/2705-2021_03_20_094305.jpg,473.5,84.5,0.73984375,0.23472222222222222,0.0578125,0.10277777777777777
2705-2021_03_20_094305.jpg,lorry_truck,17,188,640,23,360,55,2,205,78,LTAdatasets/2705/annotate/2705-2021_03_20_094305.jpg,196.5,66.5,0.30703125,0.18472222222222223,0.0265625,0.06388888888888888
2705-2021_03_20_094305.jpg,van,18,198,640,16,360,87,3,216,103,LTAdatasets/2705/annotate/2705-2021_03_20_094305.jpg,207.0,95.0,0.3234375,0.2638888888888889,0.028125,0.044444444444444446
2705-2021_03_20_094305.jpg,car,15,222,640,15,360,71,1,237,86,LTAdatasets/2705/annotate/2705-2021_03_20_094305.jpg,229.5,78.5,0.35859375,0.21805555555555556,0.0234375,0.041666666666666664
2705-2021_03_20_094305.jpg,car,26,286,640,19,360,107,1,312,126,LTAdatasets/2705/annotate/2705-2021_03_20_094305.jpg,299.0,116.5,0.4671875,0.3236111111111111,0.040625,0.05277777777777778
2705-2021_03_20_094305.jpg,car,11,247,640,11,360,68,1,258,79,LTAdatasets/2705/annotate/2705-2021_03_20_094305.jpg,252.5,73.5,0.39453125,0.20416666666666666,0.0171875,0.030555555555555555
2705-2021_03_20_081319.jpg,car,38,340,640,29,360,145,1,378,174,LTAdatasets/2705/annotate/2705-2021_03_20_081319.jpg,359.0,159.5,0.5609375,0.44305555555555554,0.059375,0.08055555555555556
2705-2021_03_20_081319.jpg,car,28,236,640,18,360,95,1,264,113,LTAdatasets/2705/annotate/2705-2021_03_20_081319.jpg,250.0,104.0,0.390625,0.28888888888888886,0.04375,0.05
2705-2021_03_20_081319.jpg,car,25,266,640,17,360,85,1,291,102,LTAdatasets/2705/annotate/2705-2021_03_20_081319.jpg,278.5,93.5,0.43515625,0.25972222222222224,0.0390625,0.04722222222222222
2705-2021_03_20_081319.jpg,bike,14,207,640,18,360,89,4,221,107,LTAdatasets/2705/annotate/2705-2021_03_20_081319.jpg,214.0,98.0,0.334375,0.2722222222222222,0.021875,0.05
2705-2021_03_20_081319.jpg,lorry_truck,35,205,640,44,360,119,2,240,163,LTAdatasets/2705/annotate/2705-2021_03_20_081319.jpg,222.5,141.0,0.34765625,0.39166666666666666,0.0546875,0.12222222222222222
2705-2021_03_20_081319.jpg,car,12,249,640,15,360,62,1,261,77,LTAdatasets/2705/annotate/2705-2021_03_20_081319.jpg,255.0,69.5,0.3984375,0.19305555555555556,0.01875,0.041666666666666664
2705-2021_03_20_085501.jpg,car,52,325,640,47,360,197,1,377,244,LTAdatasets/2705/annotate/2705-2021_03_20_085501.jpg,351.0,220.5,0.5484375,0.6125,0.08125,0.13055555555555556
2705-2021_03_20_085501.jpg,car,42,488,640,28,360,107,1,530,135,LTAdatasets/2705/annotate/2705-2021_03_20_085501.jpg,509.0,121.0,0.7953125,0.33611111111111114,0.065625,0.07777777777777778
2705-2021_03_20_085501.jpg,car,27,296,640,25,360,113,1,323,138,LTAdatasets/2705/annotate/2705-2021_03_20_085501.jpg,309.5,125.5,0.48359375,0.3486111111111111,0.0421875,0.06944444444444445
2705-2021_03_20_085501.jpg,bike,9,230,640,16,360,70,4,239,86,LTAdatasets/2705/annotate/2705-2021_03_20_085501.jpg,234.5,78.0,0.36640625,0.21666666666666667,0.0140625,0.044444444444444446
2705-2021_03_20_085501.jpg,car,15,232,640,13,360,54,1,247,67,LTAdatasets/2705/annotate/2705-2021_03_20_085501.jpg,239.5,60.5,0.37421875,0.16805555555555557,0.0234375,0.03611111111111111
2705-2021_03_20_085501.jpg,van,11,212,640,13,360,61,3,223,74,LTAdatasets/2705/annotate/2705-2021_03_20_085501.jpg,217.5,67.5,0.33984375,0.1875,0.0171875,0.03611111111111111
2705-2021_03_20_085501.jpg,lorry_truck,91,236,640,102,360,258,2,327,360,LTAdatasets/2705/annotate/2705-2021_03_20_085501.jpg,281.5,309.0,0.43984375,0.8583333333333333,0.1421875,0.2833333333333333
2705-2021_03_20_193115.jpg,lorry_truck,61,287,640,64,360,133,2,348,197,LTAdatasets/2705/annotate/2705-2021_03_20_193115.jpg,317.5,165.0,0.49609375,0.4583333333333333,0.0953125,0.17777777777777778
2705-2021_03_20_193115.jpg,lorry_truck,100,339,640,109,360,212,2,439,321,LTAdatasets/2705/annotate/2705-2021_03_20_193115.jpg,389.0,266.5,0.6078125,0.7402777777777778,0.15625,0.30277777777777776
2705-2021_03_20_193115.jpg,car,61,370,640,36,360,167,1,431,203,LTAdatasets/2705/annotate/2705-2021_03_20_193115.jpg,400.5,185.0,0.62578125,0.5138888888888888,0.0953125,0.1
2705-2021_03_20_193115.jpg,car,28,422,640,23,360,72,1,450,95,LTAdatasets/2705/annotate/2705-2021_03_20_193115.jpg,436.0,83.5,0.68125,0.23194444444444445,0.04375,0.06388888888888888
2705-2021_03_20_193115.jpg,car,29,210,640,27,360,136,1,239,163,LTAdatasets/2705/annotate/2705-2021_03_20_193115.jpg,224.5,149.5,0.35078125,0.4152777777777778,0.0453125,0.075
2705-2021_03_20_193115.jpg,car,21,295,640,19,360,102,1,316,121,LTAdatasets/2705/annotate/2705-2021_03_20_193115.jpg,305.5,111.5,0.47734375,0.30972222222222223,0.0328125,0.05277777777777778
2705-2021_03_20_193115.jpg,car,24,262,640,17,360,81,1,286,98,LTAdatasets/2705/annotate/2705-2021_03_20_193115.jpg,274.0,89.5,0.428125,0.24861111111111112,0.0375,0.04722222222222222
2705-2021_03_20_193115.jpg,car,19,198,640,13,360,74,1,217,87,LTAdatasets/2705/annotate/2705-2021_03_20_193115.jpg,207.5,80.5,0.32421875,0.22361111111111112,0.0296875,0.03611111111111111
2705-2021_03_20_193115.jpg,car,15,219,640,14,360,64,1,234,78,LTAdatasets/2705/annotate/2705-2021_03_20_193115.jpg,226.5,71.0,0.35390625,0.19722222222222222,0.0234375,0.03888888888888889
2705-2021_03_20_193115.jpg,van,22,572,640,30,360,115,3,594,145,LTAdatasets/2705/annotate/2705-2021_03_20_193115.jpg,583.0,130.0,0.9109375,0.3611111111111111,0.034375,0.08333333333333333
2705-2021_03_20_193115.jpg,lorry_truck,15,207,640,18,360,49,2,222,67,LTAdatasets/2705/annotate/2705-2021_03_20_193115.jpg,214.5,58.0,0.33515625,0.16111111111111112,0.0234375,0.05
2705-2021_03_20_083120.jpg,car,62,391,640,44,360,186,1,453,230,LTAdatasets/2705/annotate/2705-2021_03_20_083120.jpg,422.0,208.0,0.659375,0.5777777777777777,0.096875,0.12222222222222222
2705-2021_03_20_083120.jpg,bike,15,268,640,22,360,105,4,283,127,LTAdatasets/2705/annotate/2705-2021_03_20_083120.jpg,275.5,116.0,0.43046875,0.32222222222222224,0.0234375,0.06111111111111111
2705-2021_03_20_083120.jpg,bike,14,235,640,18,360,77,4,249,95,LTAdatasets/2705/annotate/2705-2021_03_20_083120.jpg,242.0,86.0,0.378125,0.2388888888888889,0.021875,0.05
2705-2021_03_20_083120.jpg,car,11,209,640,10,360,56,1,220,66,LTAdatasets/2705/annotate/2705-2021_03_20_083120.jpg,214.5,61.0,0.33515625,0.16944444444444445,0.0171875,0.027777777777777776
2705-2021_03_20_083120.jpg,van,14,237,640,15,360,54,3,251,69,LTAdatasets/2705/annotate/2705-2021_03_20_083120.jpg,244.0,61.5,0.38125,0.17083333333333334,0.021875,0.041666666666666664
2705-2021_03_20_183112.jpg,van,46,298,640,35,360,157,3,344,192,LTAdatasets/2705/annotate/2705-2021_03_20_183112.jpg,321.0,174.5,0.5015625,0.4847222222222222,0.071875,0.09722222222222222
2705-2021_03_20_183112.jpg,bus,55,459,640,31,360,77,5,514,108,LTAdatasets/2705/annotate/2705-2021_03_20_183112.jpg,486.5,92.5,0.76015625,0.2569444444444444,0.0859375,0.08611111111111111
2705-2021_03_20_183112.jpg,bus,16,183,640,26,360,37,5,199,63,LTAdatasets/2705/annotate/2705-2021_03_20_183112.jpg,191.0,50.0,0.2984375,0.1388888888888889,0.025,0.07222222222222222
2705-2021_03_20_183112.jpg,lorry_truck,18,194,640,25,360,64,2,212,89,LTAdatasets/2705/annotate/2705-2021_03_20_183112.jpg,203.0,76.5,0.3171875,0.2125,0.028125,0.06944444444444445
2705-2021_03_20_183112.jpg,car,20,238,640,8,360,65,1,258,73,LTAdatasets/2705/annotate/2705-2021_03_20_183112.jpg,248.0,69.0,0.3875,0.19166666666666668,0.03125,0.022222222222222223
2705-2021_03_20_183112.jpg,car,27,384,640,16,360,73,1,411,89,LTAdatasets/2705/annotate/2705-2021_03_20_183112.jpg,397.5,81.0,0.62109375,0.225,0.0421875,0.044444444444444446
2705-2021_03_20_183112.jpg,car,17,378,640,14,360,59,1,395,73,LTAdatasets/2705/annotate/2705-2021_03_20_183112.jpg,386.5,66.0,0.60390625,0.18333333333333332,0.0265625,0.03888888888888889
2705-2021_03_20_183112.jpg,car,57,412,640,45,360,203,1,469,248,LTAdatasets/2705/annotate/2705-2021_03_20_183112.jpg,440.5,225.5,0.68828125,0.6263888888888889,0.0890625,0.125
2705-2021_03_20_183112.jpg,car,40,512,640,28,360,116,1,552,144,LTAdatasets/2705/annotate/2705-2021_03_20_183112.jpg,532.0,130.0,0.83125,0.3611111111111111,0.0625,0.07777777777777778
2705-2021_03_20_183112.jpg,bike,17,461,640,20,360,113,4,478,133,LTAdatasets/2705/annotate/2705-2021_03_20_183112.jpg,469.5,123.0,0.73359375,0.3416666666666667,0.0265625,0.05555555555555555
2705-2021_03_20_184913.jpg,car,76,371,640,78,360,263,1,447,341,LTAdatasets/2705/annotate/2705-2021_03_20_184913.jpg,409.0,302.0,0.6390625,0.8388888888888889,0.11875,0.21666666666666667
2705-2021_03_20_184913.jpg,car,40,465,640,32,360,115,1,505,147,LTAdatasets/2705/annotate/2705-2021_03_20_184913.jpg,485.0,131.0,0.7578125,0.3638888888888889,0.0625,0.08888888888888889
2705-2021_03_20_184913.jpg,car,21,234,640,14,360,91,1,255,105,LTAdatasets/2705/annotate/2705-2021_03_20_184913.jpg,244.5,98.0,0.38203125,0.2722222222222222,0.0328125,0.03888888888888889
2705-2021_03_20_184913.jpg,car,18,241,640,9,360,69,1,259,78,LTAdatasets/2705/annotate/2705-2021_03_20_184913.jpg,250.0,73.5,0.390625,0.20416666666666666,0.028125,0.025
2705-2021_03_20_184913.jpg,car,17,225,640,7,360,51,1,242,58,LTAdatasets/2705/annotate/2705-2021_03_20_184913.jpg,233.5,54.5,0.36484375,0.15138888888888888,0.0265625,0.019444444444444445
2705-2021_03_20_184913.jpg,car,10,191,640,7,360,57,1,201,64,LTAdatasets/2705/annotate/2705-2021_03_20_184913.jpg,196.0,60.5,0.30625,0.16805555555555557,0.015625,0.019444444444444445
2705-2021_03_20_184913.jpg,lorry_truck,29,186,640,31,360,77,2,215,108,LTAdatasets/2705/annotate/2705-2021_03_20_184913.jpg,200.5,92.5,0.31328125,0.2569444444444444,0.0453125,0.08611111111111111
2705-2021_03_20_192515.jpg,lorry_truck,66,248,640,90,360,229,2,314,319,LTAdatasets/2705/annotate/2705-2021_03_20_192515.jpg,281.0,274.0,0.4390625,0.7611111111111111,0.103125,0.25
2705-2021_03_20_192515.jpg,car,23,279,640,19,360,95,1,302,114,LTAdatasets/2705/annotate/2705-2021_03_20_192515.jpg,290.5,104.5,0.45390625,0.2902777777777778,0.0359375,0.05277777777777778
2705-2021_03_20_192515.jpg,car,38,268,640,31,360,140,1,306,171,LTAdatasets/2705/annotate/2705-2021_03_20_192515.jpg,287.0,155.5,0.4484375,0.43194444444444446,0.059375,0.08611111111111111
2705-2021_03_20_192515.jpg,car,21,401,640,12,360,69,1,422,81,LTAdatasets/2705/annotate/2705-2021_03_20_192515.jpg,411.5,75.0,0.64296875,0.20833333333333334,0.0328125,0.03333333333333333
2705-2021_03_20_192515.jpg,car,15,212,640,9,360,61,1,227,70,LTAdatasets/2705/annotate/2705-2021_03_20_192515.jpg,219.5,65.5,0.34296875,0.18194444444444444,0.0234375,0.025
2705-2021_03_20_192515.jpg,car,11,208,640,11,360,52,1,219,63,LTAdatasets/2705/annotate/2705-2021_03_20_192515.jpg,213.5,57.5,0.33359375,0.1597222222222222,0.0171875,0.030555555555555555
2705-2021_03_20_192515.jpg,lorry_truck,11,190,640,13,360,56,2,201,69,LTAdatasets/2705/annotate/2705-2021_03_20_192515.jpg,195.5,62.5,0.30546875,0.1736111111111111,0.0171875,0.03611111111111111
2705-2021_03_20_192735.jpg,bus,45,189,640,65,360,74,5,234,139,LTAdatasets/2705/annotate/2705-2021_03_20_192735.jpg,211.5,106.5,0.33046875,0.29583333333333334,0.0703125,0.18055555555555555
2705-2021_03_20_195136.jpg,car,54,289,640,33,360,172,1,343,205,LTAdatasets/2705/annotate/2705-2021_03_20_195136.jpg,316.0,188.5,0.49375,0.5236111111111111,0.084375,0.09166666666666666
2705-2021_03_20_195136.jpg,car,37,458,640,33,360,117,1,495,150,LTAdatasets/2705/annotate/2705-2021_03_20_195136.jpg,476.5,133.5,0.74453125,0.37083333333333335,0.0578125,0.09166666666666666
2705-2021_03_20_195136.jpg,car,29,409,640,18,360,70,1,438,88,LTAdatasets/2705/annotate/2705-2021_03_20_195136.jpg,423.5,79.0,0.66171875,0.21944444444444444,0.0453125,0.05
2705-2021_03_20_195136.jpg,car,22,236,640,21,360,88,1,258,109,LTAdatasets/2705/annotate/2705-2021_03_20_195136.jpg,247.0,98.5,0.3859375,0.27361111111111114,0.034375,0.058333333333333334
2705-2021_03_20_195136.jpg,car,18,244,640,9,360,65,1,262,74,LTAdatasets/2705/annotate/2705-2021_03_20_195136.jpg,253.0,69.5,0.3953125,0.19305555555555556,0.028125,0.025
2705-2021_03_20_195136.jpg,car,14,213,640,10,360,57,1,227,67,LTAdatasets/2705/annotate/2705-2021_03_20_195136.jpg,220.0,62.0,0.34375,0.17222222222222222,0.021875,0.027777777777777776
2705-2021_03_20_195136.jpg,car,11,195,640,9,360,66,1,206,75,LTAdatasets/2705/annotate/2705-2021_03_20_195136.jpg,200.5,70.5,0.31328125,0.19583333333333333,0.0171875,0.025
2705-2021_03_20_195136.jpg,car,11,233,640,9,360,55,1,244,64,LTAdatasets/2705/annotate/2705-2021_03_20_195136.jpg,238.5,59.5,0.37265625,0.16527777777777777,0.0171875,0.025
2705-2021_03_20_190413.jpg,bike,37,417,640,52,360,263,4,454,315,LTAdatasets/2705/annotate/2705-2021_03_20_190413.jpg,435.5,289.0,0.68046875,0.8027777777777778,0.0578125,0.14444444444444443
2705-2021_03_20_190413.jpg,car,51,243,640,50,360,219,1,294,269,LTAdatasets/2705/annotate/2705-2021_03_20_190413.jpg,268.5,244.0,0.41953125,0.6777777777777778,0.0796875,0.1388888888888889
2705-2021_03_20_190413.jpg,car,27,209,640,23,360,121,1,236,144,LTAdatasets/2705/annotate/2705-2021_03_20_190413.jpg,222.5,132.5,0.34765625,0.3680555555555556,0.0421875,0.06388888888888888
2705-2021_03_20_190413.jpg,car,18,194,640,12,360,83,1,212,95,LTAdatasets/2705/annotate/2705-2021_03_20_190413.jpg,203.0,89.0,0.3171875,0.24722222222222223,0.028125,0.03333333333333333
2705-2021_03_20_190413.jpg,car,11,248,640,14,360,66,1,259,80,LTAdatasets/2705/annotate/2705-2021_03_20_190413.jpg,253.5,73.0,0.39609375,0.20277777777777778,0.0171875,0.03888888888888889
2705-2021_03_20_190413.jpg,van,16,221,640,18,360,69,3,237,87,LTAdatasets/2705/annotate/2705-2021_03_20_190413.jpg,229.0,78.0,0.3578125,0.21666666666666667,0.025,0.05
2705-2021_03_20_190413.jpg,van,27,254,640,24,360,112,3,281,136,LTAdatasets/2705/annotate/2705-2021_03_20_190413.jpg,267.5,124.0,0.41796875,0.34444444444444444,0.0421875,0.06666666666666667
2705-2021_03_20_190413.jpg,van,14,194,640,15,360,65,3,208,80,LTAdatasets/2705/annotate/2705-2021_03_20_190413.jpg,201.0,72.5,0.3140625,0.2013888888888889,0.021875,0.041666666666666664
2705-2021_03_20_190413.jpg,van,16,372,640,14,360,60,3,388,74,LTAdatasets/2705/annotate/2705-2021_03_20_190413.jpg,380.0,67.0,0.59375,0.18611111111111112,0.025,0.03888888888888889
2705-2021_03_20_190413.jpg,lorry_truck,57,529,640,26,360,116,2,586,142,LTAdatasets/2705/annotate/2705-2021_03_20_190413.jpg,557.5,129.0,0.87109375,0.35833333333333334,0.0890625,0.07222222222222222
2705-2021_03_20_073937.jpg,bus,49,383,640,35,360,48,5,432,83,LTAdatasets/2705/annotate/2705-2021_03_20_073937.jpg,407.5,65.5,0.63671875,0.18194444444444444,0.0765625,0.09722222222222222
2705-2021_03_20_073937.jpg,car,15,219,640,11,360,68,1,234,79,LTAdatasets/2705/annotate/2705-2021_03_20_073937.jpg,226.5,73.5,0.35390625,0.20416666666666666,0.0234375,0.030555555555555555
2705-2021_03_20_082440.jpg,car,32,393,640,17,360,76,1,425,93,LTAdatasets/2705/annotate/2705-2021_03_20_082440.jpg,409.0,84.5,0.6390625,0.23472222222222222,0.05,0.04722222222222222
2705-2021_03_20_082440.jpg,car,68,361,640,73,360,235,1,429,308,LTAdatasets/2705/annotate/2705-2021_03_20_082440.jpg,395.0,271.5,0.6171875,0.7541666666666667,0.10625,0.20277777777777778
2705-2021_03_20_082440.jpg,car,43,356,640,41,360,152,1,399,193,LTAdatasets/2705/annotate/2705-2021_03_20_082440.jpg,377.5,172.5,0.58984375,0.4791666666666667,0.0671875,0.11388888888888889
2705-2021_03_20_082440.jpg,van,37,266,640,29,360,133,3,303,162,LTAdatasets/2705/annotate/2705-2021_03_20_082440.jpg,284.5,147.5,0.44453125,0.4097222222222222,0.0578125,0.08055555555555556
2705-2021_03_20_082440.jpg,lorry_truck,26,245,640,23,360,101,2,271,124,LTAdatasets/2705/annotate/2705-2021_03_20_082440.jpg,258.0,112.5,0.403125,0.3125,0.040625,0.06388888888888888
2705-2021_03_20_082440.jpg,lorry_truck,23,201,640,26,360,99,2,224,125,LTAdatasets/2705/annotate/2705-2021_03_20_082440.jpg,212.5,112.0,0.33203125,0.3111111111111111,0.0359375,0.07222222222222222
2705-2021_03_20_082440.jpg,car,21,261,640,16,360,79,1,282,95,LTAdatasets/2705/annotate/2705-2021_03_20_082440.jpg,271.5,87.0,0.42421875,0.24166666666666667,0.0328125,0.044444444444444446
2705-2021_03_20_082440.jpg,car,17,228,640,14,360,76,1,245,90,LTAdatasets/2705/annotate/2705-2021_03_20_082440.jpg,236.5,83.0,0.36953125,0.23055555555555557,0.0265625,0.03888888888888889
2705-2021_03_20_082440.jpg,bike,8,239,640,12,360,63,4,247,75,LTAdatasets/2705/annotate/2705-2021_03_20_082440.jpg,243.0,69.0,0.3796875,0.19166666666666668,0.0125,0.03333333333333333
2705-2021_03_20_082440.jpg,car,11,213,640,12,360,62,1,224,74,LTAdatasets/2705/annotate/2705-2021_03_20_082440.jpg,218.5,68.0,0.34140625,0.18888888888888888,0.0171875,0.03333333333333333
2705-2021_03_20_082440.jpg,car,10,235,640,7,360,56,1,245,63,LTAdatasets/2705/annotate/2705-2021_03_20_082440.jpg,240.0,59.5,0.375,0.16527777777777777,0.015625,0.019444444444444445
2705-2021_03_20_082440.jpg,car,11,210,640,8,360,55,1,221,63,LTAdatasets/2705/annotate/2705-2021_03_20_082440.jpg,215.5,59.0,0.33671875,0.1638888888888889,0.0171875,0.022222222222222223
2705-2021_03_20_080719.jpg,car,43,368,640,35,360,158,1,411,193,LTAdatasets/2705/annotate/2705-2021_03_20_080719.jpg,389.5,175.5,0.60859375,0.4875,0.0671875,0.09722222222222222
2705-2021_03_20_080719.jpg,van,69,342,640,55,360,235,3,411,290,LTAdatasets/2705/annotate/2705-2021_03_20_080719.jpg,376.5,262.5,0.58828125,0.7291666666666666,0.1078125,0.1527777777777778
2705-2021_03_20_080719.jpg,car,43,293,640,45,360,151,1,336,196,LTAdatasets/2705/annotate/2705-2021_03_20_080719.jpg,314.5,173.5,0.49140625,0.48194444444444445,0.0671875,0.125
2705-2021_03_20_080719.jpg,car,20,236,640,17,360,95,1,256,112,LTAdatasets/2705/annotate/2705-2021_03_20_080719.jpg,246.0,103.5,0.384375,0.2875,0.03125,0.04722222222222222
2705-2021_03_20_080719.jpg,car,17,243,640,12,360,65,1,260,77,LTAdatasets/2705/annotate/2705-2021_03_20_080719.jpg,251.5,71.0,0.39296875,0.19722222222222222,0.0265625,0.03333333333333333
2705-2021_03_20_080719.jpg,car,23,201,640,20,360,103,1,224,123,LTAdatasets/2705/annotate/2705-2021_03_20_080719.jpg,212.5,113.0,0.33203125,0.3138888888888889,0.0359375,0.05555555555555555
2705-2021_03_20_080719.jpg,lorry_truck,18,216,640,13,360,68,2,234,81,LTAdatasets/2705/annotate/2705-2021_03_20_080719.jpg,225.0,74.5,0.3515625,0.20694444444444443,0.028125,0.03611111111111111
2705-2021_03_20_080719.jpg,car,11,213,640,9,360,56,1,224,65,LTAdatasets/2705/annotate/2705-2021_03_20_080719.jpg,218.5,60.5,0.34140625,0.16805555555555557,0.0171875,0.025
2705-2021_03_20_080719.jpg,car,13,189,640,10,360,55,1,202,65,LTAdatasets/2705/annotate/2705-2021_03_20_080719.jpg,195.5,60.0,0.30546875,0.16666666666666666,0.0203125,0.027777777777777776
2705-2021_03_20_202217.jpg,car,44,330,640,35,360,145,1,374,180,LTAdatasets/2705/annotate/2705-2021_03_20_202217.jpg,352.0,162.5,0.55,0.4513888888888889,0.06875,0.09722222222222222
2705-2021_03_20_202217.jpg,car,41,548,640,17,360,126,1,589,143,LTAdatasets/2705/annotate/2705-2021_03_20_202217.jpg,568.5,134.5,0.88828125,0.3736111111111111,0.0640625,0.04722222222222222
2705-2021_03_20_202217.jpg,car,28,399,640,16,360,75,1,427,91,LTAdatasets/2705/annotate/2705-2021_03_20_202217.jpg,413.0,83.0,0.6453125,0.23055555555555557,0.04375,0.044444444444444446
2705-2021_03_20_202217.jpg,car,23,376,640,20,360,83,1,399,103,LTAdatasets/2705/annotate/2705-2021_03_20_202217.jpg,387.5,93.0,0.60546875,0.25833333333333336,0.0359375,0.05555555555555555
2705-2021_03_20_202217.jpg,lorry_truck,20,193,640,18,360,61,2,213,79,LTAdatasets/2705/annotate/2705-2021_03_20_202217.jpg,203.0,70.0,0.3171875,0.19444444444444445,0.03125,0.05
2705-2021_03_20_202217.jpg,bus,62,430,640,49,360,51,5,492,100,LTAdatasets/2705/annotate/2705-2021_03_20_202217.jpg,461.0,75.5,0.7203125,0.20972222222222223,0.096875,0.1361111111111111
2705-2021_03_20_202217.jpg,car,18,228,640,11,360,55,1,246,66,LTAdatasets/2705/annotate/2705-2021_03_20_202217.jpg,237.0,60.5,0.3703125,0.16805555555555557,0.028125,0.030555555555555555
2705-2021_03_20_200937.jpg,car,19,229,640,10,360,83,1,248,93,LTAdatasets/2705/annotate/2705-2021_03_20_200937.jpg,238.5,88.0,0.37265625,0.24444444444444444,0.0296875,0.027777777777777776
2705-2021_03_20_200937.jpg,car,33,427,640,18,360,75,1,460,93,LTAdatasets/2705/annotate/2705-2021_03_20_200937.jpg,443.5,84.0,0.69296875,0.23333333333333334,0.0515625,0.05
2705-2021_03_20_200937.jpg,car,18,372,640,12,360,60,1,390,72,LTAdatasets/2705/annotate/2705-2021_03_20_200937.jpg,381.0,66.0,0.5953125,0.18333333333333332,0.028125,0.03333333333333333
2705-2021_03_20_200937.jpg,car,16,239,640,12,360,61,1,255,73,LTAdatasets/2705/annotate/2705-2021_03_20_200937.jpg,247.0,67.0,0.3859375,0.18611111111111112,0.025,0.03333333333333333
2705-2021_03_20_200937.jpg,car,15,207,640,9,360,60,1,222,69,LTAdatasets/2705/annotate/2705-2021_03_20_200937.jpg,214.5,64.5,0.33515625,0.17916666666666667,0.0234375,0.025
2705-2021_03_20_094605.jpg,car,61,323,640,58,360,187,1,384,245,LTAdatasets/2705/annotate/2705-2021_03_20_094605.jpg,353.5,216.0,0.55234375,0.6,0.0953125,0.16111111111111112
2705-2021_03_20_094605.jpg,van,119,421,640,57,360,303,3,540,360,LTAdatasets/2705/annotate/2705-2021_03_20_094605.jpg,480.5,331.5,0.75078125,0.9208333333333333,0.1859375,0.15833333333333333
2705-2021_03_20_094605.jpg,car,43,498,640,30,360,104,1,541,134,LTAdatasets/2705/annotate/2705-2021_03_20_094605.jpg,519.5,119.0,0.81171875,0.33055555555555555,0.0671875,0.08333333333333333
2705-2021_03_20_094605.jpg,car,22,247,640,20,360,99,1,269,119,LTAdatasets/2705/annotate/2705-2021_03_20_094605.jpg,258.0,109.0,0.403125,0.30277777777777776,0.034375,0.05555555555555555
2705-2021_03_20_094605.jpg,car,14,252,640,14,360,72,1,266,86,LTAdatasets/2705/annotate/2705-2021_03_20_094605.jpg,259.0,79.0,0.4046875,0.21944444444444444,0.021875,0.03888888888888889
2705-2021_03_20_094605.jpg,van,17,225,640,14,360,79,3,242,93,LTAdatasets/2705/annotate/2705-2021_03_20_094605.jpg,233.5,86.0,0.36484375,0.2388888888888889,0.0265625,0.03888888888888889
2705-2021_03_20_094605.jpg,car,14,219,640,8,360,73,1,233,81,LTAdatasets/2705/annotate/2705-2021_03_20_094605.jpg,226.0,77.0,0.353125,0.21388888888888888,0.021875,0.022222222222222223
2705-2021_03_20_094605.jpg,lorry_truck,69,200,640,130,360,111,2,269,241,LTAdatasets/2705/annotate/2705-2021_03_20_094605.jpg,234.5,176.0,0.36640625,0.4888888888888889,0.1078125,0.3611111111111111
2705-2021_03_20_203658.jpg,lorry_truck,74,516,640,46,360,96,2,590,142,LTAdatasets/2705/annotate/2705-2021_03_20_203658.jpg,553.0,119.0,0.8640625,0.33055555555555555,0.115625,0.12777777777777777
2705-2021_03_20_203658.jpg,car,26,257,640,13,360,76,1,283,89,LTAdatasets/2705/annotate/2705-2021_03_20_203658.jpg,270.0,82.5,0.421875,0.22916666666666666,0.040625,0.03611111111111111
2705-2021_03_20_203658.jpg,car,24,388,640,15,360,63,1,412,78,LTAdatasets/2705/annotate/2705-2021_03_20_203658.jpg,400.0,70.5,0.625,0.19583333333333333,0.0375,0.041666666666666664
2705-2021_03_20_203658.jpg,car,19,209,640,12,360,58,1,228,70,LTAdatasets/2705/annotate/2705-2021_03_20_203658.jpg,218.5,64.0,0.34140625,0.17777777777777778,0.0296875,0.03333333333333333
2705-2021_03_20_183952.jpg,car,42,296,640,44,360,162,1,338,206,LTAdatasets/2705/annotate/2705-2021_03_20_183952.jpg,317.0,184.0,0.4953125,0.5111111111111111,0.065625,0.12222222222222222
2705-2021_03_20_183952.jpg,car,26,323,640,31,360,122,1,349,153,LTAdatasets/2705/annotate/2705-2021_03_20_183952.jpg,336.0,137.5,0.525,0.3819444444444444,0.040625,0.08611111111111111
2705-2021_03_20_183952.jpg,car,26,245,640,27,360,114,1,271,141,LTAdatasets/2705/annotate/2705-2021_03_20_183952.jpg,258.0,127.5,0.403125,0.3541666666666667,0.040625,0.075
2705-2021_03_20_183952.jpg,car,18,278,640,13,360,93,1,296,106,LTAdatasets/2705/annotate/2705-2021_03_20_183952.jpg,287.0,99.5,0.4484375,0.2763888888888889,0.028125,0.03611111111111111
2705-2021_03_20_183952.jpg,car,19,224,640,17,360,81,1,243,98,LTAdatasets/2705/annotate/2705-2021_03_20_183952.jpg,233.5,89.5,0.36484375,0.24861111111111112,0.0296875,0.04722222222222222
2705-2021_03_20_183952.jpg,car,14,249,640,14,360,68,1,263,82,LTAdatasets/2705/annotate/2705-2021_03_20_183952.jpg,256.0,75.0,0.4,0.20833333333333334,0.021875,0.03888888888888889
2705-2021_03_20_183952.jpg,car,16,210,640,11,360,62,1,226,73,LTAdatasets/2705/annotate/2705-2021_03_20_183952.jpg,218.0,67.5,0.340625,0.1875,0.025,0.030555555555555555
2705-2021_03_20_183952.jpg,van,55,538,640,31,360,118,3,593,149,LTAdatasets/2705/annotate/2705-2021_03_20_183952.jpg,565.5,133.5,0.88359375,0.37083333333333335,0.0859375,0.08611111111111111
2705-2021_03_20_183952.jpg,bike,13,527,640,17,360,97,4,540,114,LTAdatasets/2705/annotate/2705-2021_03_20_183952.jpg,533.5,105.5,0.83359375,0.29305555555555557,0.0203125,0.04722222222222222
2705-2021_03_20_183952.jpg,bike,11,190,640,13,360,58,4,201,71,LTAdatasets/2705/annotate/2705-2021_03_20_183952.jpg,195.5,64.5,0.30546875,0.17916666666666667,0.0171875,0.03611111111111111
2705-2021_03_20_183952.jpg,bike,7,215,640,9,360,50,4,222,59,LTAdatasets/2705/annotate/2705-2021_03_20_183952.jpg,218.5,54.5,0.34140625,0.15138888888888888,0.0109375,0.025
2705-2021_03_20_183952.jpg,car,9,229,640,8,360,54,1,238,62,LTAdatasets/2705/annotate/2705-2021_03_20_183952.jpg,233.5,58.0,0.36484375,0.16111111111111112,0.0140625,0.022222222222222223
2705-2021_03_20_073037.jpg,car,20,244,640,12,360,67,1,264,79,LTAdatasets/2705/annotate/2705-2021_03_20_073037.jpg,254.0,73.0,0.396875,0.20277777777777778,0.03125,0.03333333333333333
2705-2021_03_20_073037.jpg,lorry_truck,24,245,640,26,360,96,2,269,122,LTAdatasets/2705/annotate/2705-2021_03_20_073037.jpg,257.0,109.0,0.4015625,0.30277777777777776,0.0375,0.07222222222222222
2705-2021_03_20_073037.jpg,lorry_truck,16,185,640,23,360,58,2,201,81,LTAdatasets/2705/annotate/2705-2021_03_20_073037.jpg,193.0,69.5,0.3015625,0.19305555555555556,0.025,0.06388888888888888
2705-2021_03_20_185753.jpg,lorry_truck,57,482,640,44,360,73,2,539,117,LTAdatasets/2705/annotate/2705-2021_03_20_185753.jpg,510.5,95.0,0.79765625,0.2638888888888889,0.0890625,0.12222222222222222
2705-2021_03_20_185753.jpg,lorry_truck,15,185,640,14,360,42,2,200,56,LTAdatasets/2705/annotate/2705-2021_03_20_185753.jpg,192.5,49.0,0.30078125,0.1361111111111111,0.0234375,0.03888888888888889
2705-2021_03_20_185753.jpg,car,10,214,640,10,360,58,1,224,68,LTAdatasets/2705/annotate/2705-2021_03_20_185753.jpg,219.0,63.0,0.3421875,0.175,0.015625,0.027777777777777776
2705-2021_03_20_185753.jpg,car,12,233,640,7,360,57,1,245,64,LTAdatasets/2705/annotate/2705-2021_03_20_185753.jpg,239.0,60.5,0.3734375,0.16805555555555557,0.01875,0.019444444444444445
2705-2021_03_20_185753.jpg,car,58,532,640,24,360,125,1,590,149,LTAdatasets/2705/annotate/2705-2021_03_20_185753.jpg,561.0,137.0,0.8765625,0.38055555555555554,0.090625,0.06666666666666667
2705-2021_03_20_181011.jpg,car,54,295,640,29,360,191,1,349,220,LTAdatasets/2705/annotate/2705-2021_03_20_181011.jpg,322.0,205.5,0.503125,0.5708333333333333,0.084375,0.08055555555555556
2705-2021_03_20_181011.jpg,car,55,434,640,51,360,204,1,489,255,LTAdatasets/2705/annotate/2705-2021_03_20_181011.jpg,461.5,229.5,0.72109375,0.6375,0.0859375,0.14166666666666666
2705-2021_03_20_181011.jpg,car,21,242,640,16,360,106,1,263,122,LTAdatasets/2705/annotate/2705-2021_03_20_181011.jpg,252.5,114.0,0.39453125,0.31666666666666665,0.0328125,0.044444444444444446
2705-2021_03_20_181011.jpg,car,17,243,640,8,360,69,1,260,77,LTAdatasets/2705/annotate/2705-2021_03_20_181011.jpg,251.5,73.0,0.39296875,0.20277777777777778,0.0265625,0.022222222222222223
2705-2021_03_20_181011.jpg,car,12,186,640,17,360,68,1,198,85,LTAdatasets/2705/annotate/2705-2021_03_20_181011.jpg,192.0,76.5,0.3,0.2125,0.01875,0.04722222222222222
2705-2021_03_20_181011.jpg,lorry_truck,50,228,640,66,360,181,2,278,247,LTAdatasets/2705/annotate/2705-2021_03_20_181011.jpg,253.0,214.0,0.3953125,0.5944444444444444,0.078125,0.18333333333333332
2705-2021_03_20_181011.jpg,van,16,211,640,14,360,61,3,227,75,LTAdatasets/2705/annotate/2705-2021_03_20_181011.jpg,219.0,68.0,0.3421875,0.18888888888888888,0.025,0.03888888888888889
2705-2021_03_20_181011.jpg,car,14,234,640,9,360,56,1,248,65,LTAdatasets/2705/annotate/2705-2021_03_20_181011.jpg,241.0,60.5,0.3765625,0.16805555555555557,0.021875,0.025
2705-2021_03_20_100105.jpg,lorry_truck,31,385,640,30,360,45,2,416,75,LTAdatasets/2705/annotate/2705-2021_03_20_100105.jpg,400.5,60.0,0.62578125,0.16666666666666666,0.0484375,0.08333333333333333
2705-2021_03_20_100105.jpg,car,19,247,640,15,360,67,1,266,82,LTAdatasets/2705/annotate/2705-2021_03_20_100105.jpg,256.5,74.5,0.40078125,0.20694444444444443,0.0296875,0.041666666666666664
2705-2021_03_20_100105.jpg,car,17,220,640,11,360,74,1,237,85,LTAdatasets/2705/annotate/2705-2021_03_20_100105.jpg,228.5,79.5,0.35703125,0.22083333333333333,0.0265625,0.030555555555555555
2705-2021_03_20_100105.jpg,car,49,306,640,33,360,178,1,355,211,LTAdatasets/2705/annotate/2705-2021_03_20_100105.jpg,330.5,194.5,0.51640625,0.5402777777777777,0.0765625,0.09166666666666666
2705-2021_03_20_100105.jpg,car,25,362,640,10,360,79,1,387,89,LTAdatasets/2705/annotate/2705-2021_03_20_100105.jpg,374.5,84.0,0.58515625,0.23333333333333334,0.0390625,0.027777777777777776
2705-2021_03_20_084601.jpg,car,81,414,640,44,360,316,1,495,360,LTAdatasets/2705/annotate/2705-2021_03_20_084601.jpg,454.5,338.0,0.71015625,0.9388888888888889,0.1265625,0.12222222222222222
2705-2021_03_20_084601.jpg,car,51,418,640,45,360,193,1,469,238,LTAdatasets/2705/annotate/2705-2021_03_20_084601.jpg,443.5,215.5,0.69296875,0.5986111111111111,0.0796875,0.125
2705-2021_03_20_084601.jpg,car,24,284,640,15,360,96,1,308,111,LTAdatasets/2705/annotate/2705-2021_03_20_084601.jpg,296.0,103.5,0.4625,0.2875,0.0375,0.041666666666666664
2705-2021_03_20_084601.jpg,car,14,259,640,16,360,76,1,273,92,LTAdatasets/2705/annotate/2705-2021_03_20_084601.jpg,266.0,84.0,0.415625,0.23333333333333334,0.021875,0.044444444444444446
2705-2021_03_20_084601.jpg,car,13,222,640,7,360,72,1,235,79,LTAdatasets/2705/annotate/2705-2021_03_20_084601.jpg,228.5,75.5,0.35703125,0.20972222222222223,0.0203125,0.019444444444444445
2705-2021_03_20_084601.jpg,car,11,197,640,13,360,72,1,208,85,LTAdatasets/2705/annotate/2705-2021_03_20_084601.jpg,202.5,78.5,0.31640625,0.21805555555555556,0.0171875,0.03611111111111111
2705-2021_03_20_084601.jpg,lorry_truck,25,199,640,33,360,92,2,224,125,LTAdatasets/2705/annotate/2705-2021_03_20_084601.jpg,211.5,108.5,0.33046875,0.3013888888888889,0.0390625,0.09166666666666666
2705-2021_03_20_084601.jpg,lorry_truck,28,381,640,25,360,53,2,409,78,LTAdatasets/2705/annotate/2705-2021_03_20_084601.jpg,395.0,65.5,0.6171875,0.18194444444444444,0.04375,0.06944444444444445
2705-2021_03_20_084601.jpg,van,30,262,640,28,360,117,3,292,145,LTAdatasets/2705/annotate/2705-2021_03_20_084601.jpg,277.0,131.0,0.4328125,0.3638888888888889,0.046875,0.07777777777777778
2705-2021_03_20_084601.jpg,bike,9,241,640,15,360,69,4,250,84,LTAdatasets/2705/annotate/2705-2021_03_20_084601.jpg,245.5,76.5,0.38359375,0.2125,0.0140625,0.041666666666666664
2705-2021_03_20_084601.jpg,car,18,229,640,8,360,57,1,247,65,LTAdatasets/2705/annotate/2705-2021_03_20_084601.jpg,238.0,61.0,0.371875,0.16944444444444445,0.028125,0.022222222222222223
2705-2021_03_20_084601.jpg,lorry_truck,12,189,640,14,360,59,2,201,73,LTAdatasets/2705/annotate/2705-2021_03_20_084601.jpg,195.0,66.0,0.3046875,0.18333333333333332,0.01875,0.03888888888888889
2705-2021_03_20_075818.jpg,bus,52,383,640,43,360,42,5,435,85,LTAdatasets/2705/annotate/2705-2021_03_20_075818.jpg,409.0,63.5,0.6390625,0.1763888888888889,0.08125,0.11944444444444445
2705-2021_03_20_075818.jpg,car,47,370,640,36,360,169,1,417,205,LTAdatasets/2705/annotate/2705-2021_03_20_075818.jpg,393.5,187.0,0.61484375,0.5194444444444445,0.0734375,0.1
2705-2021_03_20_075818.jpg,car,26,292,640,20,360,104,1,318,124,LTAdatasets/2705/annotate/2705-2021_03_20_075818.jpg,305.0,114.0,0.4765625,0.31666666666666665,0.040625,0.05555555555555555
2705-2021_03_20_075818.jpg,lorry_truck,37,225,640,43,360,140,2,262,183,LTAdatasets/2705/annotate/2705-2021_03_20_075818.jpg,243.5,161.5,0.38046875,0.4486111111111111,0.0578125,0.11944444444444445
2705-2021_03_20_075818.jpg,van,25,248,640,21,360,108,3,273,129,LTAdatasets/2705/annotate/2705-2021_03_20_075818.jpg,260.5,118.5,0.40703125,0.32916666666666666,0.0390625,0.058333333333333334
2705-2021_03_20_075818.jpg,van,20,231,640,18,360,83,3,251,101,LTAdatasets/2705/annotate/2705-2021_03_20_075818.jpg,241.0,92.0,0.3765625,0.25555555555555554,0.03125,0.05
2705-2021_03_20_075818.jpg,car,9,247,640,13,360,61,1,256,74,LTAdatasets/2705/annotate/2705-2021_03_20_075818.jpg,251.5,67.5,0.39296875,0.1875,0.0140625,0.03611111111111111
2705-2021_03_20_075818.jpg,lorry_truck,16,216,640,21,360,54,2,232,75,LTAdatasets/2705/annotate/2705-2021_03_20_075818.jpg,224.0,64.5,0.35,0.17916666666666667,0.025,0.058333333333333334
2705-2021_03_20_075818.jpg,lorry_truck,18,189,640,20,360,54,2,207,74,LTAdatasets/2705/annotate/2705-2021_03_20_075818.jpg,198.0,64.0,0.309375,0.17777777777777778,0.028125,0.05555555555555555
2705-2021_03_20_080939.jpg,car,18,247,640,18,360,102,1,265,120,LTAdatasets/2705/annotate/2705-2021_03_20_080939.jpg,256.0,111.0,0.4,0.30833333333333335,0.028125,0.05
2705-2021_03_20_092543.jpg,lorry_truck,45,503,640,44,360,76,2,548,120,LTAdatasets/2705/annotate/2705-2021_03_20_092543.jpg,525.5,98.0,0.82109375,0.2722222222222222,0.0703125,0.12222222222222222
2705-2021_03_20_092543.jpg,lorry_truck,52,213,640,88,360,140,2,265,228,LTAdatasets/2705/annotate/2705-2021_03_20_092543.jpg,239.0,184.0,0.3734375,0.5111111111111111,0.08125,0.24444444444444444
2705-2021_03_20_092543.jpg,lorry_truck,33,186,640,37,360,68,2,219,105,LTAdatasets/2705/annotate/2705-2021_03_20_092543.jpg,202.5,86.5,0.31640625,0.24027777777777778,0.0515625,0.10277777777777777
2705-2021_03_20_092543.jpg,car,28,243,640,14,360,101,1,271,115,LTAdatasets/2705/annotate/2705-2021_03_20_092543.jpg,257.0,108.0,0.4015625,0.3,0.04375,0.03888888888888889
2705-2021_03_20_092543.jpg,car,33,302,640,22,360,112,1,335,134,LTAdatasets/2705/annotate/2705-2021_03_20_092543.jpg,318.5,123.0,0.49765625,0.3416666666666667,0.0515625,0.06111111111111111
2705-2021_03_20_092543.jpg,car,32,285,640,30,360,137,1,317,167,LTAdatasets/2705/annotate/2705-2021_03_20_092543.jpg,301.0,152.0,0.4703125,0.4222222222222222,0.05,0.08333333333333333
2705-2021_03_20_092543.jpg,car,84,344,640,71,360,241,1,428,312,LTAdatasets/2705/annotate/2705-2021_03_20_092543.jpg,386.0,276.5,0.603125,0.7680555555555556,0.13125,0.19722222222222222
2705-2021_03_20_092543.jpg,car,13,238,640,9,360,62,1,251,71,LTAdatasets/2705/annotate/2705-2021_03_20_092543.jpg,244.5,66.5,0.38203125,0.18472222222222223,0.0203125,0.025
2705-2021_03_20_092543.jpg,lorry_truck,13,190,640,12,360,55,2,203,67,LTAdatasets/2705/annotate/2705-2021_03_20_092543.jpg,196.5,61.0,0.30703125,0.16944444444444445,0.0203125,0.03333333333333333
2705-2021_03_20_082220.jpg,car,77,451,640,57,360,235,1,528,292,LTAdatasets/2705/annotate/2705-2021_03_20_082220.jpg,489.5,263.5,0.76484375,0.7319444444444444,0.1203125,0.15833333333333333
2705-2021_03_20_082220.jpg,car,18,292,640,24,360,100,1,310,124,LTAdatasets/2705/annotate/2705-2021_03_20_082220.jpg,301.0,112.0,0.4703125,0.3111111111111111,0.028125,0.06666666666666667
2705-2021_03_20_082220.jpg,van,32,252,640,29,360,115,3,284,144,LTAdatasets/2705/annotate/2705-2021_03_20_082220.jpg,268.0,129.5,0.41875,0.3597222222222222,0.05,0.08055555555555556
2705-2021_03_20_082220.jpg,lorry_truck,9,194,640,15,360,62,2,203,77,LTAdatasets/2705/annotate/2705-2021_03_20_082220.jpg,198.5,69.5,0.31015625,0.19305555555555556,0.0140625,0.041666666666666664
2705-2021_03_20_085141.jpg,lorry_truck,74,248,640,83,360,235,2,322,318,LTAdatasets/2705/annotate/2705-2021_03_20_085141.jpg,285.0,276.5,0.4453125,0.7680555555555556,0.115625,0.23055555555555557
2705-2021_03_20_085141.jpg,lorry_truck,42,525,640,45,360,86,2,567,131,LTAdatasets/2705/annotate/2705-2021_03_20_085141.jpg,546.0,108.5,0.853125,0.3013888888888889,0.065625,0.125
2705-2021_03_20_085141.jpg,lorry_truck,30,379,640,31,360,48,2,409,79,LTAdatasets/2705/annotate/2705-2021_03_20_085141.jpg,394.0,63.5,0.615625,0.1763888888888889,0.046875,0.08611111111111111
2705-2021_03_20_085141.jpg,car,39,345,640,31,360,150,1,384,181,LTAdatasets/2705/annotate/2705-2021_03_20_085141.jpg,364.5,165.5,0.56953125,0.4597222222222222,0.0609375,0.08611111111111111
2705-2021_03_20_085141.jpg,car,38,279,640,28,360,140,1,317,168,LTAdatasets/2705/annotate/2705-2021_03_20_085141.jpg,298.0,154.0,0.465625,0.42777777777777776,0.059375,0.07777777777777778
2705-2021_03_20_085141.jpg,van,39,225,640,44,360,175,3,264,219,LTAdatasets/2705/annotate/2705-2021_03_20_085141.jpg,244.5,197.0,0.38203125,0.5472222222222223,0.0609375,0.12222222222222222
2705-2021_03_20_085141.jpg,lorry_truck,27,202,640,31,360,103,2,229,134,LTAdatasets/2705/annotate/2705-2021_03_20_085141.jpg,215.5,118.5,0.33671875,0.32916666666666666,0.0421875,0.08611111111111111
2705-2021_03_20_085141.jpg,bike,15,249,640,18,360,68,4,264,86,LTAdatasets/2705/annotate/2705-2021_03_20_085141.jpg,256.5,77.0,0.40078125,0.21388888888888888,0.0234375,0.05
2705-2021_03_20_085141.jpg,car,18,222,640,13,360,75,1,240,88,LTAdatasets/2705/annotate/2705-2021_03_20_085141.jpg,231.0,81.5,0.3609375,0.2263888888888889,0.028125,0.03611111111111111
2705-2021_03_20_085141.jpg,car,17,210,640,9,360,66,1,227,75,LTAdatasets/2705/annotate/2705-2021_03_20_085141.jpg,218.5,70.5,0.34140625,0.19583333333333333,0.0265625,0.025
2705-2021_03_20_085141.jpg,lorry_truck,11,186,640,15,360,58,2,197,73,LTAdatasets/2705/annotate/2705-2021_03_20_085141.jpg,191.5,65.5,0.29921875,0.18194444444444444,0.0171875,0.041666666666666664
2705-2021_03_20_183712.jpg,car,25,404,640,21,360,92,1,429,113,LTAdatasets/2705/annotate/2705-2021_03_20_183712.jpg,416.5,102.5,0.65078125,0.2847222222222222,0.0390625,0.058333333333333334
2705-2021_03_20_183712.jpg,car,23,405,640,16,360,80,1,428,96,LTAdatasets/2705/annotate/2705-2021_03_20_183712.jpg,416.5,88.0,0.65078125,0.24444444444444444,0.0359375,0.044444444444444446
2705-2021_03_20_183712.jpg,bike,19,540,640,27,360,112,4,559,139,LTAdatasets/2705/annotate/2705-2021_03_20_183712.jpg,549.5,125.5,0.85859375,0.3486111111111111,0.0296875,0.075
2705-2021_03_20_183712.jpg,van,49,312,640,52,360,181,3,361,233,LTAdatasets/2705/annotate/2705-2021_03_20_183712.jpg,336.5,207.0,0.52578125,0.575,0.0765625,0.14444444444444443
2705-2021_03_20_183712.jpg,car,70,460,640,60,360,233,1,530,293,LTAdatasets/2705/annotate/2705-2021_03_20_183712.jpg,495.0,263.0,0.7734375,0.7305555555555555,0.109375,0.16666666666666666
2705-2021_03_20_183712.jpg,car,60,267,640,62,360,298,1,327,360,LTAdatasets/2705/annotate/2705-2021_03_20_183712.jpg,297.0,329.0,0.4640625,0.9138888888888889,0.09375,0.17222222222222222
2705-2021_03_20_183712.jpg,car,23,235,640,21,360,93,1,258,114,LTAdatasets/2705/annotate/2705-2021_03_20_183712.jpg,246.5,103.5,0.38515625,0.2875,0.0359375,0.058333333333333334
2705-2021_03_20_183712.jpg,car,20,214,640,14,360,68,1,234,82,LTAdatasets/2705/annotate/2705-2021_03_20_183712.jpg,224.0,75.0,0.35,0.20833333333333334,0.03125,0.03888888888888889
2705-2021_03_20_183712.jpg,car,14,190,640,9,360,63,1,204,72,LTAdatasets/2705/annotate/2705-2021_03_20_183712.jpg,197.0,67.5,0.3078125,0.1875,0.021875,0.025
2705-2021_03_20_183712.jpg,bus,70,402,640,49,360,42,5,472,91,LTAdatasets/2705/annotate/2705-2021_03_20_183712.jpg,437.0,66.5,0.6828125,0.18472222222222223,0.109375,0.1361111111111111
2705-2021_03_20_073417.jpg,bus,104,275,640,103,360,136,5,379,239,LTAdatasets/2705/annotate/2705-2021_03_20_073417.jpg,327.0,187.5,0.5109375,0.5208333333333334,0.1625,0.2861111111111111
2705-2021_03_20_073417.jpg,lorry_truck,29,203,640,43,360,108,2,232,151,LTAdatasets/2705/annotate/2705-2021_03_20_073417.jpg,217.5,129.5,0.33984375,0.3597222222222222,0.0453125,0.11944444444444445
2705-2021_03_20_073417.jpg,car,36,474,640,24,360,91,1,510,115,LTAdatasets/2705/annotate/2705-2021_03_20_073417.jpg,492.0,103.0,0.76875,0.2861111111111111,0.05625,0.06666666666666667
2705-2021_03_20_073417.jpg,car,27,380,640,15,360,85,1,407,100,LTAdatasets/2705/annotate/2705-2021_03_20_073417.jpg,393.5,92.5,0.61484375,0.2569444444444444,0.0421875,0.041666666666666664
2705-2021_03_20_073417.jpg,lorry_truck,15,228,640,17,360,77,2,243,94,LTAdatasets/2705/annotate/2705-2021_03_20_073417.jpg,235.5,85.5,0.36796875,0.2375,0.0234375,0.04722222222222222
2705-2021_03_20_073417.jpg,car,15,241,640,10,360,62,1,256,72,LTAdatasets/2705/annotate/2705-2021_03_20_073417.jpg,248.5,67.0,0.38828125,0.18611111111111112,0.0234375,0.027777777777777776
2705-2021_03_20_073417.jpg,lorry_truck,18,184,640,18,360,52,2,202,70,LTAdatasets/2705/annotate/2705-2021_03_20_073417.jpg,193.0,61.0,0.3015625,0.16944444444444445,0.028125,0.05
2705-2021_03_20_084901.jpg,car,73,479,640,65,360,246,1,552,311,LTAdatasets/2705/annotate/2705-2021_03_20_084901.jpg,515.5,278.5,0.80546875,0.7736111111111111,0.1140625,0.18055555555555555
2705-2021_03_20_084901.jpg,car,63,348,640,54,360,233,1,411,287,LTAdatasets/2705/annotate/2705-2021_03_20_084901.jpg,379.5,260.0,0.59296875,0.7222222222222222,0.0984375,0.15
2705-2021_03_20_084901.jpg,car,24,292,640,19,360,100,1,316,119,LTAdatasets/2705/annotate/2705-2021_03_20_084901.jpg,304.0,109.5,0.475,0.30416666666666664,0.0375,0.05277777777777778
2705-2021_03_20_084901.jpg,car,28,246,640,17,360,113,1,274,130,LTAdatasets/2705/annotate/2705-2021_03_20_084901.jpg,260.0,121.5,0.40625,0.3375,0.04375,0.04722222222222222
2705-2021_03_20_084901.jpg,bike,19,338,640,30,360,154,4,357,184,LTAdatasets/2705/annotate/2705-2021_03_20_084901.jpg,347.5,169.0,0.54296875,0.46944444444444444,0.0296875,0.08333333333333333
2705-2021_03_20_084901.jpg,lorry_truck,19,190,640,18,360,62,2,209,80,LTAdatasets/2705/annotate/2705-2021_03_20_084901.jpg,199.5,71.0,0.31171875,0.19722222222222222,0.0296875,0.05
2705-2021_03_20_084901.jpg,van,10,216,640,10,360,62,3,226,72,LTAdatasets/2705/annotate/2705-2021_03_20_084901.jpg,221.0,67.0,0.3453125,0.18611111111111112,0.015625,0.027777777777777776
2705-2021_03_20_084901.jpg,lorry_truck,2,624,640,5,360,83,2,626,88,LTAdatasets/2705/annotate/2705-2021_03_20_084901.jpg,625.0,85.5,0.9765625,0.2375,0.003125,0.013888888888888888
2705-2021_03_20_084901.jpg,lorry_truck,42,553,640,31,360,104,2,595,135,LTAdatasets/2705/annotate/2705-2021_03_20_084901.jpg,574.0,119.5,0.896875,0.33194444444444443,0.065625,0.08611111111111111
2705-2021_03_20_095205.jpg,car,43,494,640,35,360,127,1,537,162,LTAdatasets/2705/annotate/2705-2021_03_20_095205.jpg,515.5,144.5,0.80546875,0.4013888888888889,0.0671875,0.09722222222222222
2705-2021_03_20_095205.jpg,lorry_truck,24,575,640,34,360,108,2,599,142,LTAdatasets/2705/annotate/2705-2021_03_20_095205.jpg,587.0,125.0,0.9171875,0.3472222222222222,0.0375,0.09444444444444444
2705-2021_03_20_095205.jpg,van,54,313,640,49,360,185,3,367,234,LTAdatasets/2705/annotate/2705-2021_03_20_095205.jpg,340.0,209.5,0.53125,0.5819444444444445,0.084375,0.1361111111111111
2705-2021_03_20_095205.jpg,car,111,529,640,81,360,275,1,640,356,LTAdatasets/2705/annotate/2705-2021_03_20_095205.jpg,584.5,315.5,0.91328125,0.8763888888888889,0.1734375,0.225
2705-2021_03_20_095205.jpg,car,22,296,640,19,360,97,1,318,116,LTAdatasets/2705/annotate/2705-2021_03_20_095205.jpg,307.0,106.5,0.4796875,0.29583333333333334,0.034375,0.05277777777777778
2705-2021_03_20_095205.jpg,van,29,234,640,19,360,101,3,263,120,LTAdatasets/2705/annotate/2705-2021_03_20_095205.jpg,248.5,110.5,0.38828125,0.30694444444444446,0.0453125,0.05277777777777778
2705-2021_03_20_095205.jpg,car,17,227,640,12,360,78,1,244,90,LTAdatasets/2705/annotate/2705-2021_03_20_095205.jpg,235.5,84.0,0.36796875,0.23333333333333334,0.0265625,0.03333333333333333
2705-2021_03_20_095205.jpg,van,14,213,640,12,360,60,3,227,72,LTAdatasets/2705/annotate/2705-2021_03_20_095205.jpg,220.0,66.0,0.34375,0.18333333333333332,0.021875,0.03333333333333333
2705-2021_03_20_095205.jpg,lorry_truck,39,270,640,42,360,117,2,309,159,LTAdatasets/2705/annotate/2705-2021_03_20_095205.jpg,289.5,138.0,0.45234375,0.38333333333333336,0.0609375,0.11666666666666667
2705-2021_03_20_180710.jpg,car,41,474,640,35,360,123,1,515,158,LTAdatasets/2705/annotate/2705-2021_03_20_180710.jpg,494.5,140.5,0.77265625,0.3902777777777778,0.0640625,0.09722222222222222
2705-2021_03_20_180710.jpg,car,46,508,640,31,360,108,1,554,139,LTAdatasets/2705/annotate/2705-2021_03_20_180710.jpg,531.0,123.5,0.8296875,0.34305555555555556,0.071875,0.08611111111111111
2705-2021_03_20_180710.jpg,bus,56,395,640,48,360,43,5,451,91,LTAdatasets/2705/annotate/2705-2021_03_20_180710.jpg,423.0,67.0,0.6609375,0.18611111111111112,0.0875,0.13333333333333333
2705-2021_03_20_200416.jpg,car,28,301,640,28,360,112,1,329,140,LTAdatasets/2705/annotate/2705-2021_03_20_200416.jpg,315.0,126.0,0.4921875,0.35,0.04375,0.07777777777777778
2705-2021_03_20_200416.jpg,car,30,405,640,26,360,74,1,435,100,LTAdatasets/2705/annotate/2705-2021_03_20_200416.jpg,420.0,87.0,0.65625,0.24166666666666667,0.046875,0.07222222222222222
2705-2021_03_20_180410.jpg,lorry_truck,39,481,640,51,360,83,2,520,134,LTAdatasets/2705/annotate/2705-2021_03_20_180410.jpg,500.5,108.5,0.78203125,0.3013888888888889,0.0609375,0.14166666666666666
2705-2021_03_20_180410.jpg,bike,20,508,640,31,360,131,4,528,162,LTAdatasets/2705/annotate/2705-2021_03_20_180410.jpg,518.0,146.5,0.809375,0.40694444444444444,0.03125,0.08611111111111111
2705-2021_03_20_180410.jpg,bike,18,403,640,23,360,86,4,421,109,LTAdatasets/2705/annotate/2705-2021_03_20_180410.jpg,412.0,97.5,0.64375,0.2708333333333333,0.028125,0.06388888888888888
2705-2021_03_20_180410.jpg,car,26,257,640,19,360,112,1,283,131,LTAdatasets/2705/annotate/2705-2021_03_20_180410.jpg,270.0,121.5,0.421875,0.3375,0.040625,0.05277777777777778
2705-2021_03_20_180410.jpg,car,29,222,640,25,360,145,1,251,170,LTAdatasets/2705/annotate/2705-2021_03_20_180410.jpg,236.5,157.5,0.36953125,0.4375,0.0453125,0.06944444444444445
2705-2021_03_20_180410.jpg,van,44,279,640,31,360,150,3,323,181,LTAdatasets/2705/annotate/2705-2021_03_20_180410.jpg,301.0,165.5,0.4703125,0.4597222222222222,0.06875,0.08611111111111111
2705-2021_03_20_180410.jpg,car,94,503,640,87,360,266,1,597,353,LTAdatasets/2705/annotate/2705-2021_03_20_180410.jpg,550.0,309.5,0.859375,0.8597222222222223,0.146875,0.24166666666666667
2705-2021_03_20_180410.jpg,car,21,226,640,14,360,85,1,247,99,LTAdatasets/2705/annotate/2705-2021_03_20_180410.jpg,236.5,92.0,0.36953125,0.25555555555555554,0.0328125,0.03888888888888889
2705-2021_03_20_180410.jpg,car,22,250,640,14,360,70,1,272,84,LTAdatasets/2705/annotate/2705-2021_03_20_180410.jpg,261.0,77.0,0.4078125,0.21388888888888888,0.034375,0.03888888888888889
2705-2021_03_20_180410.jpg,lorry_truck,19,192,640,20,360,74,2,211,94,LTAdatasets/2705/annotate/2705-2021_03_20_180410.jpg,201.5,84.0,0.31484375,0.23333333333333334,0.0296875,0.05555555555555555
2705-2021_03_20_180410.jpg,car,15,210,640,10,360,57,1,225,67,LTAdatasets/2705/annotate/2705-2021_03_20_180410.jpg,217.5,62.0,0.33984375,0.17222222222222222,0.0234375,0.027777777777777776
2705-2021_03_20_180410.jpg,lorry_truck,68,539,640,36,360,99,2,607,135,LTAdatasets/2705/annotate/2705-2021_03_20_180410.jpg,573.0,117.0,0.8953125,0.325,0.10625,0.1
2705-2021_03_20_085822.jpg,van,30,443,640,23,360,87,3,473,110,LTAdatasets/2705/annotate/2705-2021_03_20_085822.jpg,458.0,98.5,0.715625,0.27361111111111114,0.046875,0.06388888888888888
2705-2021_03_20_085822.jpg,car,12,231,640,7,360,55,1,243,62,LTAdatasets/2705/annotate/2705-2021_03_20_085822.jpg,237.0,58.5,0.3703125,0.1625,0.01875,0.019444444444444445
2705-2021_03_20_085822.jpg,car,8,191,640,7,360,60,1,199,67,LTAdatasets/2705/annotate/2705-2021_03_20_085822.jpg,195.0,63.5,0.3046875,0.1763888888888889,0.0125,0.019444444444444445
2705-2021_03_20_085822.jpg,car,12,211,640,14,360,55,1,223,69,LTAdatasets/2705/annotate/2705-2021_03_20_085822.jpg,217.0,62.0,0.3390625,0.17222222222222222,0.01875,0.03888888888888889
2705-2021_03_20_085822.jpg,lorry_truck,18,198,640,23,360,86,2,216,109,LTAdatasets/2705/annotate/2705-2021_03_20_085822.jpg,207.0,97.5,0.3234375,0.2708333333333333,0.028125,0.06388888888888888
2705-2021_03_20_085822.jpg,car,28,287,640,21,360,98,1,315,119,LTAdatasets/2705/annotate/2705-2021_03_20_085822.jpg,301.0,108.5,0.4703125,0.3013888888888889,0.04375,0.058333333333333334
2705-2021_03_20_085822.jpg,car,19,261,640,15,360,78,1,280,93,LTAdatasets/2705/annotate/2705-2021_03_20_085822.jpg,270.5,85.5,0.42265625,0.2375,0.0296875,0.041666666666666664
2705-2021_03_20_085822.jpg,car,25,236,640,22,360,100,1,261,122,LTAdatasets/2705/annotate/2705-2021_03_20_085822.jpg,248.5,111.0,0.38828125,0.30833333333333335,0.0390625,0.06111111111111111
2705-2021_03_20_085822.jpg,car,54,312,640,40,360,200,1,366,240,LTAdatasets/2705/annotate/2705-2021_03_20_085822.jpg,339.0,220.0,0.5296875,0.6111111111111112,0.084375,0.1111111111111111
2705-2021_03_20_083640.jpg,bike,22,505,640,33,360,122,4,527,155,LTAdatasets/2705/annotate/2705-2021_03_20_083640.jpg,516.0,138.5,0.80625,0.38472222222222224,0.034375,0.09166666666666666
2705-2021_03_20_083640.jpg,van,16,193,640,18,360,70,3,209,88,LTAdatasets/2705/annotate/2705-2021_03_20_083640.jpg,201.0,79.0,0.3140625,0.21944444444444444,0.025,0.05
2705-2021_03_20_083640.jpg,lorry_truck,26,232,640,30,360,83,2,258,113,LTAdatasets/2705/annotate/2705-2021_03_20_083640.jpg,245.0,98.0,0.3828125,0.2722222222222222,0.040625,0.08333333333333333
2705-2021_03_20_083640.jpg,lorry_truck,68,309,640,69,360,186,2,377,255,LTAdatasets/2705/annotate/2705-2021_03_20_083640.jpg,343.0,220.5,0.5359375,0.6125,0.10625,0.19166666666666668
2705-2021_03_20_083640.jpg,car,29,315,640,26,360,113,1,344,139,LTAdatasets/2705/annotate/2705-2021_03_20_083640.jpg,329.5,126.0,0.51484375,0.35,0.0453125,0.07222222222222222
2705-2021_03_20_083640.jpg,car,23,277,640,14,360,94,1,300,108,LTAdatasets/2705/annotate/2705-2021_03_20_083640.jpg,288.5,101.0,0.45078125,0.28055555555555556,0.0359375,0.03888888888888889
2705-2021_03_20_083640.jpg,car,31,266,640,35,360,124,1,297,159,LTAdatasets/2705/annotate/2705-2021_03_20_083640.jpg,281.5,141.5,0.43984375,0.39305555555555555,0.0484375,0.09722222222222222
2705-2021_03_20_083640.jpg,car,18,248,640,11,360,70,1,266,81,LTAdatasets/2705/annotate/2705-2021_03_20_083640.jpg,257.0,75.5,0.4015625,0.20972222222222223,0.028125,0.030555555555555555
2705-2021_03_20_083640.jpg,car,12,229,640,9,360,52,1,241,61,LTAdatasets/2705/annotate/2705-2021_03_20_083640.jpg,235.0,56.5,0.3671875,0.15694444444444444,0.01875,0.025
2705-2021_03_20_195736.jpg,car,22,201,640,15,360,104,1,223,119,LTAdatasets/2705/annotate/2705-2021_03_20_195736.jpg,212.0,111.5,0.33125,0.30972222222222223,0.034375,0.041666666666666664
2705-2021_03_20_195736.jpg,car,30,269,640,24,360,125,1,299,149,LTAdatasets/2705/annotate/2705-2021_03_20_195736.jpg,284.0,137.0,0.44375,0.38055555555555554,0.046875,0.06666666666666667
2705-2021_03_20_195736.jpg,car,41,461,640,26,360,100,1,502,126,LTAdatasets/2705/annotate/2705-2021_03_20_195736.jpg,481.5,113.0,0.75234375,0.3138888888888889,0.0640625,0.07222222222222222
2705-2021_03_20_195736.jpg,bike,15,422,640,21,360,77,4,437,98,LTAdatasets/2705/annotate/2705-2021_03_20_195736.jpg,429.5,87.5,0.67109375,0.24305555555555555,0.0234375,0.058333333333333334
2705-2021_03_20_195736.jpg,bike,23,355,640,50,360,222,4,378,272,LTAdatasets/2705/annotate/2705-2021_03_20_195736.jpg,366.5,247.0,0.57265625,0.6861111111111111,0.0359375,0.1388888888888889
2705-2021_03_20_195736.jpg,car,55,417,640,62,360,190,1,472,252,LTAdatasets/2705/annotate/2705-2021_03_20_195736.jpg,444.5,221.0,0.69453125,0.6138888888888889,0.0859375,0.17222222222222222
2705-2021_03_20_195736.jpg,lorry_truck,82,231,640,112,360,192,2,313,304,LTAdatasets/2705/annotate/2705-2021_03_20_195736.jpg,272.0,248.0,0.425,0.6888888888888889,0.128125,0.3111111111111111
2705-2021_03_20_195736.jpg,car,19,230,640,13,360,79,1,249,92,LTAdatasets/2705/annotate/2705-2021_03_20_195736.jpg,239.5,85.5,0.37421875,0.2375,0.0296875,0.03611111111111111
2705-2021_03_20_195736.jpg,car,16,241,640,13,360,63,1,257,76,LTAdatasets/2705/annotate/2705-2021_03_20_195736.jpg,249.0,69.5,0.3890625,0.19305555555555556,0.025,0.03611111111111111
2705-2021_03_20_195736.jpg,car,18,227,640,9,360,53,1,245,62,LTAdatasets/2705/annotate/2705-2021_03_20_195736.jpg,236.0,57.5,0.36875,0.1597222222222222,0.028125,0.025
2705-2021_03_20_095505.jpg,car,35,462,640,28,360,116,1,497,144,LTAdatasets/2705/annotate/2705-2021_03_20_095505.jpg,479.5,130.0,0.74921875,0.3611111111111111,0.0546875,0.07777777777777778
2705-2021_03_20_095505.jpg,car,86,483,640,69,360,262,1,569,331,LTAdatasets/2705/annotate/2705-2021_03_20_095505.jpg,526.0,296.5,0.821875,0.8236111111111111,0.134375,0.19166666666666668
2705-2021_03_20_095505.jpg,lorry_truck,33,441,640,24,360,83,2,474,107,LTAdatasets/2705/annotate/2705-2021_03_20_095505.jpg,457.5,95.0,0.71484375,0.2638888888888889,0.0515625,0.06666666666666667
2705-2021_03_20_095505.jpg,lorry_truck,33,200,640,37,360,100,2,233,137,LTAdatasets/2705/annotate/2705-2021_03_20_095505.jpg,216.5,118.5,0.33828125,0.32916666666666666,0.0515625,0.10277777777777777
2705-2021_03_20_095505.jpg,lorry_truck,27,183,640,32,360,53,2,210,85,LTAdatasets/2705/annotate/2705-2021_03_20_095505.jpg,196.5,69.0,0.30703125,0.19166666666666668,0.0421875,0.08888888888888889
2705-2021_03_20_095505.jpg,van,18,226,640,20,360,70,3,244,90,LTAdatasets/2705/annotate/2705-2021_03_20_095505.jpg,235.0,80.0,0.3671875,0.2222222222222222,0.028125,0.05555555555555555
2705-2021_03_20_095505.jpg,van,23,266,640,18,360,81,3,289,99,LTAdatasets/2705/annotate/2705-2021_03_20_095505.jpg,277.5,90.0,0.43359375,0.25,0.0359375,0.05
2705-2021_03_20_190634.jpg,car,34,455,640,27,360,90,1,489,117,LTAdatasets/2705/annotate/2705-2021_03_20_190634.jpg,472.0,103.5,0.7375,0.2875,0.053125,0.075
2705-2021_03_20_190634.jpg,car,35,473,640,32,360,124,1,508,156,LTAdatasets/2705/annotate/2705-2021_03_20_190634.jpg,490.5,140.0,0.76640625,0.3888888888888889,0.0546875,0.08888888888888889
2705-2021_03_20_190634.jpg,car,22,380,640,14,360,71,1,402,85,LTAdatasets/2705/annotate/2705-2021_03_20_190634.jpg,391.0,78.0,0.6109375,0.21666666666666667,0.034375,0.03888888888888889
2705-2021_03_20_190634.jpg,car,22,278,640,23,360,87,1,300,110,LTAdatasets/2705/annotate/2705-2021_03_20_190634.jpg,289.0,98.5,0.4515625,0.27361111111111114,0.034375,0.06388888888888888
2705-2021_03_20_190634.jpg,car,22,237,640,16,360,95,1,259,111,LTAdatasets/2705/annotate/2705-2021_03_20_190634.jpg,248.0,103.0,0.3875,0.2861111111111111,0.034375,0.044444444444444446
2705-2021_03_20_190634.jpg,lorry_truck,61,538,640,43,360,95,2,599,138,LTAdatasets/2705/annotate/2705-2021_03_20_190634.jpg,568.5,116.5,0.88828125,0.3236111111111111,0.0953125,0.11944444444444445
2705-2021_03_20_201917.jpg,car,42,406,640,25,360,95,1,448,120,LTAdatasets/2705/annotate/2705-2021_03_20_201917.jpg,427.0,107.5,0.6671875,0.2986111111111111,0.065625,0.06944444444444445
2705-2021_03_20_201917.jpg,bus,30,188,640,40,360,68,5,218,108,LTAdatasets/2705/annotate/2705-2021_03_20_201917.jpg,203.0,88.0,0.3171875,0.24444444444444444,0.046875,0.1111111111111111
2705-2021_03_20_081920.jpg,lorry_truck,58,230,640,69,360,202,2,288,271,LTAdatasets/2705/annotate/2705-2021_03_20_081920.jpg,259.0,236.5,0.4046875,0.6569444444444444,0.090625,0.19166666666666668
2705-2021_03_20_081920.jpg,van,21,263,640,21,360,83,3,284,104,LTAdatasets/2705/annotate/2705-2021_03_20_081920.jpg,273.5,93.5,0.42734375,0.25972222222222224,0.0328125,0.058333333333333334
2705-2021_03_20_081920.jpg,car,15,222,640,14,360,76,1,237,90,LTAdatasets/2705/annotate/2705-2021_03_20_081920.jpg,229.5,83.0,0.35859375,0.23055555555555557,0.0234375,0.03888888888888889
2705-2021_03_20_081920.jpg,car,16,241,640,10,360,62,1,257,72,LTAdatasets/2705/annotate/2705-2021_03_20_081920.jpg,249.0,67.0,0.3890625,0.18611111111111112,0.025,0.027777777777777776
2705-2021_03_20_081920.jpg,car,12,190,640,8,360,62,1,202,70,LTAdatasets/2705/annotate/2705-2021_03_20_081920.jpg,196.0,66.0,0.30625,0.18333333333333332,0.01875,0.022222222222222223
2705-2021_03_20_080119.jpg,car,29,261,640,26,360,110,1,290,136,LTAdatasets/2705/annotate/2705-2021_03_20_080119.jpg,275.5,123.0,0.43046875,0.3416666666666667,0.0453125,0.07222222222222222
2705-2021_03_20_080119.jpg,car,18,221,640,10,360,74,1,239,84,LTAdatasets/2705/annotate/2705-2021_03_20_080119.jpg,230.0,79.0,0.359375,0.21944444444444444,0.028125,0.027777777777777776
2705-2021_03_20_080119.jpg,bike,15,433,640,17,360,96,4,448,113,LTAdatasets/2705/annotate/2705-2021_03_20_080119.jpg,440.5,104.5,0.68828125,0.2902777777777778,0.0234375,0.04722222222222222
2705-2021_03_20_080119.jpg,bike,8,375,640,14,360,66,4,383,80,LTAdatasets/2705/annotate/2705-2021_03_20_080119.jpg,379.0,73.0,0.5921875,0.20277777777777778,0.0125,0.03888888888888889
2705-2021_03_20_080119.jpg,lorry_truck,60,401,640,36,360,53,2,461,89,LTAdatasets/2705/annotate/2705-2021_03_20_080119.jpg,431.0,71.0,0.6734375,0.19722222222222222,0.09375,0.1
2705-2021_03_20_080119.jpg,car,25,441,640,18,360,90,1,466,108,LTAdatasets/2705/annotate/2705-2021_03_20_080119.jpg,453.5,99.0,0.70859375,0.275,0.0390625,0.05
2705-2021_03_20_080119.jpg,lorry_truck,15,188,640,20,360,54,2,203,74,LTAdatasets/2705/annotate/2705-2021_03_20_080119.jpg,195.5,64.0,0.30546875,0.17777777777777778,0.0234375,0.05555555555555555
2705-2021_03_20_080119.jpg,van,11,211,640,10,360,55,3,222,65,LTAdatasets/2705/annotate/2705-2021_03_20_080119.jpg,216.5,60.0,0.33828125,0.16666666666666666,0.0171875,0.027777777777777776
2705-2021_03_20_080119.jpg,bike,12,238,640,14,360,65,4,250,79,LTAdatasets/2705/annotate/2705-2021_03_20_080119.jpg,244.0,72.0,0.38125,0.2,0.01875,0.03888888888888889
2705-2021_03_20_200116.jpg,lorry_truck,34,203,640,34,360,117,2,237,151,LTAdatasets/2705/annotate/2705-2021_03_20_200116.jpg,220.0,134.0,0.34375,0.37222222222222223,0.053125,0.09444444444444444
2705-2021_03_20_200116.jpg,lorry_truck,39,443,640,27,360,69,2,482,96,LTAdatasets/2705/annotate/2705-2021_03_20_200116.jpg,462.5,82.5,0.72265625,0.22916666666666666,0.0609375,0.075
2705-2021_03_20_200116.jpg,bike,17,401,640,20,360,90,4,418,110,LTAdatasets/2705/annotate/2705-2021_03_20_200116.jpg,409.5,100.0,0.63984375,0.2777777777777778,0.0265625,0.05555555555555555
2705-2021_03_20_200116.jpg,van,42,516,640,28,360,114,3,558,142,LTAdatasets/2705/annotate/2705-2021_03_20_200116.jpg,537.0,128.0,0.8390625,0.35555555555555557,0.065625,0.07777777777777778
2705-2021_03_20_200116.jpg,car,26,401,640,19,360,63,1,427,82,LTAdatasets/2705/annotate/2705-2021_03_20_200116.jpg,414.0,72.5,0.646875,0.2013888888888889,0.040625,0.05277777777777778
2705-2021_03_20_200116.jpg,car,22,388,640,16,360,78,1,410,94,LTAdatasets/2705/annotate/2705-2021_03_20_200116.jpg,399.0,86.0,0.6234375,0.2388888888888889,0.034375,0.044444444444444446
2705-2021_03_20_094904.jpg,car,36,442,640,22,360,91,1,478,113,LTAdatasets/2705/annotate/2705-2021_03_20_094904.jpg,460.0,102.0,0.71875,0.2833333333333333,0.05625,0.06111111111111111
2705-2021_03_20_094904.jpg,van,58,343,640,57,360,199,3,401,256,LTAdatasets/2705/annotate/2705-2021_03_20_094904.jpg,372.0,227.5,0.58125,0.6319444444444444,0.090625,0.15833333333333333
2705-2021_03_20_094904.jpg,lorry_truck,61,228,640,75,360,181,2,289,256,LTAdatasets/2705/annotate/2705-2021_03_20_094904.jpg,258.5,218.5,0.40390625,0.6069444444444444,0.0953125,0.20833333333333334
2705-2021_03_20_094904.jpg,bus,26,186,640,37,360,55,5,212,92,LTAdatasets/2705/annotate/2705-2021_03_20_094904.jpg,199.0,73.5,0.3109375,0.20416666666666666,0.040625,0.10277777777777777
2705-2021_03_20_094904.jpg,car,15,216,640,14,360,63,1,231,77,LTAdatasets/2705/annotate/2705-2021_03_20_094904.jpg,223.5,70.0,0.34921875,0.19444444444444445,0.0234375,0.03888888888888889
2705-2021_03_20_094904.jpg,car,16,234,640,14,360,59,1,250,73,LTAdatasets/2705/annotate/2705-2021_03_20_094904.jpg,242.0,66.0,0.378125,0.18333333333333332,0.025,0.03888888888888889
1501-2021_03_20_190413.jpg,van,19,93,320,16,240,25,3,112,41,LTAdatasets/1501/annotate/1501-2021_03_20_190413.jpg,102.5,33.0,0.3203125,0.1375,0.059375,0.06666666666666667
1501-2021_03_20_190413.jpg,car,16,54,320,11,240,23,1,70,34,LTAdatasets/1501/annotate/1501-2021_03_20_190413.jpg,62.0,28.5,0.19375,0.11875,0.05,0.04583333333333333
1501-2021_03_20_091302.jpg,lorry_truck,21,61,320,19,240,22,2,82,41,LTAdatasets/1501/annotate/1501-2021_03_20_091302.jpg,71.5,31.5,0.2234375,0.13125,0.065625,0.07916666666666666
1501-2021_03_20_101005.jpg,lorry_truck,23,53,320,15,240,22,2,76,37,LTAdatasets/1501/annotate/1501-2021_03_20_101005.jpg,64.5,29.5,0.2015625,0.12291666666666666,0.071875,0.0625
1501-2021_03_20_211300.jpg,car,47,82,320,26,240,81,1,129,107,LTAdatasets/1501/annotate/1501-2021_03_20_211300.jpg,105.5,94.0,0.3296875,0.39166666666666666,0.146875,0.10833333333333334
1501-2021_03_20_183712.jpg,lorry_truck,31,120,320,31,240,23,2,151,54,LTAdatasets/1501/annotate/1501-2021_03_20_183712.jpg,135.5,38.5,0.4234375,0.16041666666666668,0.096875,0.12916666666666668
1501-2021_03_20_074318.jpg,car,46,122,320,78,240,91,1,168,169,LTAdatasets/1501/annotate/1501-2021_03_20_074318.jpg,145.0,130.0,0.453125,0.5416666666666666,0.14375,0.325
1501-2021_03_20_184913.jpg,car,14,52,320,10,240,25,1,66,35,LTAdatasets/1501/annotate/1501-2021_03_20_184913.jpg,59.0,30.0,0.184375,0.125,0.04375,0.041666666666666664
1501-2021_03_20_184913.jpg,car,15,69,320,9,240,23,1,84,32,LTAdatasets/1501/annotate/1501-2021_03_20_184913.jpg,76.5,27.5,0.2390625,0.11458333333333333,0.046875,0.0375
1501-2021_03_20_091903.jpg,car,17,58,320,12,240,27,1,75,39,LTAdatasets/1501/annotate/1501-2021_03_20_091903.jpg,66.5,33.0,0.2078125,0.1375,0.053125,0.05
1501-2021_03_20_080419.jpg,car,58,124,320,91,240,115,1,182,206,LTAdatasets/1501/annotate/1501-2021_03_20_080419.jpg,153.0,160.5,0.478125,0.66875,0.18125,0.37916666666666665
1501-2021_03_20_202758.jpg,car,48,121,320,78,240,105,1,169,183,LTAdatasets/1501/annotate/1501-2021_03_20_202758.jpg,145.0,144.0,0.453125,0.6,0.15,0.325
1501-2021_03_20_060933.jpg,car,17,53,320,8,240,24,1,70,32,LTAdatasets/1501/annotate/1501-2021_03_20_060933.jpg,61.5,28.0,0.1921875,0.11666666666666667,0.053125,0.03333333333333333
1501-2021_03_20_181251.jpg,lorry_truck,36,81,320,22,240,22,2,117,44,LTAdatasets/1501/annotate/1501-2021_03_20_181251.jpg,99.0,33.0,0.309375,0.1375,0.1125,0.09166666666666666
1501-2021_03_20_084901.jpg,bike,15,98,320,27,240,79,4,113,106,LTAdatasets/1501/annotate/1501-2021_03_20_084901.jpg,105.5,92.5,0.3296875,0.3854166666666667,0.046875,0.1125
1501-2021_03_20_213701.jpg,van,13,59,320,15,240,23,3,72,38,LTAdatasets/1501/annotate/1501-2021_03_20_213701.jpg,65.5,30.5,0.2046875,0.12708333333333333,0.040625,0.0625
1501-2021_03_20_213341.jpg,lorry_truck,59,160,320,38,240,32,2,219,70,LTAdatasets/1501/annotate/1501-2021_03_20_213341.jpg,189.5,51.0,0.5921875,0.2125,0.184375,0.15833333333333333
1501-2021_03_20_074918.jpg,lorry_truck,25,126,320,20,240,29,2,151,49,LTAdatasets/1501/annotate/1501-2021_03_20_074918.jpg,138.5,39.0,0.4328125,0.1625,0.078125,0.08333333333333333
1501-2021_03_20_082220.jpg,car,25,67,320,21,240,42,1,92,63,LTAdatasets/1501/annotate/1501-2021_03_20_082220.jpg,79.5,52.5,0.2484375,0.21875,0.078125,0.0875
1501-2021_03_20_211900.jpg,car,14,54,320,7,240,25,1,68,32,LTAdatasets/1501/annotate/1501-2021_03_20_211900.jpg,61.0,28.5,0.190625,0.11875,0.04375,0.029166666666666667
1501-2021_03_20_094305.jpg,car,30,148,320,22,240,40,1,178,62,LTAdatasets/1501/annotate/1501-2021_03_20_094305.jpg,163.0,51.0,0.509375,0.2125,0.09375,0.09166666666666666
1501-2021_03_20_100405.jpg,car,25,60,320,17,240,40,1,85,57,LTAdatasets/1501/annotate/1501-2021_03_20_100405.jpg,72.5,48.5,0.2265625,0.20208333333333334,0.078125,0.07083333333333333
1501-2021_03_20_073417.jpg,car,13,55,320,9,240,24,1,68,33,LTAdatasets/1501/annotate/1501-2021_03_20_073417.jpg,61.5,28.5,0.1921875,0.11875,0.040625,0.0375
1501-2021_03_20_212501.jpg,bike,12,67,320,22,240,36,4,79,58,LTAdatasets/1501/annotate/1501-2021_03_20_212501.jpg,73.0,47.0,0.228125,0.19583333333333333,0.0375,0.09166666666666666
1501-2021_03_20_181851.jpg,bike,8,79,320,11,240,20,4,87,31,LTAdatasets/1501/annotate/1501-2021_03_20_181851.jpg,83.0,25.5,0.259375,0.10625,0.025,0.04583333333333333
1501-2021_03_20_181851.jpg,car,17,64,320,17,240,30,1,81,47,LTAdatasets/1501/annotate/1501-2021_03_20_181851.jpg,72.5,38.5,0.2265625,0.16041666666666668,0.053125,0.07083333333333333
1501-2021_03_20_181851.jpg,car,9,52,320,7,240,25,1,61,32,LTAdatasets/1501/annotate/1501-2021_03_20_181851.jpg,56.5,28.5,0.1765625,0.11875,0.028125,0.029166666666666667
1501-2021_03_20_210940.jpg,lorry_truck,35,104,320,20,240,23,2,139,43,LTAdatasets/1501/annotate/1501-2021_03_20_210940.jpg,121.5,33.0,0.3796875,0.1375,0.109375,0.08333333333333333
1501-2021_03_20_210940.jpg,car,18,64,320,12,240,32,1,82,44,LTAdatasets/1501/annotate/1501-2021_03_20_210940.jpg,73.0,38.0,0.228125,0.15833333333333333,0.05625,0.05
1501-2021_03_20_210940.jpg,bike,9,89,320,15,240,27,4,98,42,LTAdatasets/1501/annotate/1501-2021_03_20_210940.jpg,93.5,34.5,0.2921875,0.14375,0.028125,0.0625
1501-2021_03_20_085822.jpg,car,39,65,320,35,240,63,1,104,98,LTAdatasets/1501/annotate/1501-2021_03_20_085822.jpg,84.5,80.5,0.2640625,0.33541666666666664,0.121875,0.14583333333333334
1501-2021_03_20_085822.jpg,car,24,131,320,15,240,36,1,155,51,LTAdatasets/1501/annotate/1501-2021_03_20_085822.jpg,143.0,43.5,0.446875,0.18125,0.075,0.0625
1501-2021_03_20_183412.jpg,car,26,65,320,24,240,50,1,91,74,LTAdatasets/1501/annotate/1501-2021_03_20_183412.jpg,78.0,62.0,0.24375,0.25833333333333336,0.08125,0.1
1501-2021_03_20_183412.jpg,car,19,67,320,14,240,32,1,86,46,LTAdatasets/1501/annotate/1501-2021_03_20_183412.jpg,76.5,39.0,0.2390625,0.1625,0.059375,0.058333333333333334
1501-2021_03_20_183412.jpg,lorry_truck,101,124,320,129,240,110,2,225,239,LTAdatasets/1501/annotate/1501-2021_03_20_183412.jpg,174.5,174.5,0.5453125,0.7270833333333333,0.315625,0.5375
1501-2021_03_20_202437.jpg,car,41,279,320,47,240,72,1,320,119,LTAdatasets/1501/annotate/1501-2021_03_20_202437.jpg,299.5,95.5,0.9359375,0.39791666666666664,0.128125,0.19583333333333333
1501-2021_03_20_063354.jpg,van,19,69,320,24,240,33,3,88,57,LTAdatasets/1501/annotate/1501-2021_03_20_063354.jpg,78.5,45.0,0.2453125,0.1875,0.059375,0.1
1501-2021_03_20_185753.jpg,lorry_truck,91,196,320,51,240,40,2,287,91,LTAdatasets/1501/annotate/1501-2021_03_20_185753.jpg,241.5,65.5,0.7546875,0.27291666666666664,0.284375,0.2125
1501-2021_03_20_205739.jpg,car,28,100,320,16,240,33,1,128,49,LTAdatasets/1501/annotate/1501-2021_03_20_205739.jpg,114.0,41.0,0.35625,0.17083333333333334,0.0875,0.06666666666666667
1501-2021_03_20_064855.jpg,lorry_truck,32,62,320,21,240,24,2,94,45,LTAdatasets/1501/annotate/1501-2021_03_20_064855.jpg,78.0,34.5,0.24375,0.14375,0.1,0.0875
1501-2021_03_20_192214.jpg,car,12,55,320,8,240,26,1,67,34,LTAdatasets/1501/annotate/1501-2021_03_20_192214.jpg,61.0,30.0,0.190625,0.125,0.0375,0.03333333333333333
1006-2021_03_20_085141.jpg,car,17,219,320,13,240,111,1,236,124,LTAdatasets/1006/annotate/1006-2021_03_20_085141.jpg,227.5,117.5,0.7109375,0.4895833333333333,0.053125,0.05416666666666667
1006-2021_03_20_085141.jpg,car,24,266,320,16,240,115,1,290,131,LTAdatasets/1006/annotate/1006-2021_03_20_085141.jpg,278.0,123.0,0.86875,0.5125,0.075,0.06666666666666667
1006-2021_03_20_085141.jpg,car,33,236,320,25,240,171,1,269,196,LTAdatasets/1006/annotate/1006-2021_03_20_085141.jpg,252.5,183.5,0.7890625,0.7645833333333333,0.103125,0.10416666666666667
1006-2021_03_20_085141.jpg,car,16,209,320,9,240,93,1,225,102,LTAdatasets/1006/annotate/1006-2021_03_20_085141.jpg,217.0,97.5,0.678125,0.40625,0.05,0.0375
1006-2021_03_20_085141.jpg,car,11,217,320,10,240,82,1,228,92,LTAdatasets/1006/annotate/1006-2021_03_20_085141.jpg,222.5,87.0,0.6953125,0.3625,0.034375,0.041666666666666664
1006-2021_03_20_085141.jpg,car,13,281,320,9,240,89,1,294,98,LTAdatasets/1006/annotate/1006-2021_03_20_085141.jpg,287.5,93.5,0.8984375,0.38958333333333334,0.040625,0.0375
1006-2021_03_20_180710.jpg,car,28,262,320,24,240,152,1,290,176,LTAdatasets/1006/annotate/1006-2021_03_20_180710.jpg,276.0,164.0,0.8625,0.6833333333333333,0.0875,0.1
1006-2021_03_20_180710.jpg,car,19,191,320,11,240,105,1,210,116,LTAdatasets/1006/annotate/1006-2021_03_20_180710.jpg,200.5,110.5,0.6265625,0.46041666666666664,0.059375,0.04583333333333333
1006-2021_03_20_180710.jpg,car,15,257,320,8,240,85,1,272,93,LTAdatasets/1006/annotate/1006-2021_03_20_180710.jpg,264.5,89.0,0.8265625,0.37083333333333335,0.046875,0.03333333333333333
1006-2021_03_20_180710.jpg,car,12,286,320,6,240,87,1,298,93,LTAdatasets/1006/annotate/1006-2021_03_20_180710.jpg,292.0,90.0,0.9125,0.375,0.0375,0.025
1006-2021_03_20_180710.jpg,car,15,289,320,9,240,95,1,304,104,LTAdatasets/1006/annotate/1006-2021_03_20_180710.jpg,296.5,99.5,0.9265625,0.41458333333333336,0.046875,0.0375
1006-2021_03_20_180710.jpg,car,11,198,320,9,240,82,1,209,91,LTAdatasets/1006/annotate/1006-2021_03_20_180710.jpg,203.5,86.5,0.6359375,0.36041666666666666,0.034375,0.0375
1006-2021_03_20_180710.jpg,car,10,244,320,7,240,80,1,254,87,LTAdatasets/1006/annotate/1006-2021_03_20_180710.jpg,249.0,83.5,0.778125,0.34791666666666665,0.03125,0.029166666666666667
1006-2021_03_20_180710.jpg,car,7,271,320,8,240,75,1,278,83,LTAdatasets/1006/annotate/1006-2021_03_20_180710.jpg,274.5,79.0,0.8578125,0.32916666666666666,0.021875,0.03333333333333333
1006-2021_03_20_180710.jpg,car,13,244,320,7,240,75,1,257,82,LTAdatasets/1006/annotate/1006-2021_03_20_180710.jpg,250.5,78.5,0.7828125,0.32708333333333334,0.040625,0.029166666666666667
1006-2021_03_20_210420.jpg,car,13,189,320,15,240,104,1,202,119,LTAdatasets/1006/annotate/1006-2021_03_20_210420.jpg,195.5,111.5,0.6109375,0.46458333333333335,0.040625,0.0625
1006-2021_03_20_210420.jpg,car,13,202,320,8,240,91,1,215,99,LTAdatasets/1006/annotate/1006-2021_03_20_210420.jpg,208.5,95.0,0.6515625,0.3958333333333333,0.040625,0.03333333333333333
1006-2021_03_20_210420.jpg,van,9,198,320,6,240,83,3,207,89,LTAdatasets/1006/annotate/1006-2021_03_20_210420.jpg,202.5,86.0,0.6328125,0.35833333333333334,0.028125,0.025
1006-2021_03_20_220643.jpg,car,30,249,320,18,240,135,1,279,153,LTAdatasets/1006/annotate/1006-2021_03_20_220643.jpg,264.0,144.0,0.825,0.6,0.09375,0.075
1006-2021_03_20_091903.jpg,car,19,248,320,10,240,105,1,267,115,LTAdatasets/1006/annotate/1006-2021_03_20_091903.jpg,257.5,110.0,0.8046875,0.4583333333333333,0.059375,0.041666666666666664
1006-2021_03_20_091903.jpg,car,11,211,320,11,240,95,1,222,106,LTAdatasets/1006/annotate/1006-2021_03_20_091903.jpg,216.5,100.5,0.6765625,0.41875,0.034375,0.04583333333333333
1006-2021_03_20_091903.jpg,car,13,211,320,6,240,81,1,224,87,LTAdatasets/1006/annotate/1006-2021_03_20_091903.jpg,217.5,84.0,0.6796875,0.35,0.040625,0.025
1006-2021_03_20_091903.jpg,car,13,259,320,7,240,78,1,272,85,LTAdatasets/1006/annotate/1006-2021_03_20_091903.jpg,265.5,81.5,0.8296875,0.33958333333333335,0.040625,0.029166666666666667
1006-2021_03_20_094904.jpg,van,33,213,320,32,240,155,3,246,187,LTAdatasets/1006/annotate/1006-2021_03_20_094904.jpg,229.5,171.0,0.7171875,0.7125,0.103125,0.13333333333333333
1006-2021_03_20_094904.jpg,van,13,207,320,11,240,95,3,220,106,LTAdatasets/1006/annotate/1006-2021_03_20_094904.jpg,213.5,100.5,0.6671875,0.41875,0.040625,0.04583333333333333
1006-2021_03_20_094904.jpg,car,21,254,320,14,240,111,1,275,125,LTAdatasets/1006/annotate/1006-2021_03_20_094904.jpg,264.5,118.0,0.8265625,0.49166666666666664,0.065625,0.058333333333333334
1006-2021_03_20_094904.jpg,car,34,265,320,29,240,156,1,299,185,LTAdatasets/1006/annotate/1006-2021_03_20_094904.jpg,282.0,170.5,0.88125,0.7104166666666667,0.10625,0.12083333333333333
1006-2021_03_20_094904.jpg,car,11,214,320,14,240,129,1,225,143,LTAdatasets/1006/annotate/1006-2021_03_20_094904.jpg,219.5,136.0,0.6859375,0.5666666666666667,0.034375,0.058333333333333334
1006-2021_03_20_094904.jpg,car,15,193,320,12,240,109,1,208,121,LTAdatasets/1006/annotate/1006-2021_03_20_094904.jpg,200.5,115.0,0.6265625,0.4791666666666667,0.046875,0.05
1006-2021_03_20_094904.jpg,car,16,220,320,11,240,107,1,236,118,LTAdatasets/1006/annotate/1006-2021_03_20_094904.jpg,228.0,112.5,0.7125,0.46875,0.05,0.04583333333333333
1006-2021_03_20_094904.jpg,car,13,231,320,12,240,90,1,244,102,LTAdatasets/1006/annotate/1006-2021_03_20_094904.jpg,237.5,96.0,0.7421875,0.4,0.040625,0.05
1006-2021_03_20_094904.jpg,car,7,217,320,6,240,83,1,224,89,LTAdatasets/1006/annotate/1006-2021_03_20_094904.jpg,220.5,86.0,0.6890625,0.35833333333333334,0.021875,0.025
1006-2021_03_20_094904.jpg,lorry_truck,12,271,320,8,240,75,2,283,83,LTAdatasets/1006/annotate/1006-2021_03_20_094904.jpg,277.0,79.0,0.865625,0.32916666666666666,0.0375,0.03333333333333333
1006-2021_03_20_094904.jpg,car,9,249,320,9,240,74,1,258,83,LTAdatasets/1006/annotate/1006-2021_03_20_094904.jpg,253.5,78.5,0.7921875,0.32708333333333334,0.028125,0.0375
1006-2021_03_20_094904.jpg,car,12,263,320,9,240,73,1,275,82,LTAdatasets/1006/annotate/1006-2021_03_20_094904.jpg,269.0,77.5,0.840625,0.3229166666666667,0.0375,0.0375
1006-2021_03_20_094904.jpg,car,10,198,320,9,240,80,1,208,89,LTAdatasets/1006/annotate/1006-2021_03_20_094904.jpg,203.0,84.5,0.634375,0.35208333333333336,0.03125,0.0375
1006-2021_03_20_202758.jpg,lorry_truck,53,221,320,57,240,179,2,274,236,LTAdatasets/1006/annotate/1006-2021_03_20_202758.jpg,247.5,207.5,0.7734375,0.8645833333333334,0.165625,0.2375
1006-2021_03_20_202758.jpg,car,23,253,320,12,240,109,1,276,121,LTAdatasets/1006/annotate/1006-2021_03_20_202758.jpg,264.5,115.0,0.8265625,0.4791666666666667,0.071875,0.05
1006-2021_03_20_202758.jpg,car,18,215,320,9,240,105,1,233,114,LTAdatasets/1006/annotate/1006-2021_03_20_202758.jpg,224.0,109.5,0.7,0.45625,0.05625,0.0375
1006-2021_03_20_202758.jpg,car,26,196,320,18,240,114,1,222,132,LTAdatasets/1006/annotate/1006-2021_03_20_202758.jpg,209.0,123.0,0.653125,0.5125,0.08125,0.075
1006-2021_03_20_070716.jpg,bike,13,302,320,19,240,135,4,315,154,LTAdatasets/1006/annotate/1006-2021_03_20_070716.jpg,308.5,144.5,0.9640625,0.6020833333333333,0.040625,0.07916666666666666
1006-2021_03_20_070716.jpg,bike,6,224,320,9,240,90,4,230,99,LTAdatasets/1006/annotate/1006-2021_03_20_070716.jpg,227.0,94.5,0.709375,0.39375,0.01875,0.0375
1006-2021_03_20_070716.jpg,bike,8,251,320,7,240,76,4,259,83,LTAdatasets/1006/annotate/1006-2021_03_20_070716.jpg,255.0,79.5,0.796875,0.33125,0.025,0.029166666666666667
1006-2021_03_20_070716.jpg,car,11,202,320,8,240,92,1,213,100,LTAdatasets/1006/annotate/1006-2021_03_20_070716.jpg,207.5,96.0,0.6484375,0.4,0.034375,0.03333333333333333
1006-2021_03_20_070716.jpg,car,11,216,320,7,240,83,1,227,90,LTAdatasets/1006/annotate/1006-2021_03_20_070716.jpg,221.5,86.5,0.6921875,0.36041666666666666,0.034375,0.029166666666666667
1006-2021_03_20_195136.jpg,car,39,260,320,20,240,153,1,299,173,LTAdatasets/1006/annotate/1006-2021_03_20_195136.jpg,279.5,163.0,0.8734375,0.6791666666666667,0.121875,0.08333333333333333
1006-2021_03_20_195136.jpg,van,27,196,320,26,240,131,3,223,157,LTAdatasets/1006/annotate/1006-2021_03_20_195136.jpg,209.5,144.0,0.6546875,0.6,0.084375,0.10833333333333334
1006-2021_03_20_195136.jpg,van,32,207,320,36,240,165,3,239,201,LTAdatasets/1006/annotate/1006-2021_03_20_195136.jpg,223.0,183.0,0.696875,0.7625,0.1,0.15
1006-2021_03_20_195136.jpg,car,15,203,320,9,240,97,1,218,106,LTAdatasets/1006/annotate/1006-2021_03_20_195136.jpg,210.5,101.5,0.6578125,0.42291666666666666,0.046875,0.0375
1006-2021_03_20_071236.jpg,van,30,258,320,27,240,156,3,288,183,LTAdatasets/1006/annotate/1006-2021_03_20_071236.jpg,273.0,169.5,0.853125,0.70625,0.09375,0.1125
1006-2021_03_20_071236.jpg,van,18,224,320,16,240,112,3,242,128,LTAdatasets/1006/annotate/1006-2021_03_20_071236.jpg,233.0,120.0,0.728125,0.5,0.05625,0.06666666666666667
1006-2021_03_20_071236.jpg,van,14,187,320,14,240,99,3,201,113,LTAdatasets/1006/annotate/1006-2021_03_20_071236.jpg,194.0,106.0,0.60625,0.44166666666666665,0.04375,0.058333333333333334
1006-2021_03_20_071236.jpg,van,18,195,320,16,240,116,3,213,132,LTAdatasets/1006/annotate/1006-2021_03_20_071236.jpg,204.0,124.0,0.6375,0.5166666666666667,0.05625,0.06666666666666667
1006-2021_03_20_194315.jpg,car,32,284,320,20,240,137,1,316,157,LTAdatasets/1006/annotate/1006-2021_03_20_194315.jpg,300.0,147.0,0.9375,0.6125,0.1,0.08333333333333333
1006-2021_03_20_194315.jpg,car,23,217,320,15,240,107,1,240,122,LTAdatasets/1006/annotate/1006-2021_03_20_194315.jpg,228.5,114.5,0.7140625,0.47708333333333336,0.071875,0.0625
1006-2021_03_20_194315.jpg,car,13,237,320,12,240,97,1,250,109,LTAdatasets/1006/annotate/1006-2021_03_20_194315.jpg,243.5,103.0,0.7609375,0.42916666666666664,0.040625,0.05
1006-2021_03_20_081920.jpg,van,33,259,320,36,240,146,3,292,182,LTAdatasets/1006/annotate/1006-2021_03_20_081920.jpg,275.5,164.0,0.8609375,0.6833333333333333,0.103125,0.15
1006-2021_03_20_081920.jpg,car,14,218,320,13,240,102,1,232,115,LTAdatasets/1006/annotate/1006-2021_03_20_081920.jpg,225.0,108.5,0.703125,0.45208333333333334,0.04375,0.05416666666666667
1006-2021_03_20_081920.jpg,van,12,202,320,8,240,85,3,214,93,LTAdatasets/1006/annotate/1006-2021_03_20_081920.jpg,208.0,89.0,0.65,0.37083333333333335,0.0375,0.03333333333333333
1006-2021_03_20_081920.jpg,bike,9,275,320,8,240,81,4,284,89,LTAdatasets/1006/annotate/1006-2021_03_20_081920.jpg,279.5,85.0,0.8734375,0.3541666666666667,0.028125,0.03333333333333333
1006-2021_03_20_190413.jpg,car,22,239,320,15,240,124,1,261,139,LTAdatasets/1006/annotate/1006-2021_03_20_190413.jpg,250.0,131.5,0.78125,0.5479166666666667,0.06875,0.0625
1006-2021_03_20_190413.jpg,car,21,273,320,18,240,120,1,294,138,LTAdatasets/1006/annotate/1006-2021_03_20_190413.jpg,283.5,129.0,0.8859375,0.5375,0.065625,0.075
1006-2021_03_20_190413.jpg,car,17,242,320,12,240,102,1,259,114,LTAdatasets/1006/annotate/1006-2021_03_20_190413.jpg,250.5,108.0,0.7828125,0.45,0.053125,0.05
1006-2021_03_20_190413.jpg,car,15,193,320,11,240,107,1,208,118,LTAdatasets/1006/annotate/1006-2021_03_20_190413.jpg,200.5,112.5,0.6265625,0.46875,0.046875,0.04583333333333333
1006-2021_03_20_190413.jpg,car,18,200,320,15,240,130,1,218,145,LTAdatasets/1006/annotate/1006-2021_03_20_190413.jpg,209.0,137.5,0.653125,0.5729166666666666,0.05625,0.0625
1006-2021_03_20_190413.jpg,car,13,210,320,9,240,97,1,223,106,LTAdatasets/1006/annotate/1006-2021_03_20_190413.jpg,216.5,101.5,0.6765625,0.42291666666666666,0.040625,0.0375
1006-2021_03_20_190413.jpg,bike,6,204,320,10,240,98,4,210,108,LTAdatasets/1006/annotate/1006-2021_03_20_190413.jpg,207.0,103.0,0.646875,0.42916666666666664,0.01875,0.041666666666666664
1006-2021_03_20_190413.jpg,car,16,298,320,15,240,96,1,314,111,LTAdatasets/1006/annotate/1006-2021_03_20_190413.jpg,306.0,103.5,0.95625,0.43125,0.05,0.0625
1006-2021_03_20_190413.jpg,car,15,272,320,11,240,87,1,287,98,LTAdatasets/1006/annotate/1006-2021_03_20_190413.jpg,279.5,92.5,0.8734375,0.3854166666666667,0.046875,0.04583333333333333
1006-2021_03_20_190413.jpg,car,11,283,320,11,240,83,1,294,94,LTAdatasets/1006/annotate/1006-2021_03_20_190413.jpg,288.5,88.5,0.9015625,0.36875,0.034375,0.04583333333333333
1006-2021_03_20_190413.jpg,car,10,254,320,5,240,82,1,264,87,LTAdatasets/1006/annotate/1006-2021_03_20_190413.jpg,259.0,84.5,0.809375,0.35208333333333336,0.03125,0.020833333333333332
1006-2021_03_20_190413.jpg,van,11,187,320,9,240,90,3,198,99,LTAdatasets/1006/annotate/1006-2021_03_20_190413.jpg,192.5,94.5,0.6015625,0.39375,0.034375,0.0375
1006-2021_03_20_213341.jpg,car,39,229,320,36,240,192,1,268,228,LTAdatasets/1006/annotate/1006-2021_03_20_213341.jpg,248.5,210.0,0.7765625,0.875,0.121875,0.15
1006-2021_03_20_213341.jpg,car,21,232,320,17,240,117,1,253,134,LTAdatasets/1006/annotate/1006-2021_03_20_213341.jpg,242.5,125.5,0.7578125,0.5229166666666667,0.065625,0.07083333333333333
1006-2021_03_20_061853.jpg,car,17,257,320,14,240,109,1,274,123,LTAdatasets/1006/annotate/1006-2021_03_20_061853.jpg,265.5,116.0,0.8296875,0.48333333333333334,0.053125,0.058333333333333334
1006-2021_03_20_061853.jpg,lorry_truck,29,187,320,31,240,106,2,216,137,LTAdatasets/1006/annotate/1006-2021_03_20_061853.jpg,201.5,121.5,0.6296875,0.50625,0.090625,0.12916666666666668
1006-2021_03_20_061853.jpg,car,13,214,320,13,240,98,1,227,111,LTAdatasets/1006/annotate/1006-2021_03_20_061853.jpg,220.5,104.5,0.6890625,0.4354166666666667,0.040625,0.05416666666666667
1006-2021_03_20_065155.jpg,car,27,217,320,17,240,130,1,244,147,LTAdatasets/1006/annotate/1006-2021_03_20_065155.jpg,230.5,138.5,0.7203125,0.5770833333333333,0.084375,0.07083333333333333
1006-2021_03_20_065155.jpg,van,17,220,320,15,240,106,3,237,121,LTAdatasets/1006/annotate/1006-2021_03_20_065155.jpg,228.5,113.5,0.7140625,0.47291666666666665,0.053125,0.0625
1006-2021_03_20_065155.jpg,car,11,204,320,11,240,87,1,215,98,LTAdatasets/1006/annotate/1006-2021_03_20_065155.jpg,209.5,92.5,0.6546875,0.3854166666666667,0.034375,0.04583333333333333
1006-2021_03_20_065755.jpg,car,36,234,320,31,240,171,1,270,202,LTAdatasets/1006/annotate/1006-2021_03_20_065755.jpg,252.0,186.5,0.7875,0.7770833333333333,0.1125,0.12916666666666668
1006-2021_03_20_065755.jpg,lorry_truck,12,190,320,17,240,97,2,202,114,LTAdatasets/1006/annotate/1006-2021_03_20_065755.jpg,196.0,105.5,0.6125,0.4395833333333333,0.0375,0.07083333333333333
1006-2021_03_20_094024.jpg,bike,20,288,320,22,240,165,4,308,187,LTAdatasets/1006/annotate/1006-2021_03_20_094024.jpg,298.0,176.0,0.93125,0.7333333333333333,0.0625,0.09166666666666666
1006-2021_03_20_094024.jpg,van,25,295,320,32,240,132,3,320,164,LTAdatasets/1006/annotate/1006-2021_03_20_094024.jpg,307.5,148.0,0.9609375,0.6166666666666667,0.078125,0.13333333333333333
1006-2021_03_20_094024.jpg,car,14,210,320,12,240,95,1,224,107,LTAdatasets/1006/annotate/1006-2021_03_20_094024.jpg,217.0,101.0,0.678125,0.42083333333333334,0.04375,0.05
1006-2021_03_20_094024.jpg,car,9,219,320,9,240,83,1,228,92,LTAdatasets/1006/annotate/1006-2021_03_20_094024.jpg,223.5,87.5,0.6984375,0.3645833333333333,0.028125,0.0375
1006-2021_03_20_191914.jpg,car,22,271,320,15,240,122,1,293,137,LTAdatasets/1006/annotate/1006-2021_03_20_191914.jpg,282.0,129.5,0.88125,0.5395833333333333,0.06875,0.0625
1006-2021_03_20_191914.jpg,car,13,221,320,9,240,86,1,234,95,LTAdatasets/1006/annotate/1006-2021_03_20_191914.jpg,227.5,90.5,0.7109375,0.3770833333333333,0.040625,0.0375
1006-2021_03_20_191914.jpg,car,15,285,320,9,240,87,1,300,96,LTAdatasets/1006/annotate/1006-2021_03_20_191914.jpg,292.5,91.5,0.9140625,0.38125,0.046875,0.0375
1006-2021_03_20_191914.jpg,car,11,251,320,10,240,79,1,262,89,LTAdatasets/1006/annotate/1006-2021_03_20_191914.jpg,256.5,84.0,0.8015625,0.35,0.034375,0.041666666666666664
1006-2021_03_20_184913.jpg,car,21,250,320,18,240,104,1,271,122,LTAdatasets/1006/annotate/1006-2021_03_20_184913.jpg,260.5,113.0,0.8140625,0.4708333333333333,0.065625,0.075
1006-2021_03_20_184913.jpg,car,16,213,320,9,240,102,1,229,111,LTAdatasets/1006/annotate/1006-2021_03_20_184913.jpg,221.0,106.5,0.690625,0.44375,0.05,0.0375
1006-2021_03_20_184913.jpg,car,11,207,320,9,240,93,1,218,102,LTAdatasets/1006/annotate/1006-2021_03_20_184913.jpg,212.5,97.5,0.6640625,0.40625,0.034375,0.0375
1006-2021_03_20_184913.jpg,car,10,220,320,7,240,87,1,230,94,LTAdatasets/1006/annotate/1006-2021_03_20_184913.jpg,225.0,90.5,0.703125,0.3770833333333333,0.03125,0.029166666666666667
1006-2021_03_20_184913.jpg,lorry_truck,9,200,320,9,240,81,2,209,90,LTAdatasets/1006/annotate/1006-2021_03_20_184913.jpg,204.5,85.5,0.6390625,0.35625,0.028125,0.0375
1006-2021_03_20_184913.jpg,lorry_truck,11,253,320,9,240,69,2,264,78,LTAdatasets/1006/annotate/1006-2021_03_20_184913.jpg,258.5,73.5,0.8078125,0.30625,0.034375,0.0375
1006-2021_03_20_063654.jpg,van,27,197,320,26,240,128,3,224,154,LTAdatasets/1006/annotate/1006-2021_03_20_063654.jpg,210.5,141.0,0.6578125,0.5875,0.084375,0.10833333333333334
1006-2021_03_20_063654.jpg,car,21,257,320,11,240,111,1,278,122,LTAdatasets/1006/annotate/1006-2021_03_20_063654.jpg,267.5,116.5,0.8359375,0.48541666666666666,0.065625,0.04583333333333333
1006-2021_03_20_063654.jpg,car,13,186,320,9,240,101,1,199,110,LTAdatasets/1006/annotate/1006-2021_03_20_063654.jpg,192.5,105.5,0.6015625,0.4395833333333333,0.040625,0.0375
1006-2021_03_20_200637.jpg,car,21,227,320,12,240,113,1,248,125,LTAdatasets/1006/annotate/1006-2021_03_20_200637.jpg,237.5,119.0,0.7421875,0.49583333333333335,0.065625,0.05
1006-2021_03_20_204018.jpg,car,20,231,320,13,240,114,1,251,127,LTAdatasets/1006/annotate/1006-2021_03_20_204018.jpg,241.0,120.5,0.753125,0.5020833333333333,0.0625,0.05416666666666667
1006-2021_03_20_204018.jpg,car,13,203,320,8,240,92,1,216,100,LTAdatasets/1006/annotate/1006-2021_03_20_204018.jpg,209.5,96.0,0.6546875,0.4,0.040625,0.03333333333333333
1006-2021_03_20_074918.jpg,car,35,212,320,37,240,174,1,247,211,LTAdatasets/1006/annotate/1006-2021_03_20_074918.jpg,229.5,192.5,0.7171875,0.8020833333333334,0.109375,0.15416666666666667
1006-2021_03_20_074918.jpg,car,33,251,320,19,240,154,1,284,173,LTAdatasets/1006/annotate/1006-2021_03_20_074918.jpg,267.5,163.5,0.8359375,0.68125,0.103125,0.07916666666666666
1006-2021_03_20_074918.jpg,car,22,294,320,21,240,136,1,316,157,LTAdatasets/1006/annotate/1006-2021_03_20_074918.jpg,305.0,146.5,0.953125,0.6104166666666667,0.06875,0.0875
1006-2021_03_20_074918.jpg,car,23,217,320,18,240,122,1,240,140,LTAdatasets/1006/annotate/1006-2021_03_20_074918.jpg,228.5,131.0,0.7140625,0.5458333333333333,0.071875,0.075
1006-2021_03_20_074918.jpg,car,15,196,320,10,240,110,1,211,120,LTAdatasets/1006/annotate/1006-2021_03_20_074918.jpg,203.5,115.0,0.6359375,0.4791666666666667,0.046875,0.041666666666666664
1006-2021_03_20_074918.jpg,lorry_truck,14,211,320,10,240,94,2,225,104,LTAdatasets/1006/annotate/1006-2021_03_20_074918.jpg,218.0,99.0,0.68125,0.4125,0.04375,0.041666666666666664
1006-2021_03_20_074918.jpg,lorry_truck,9,197,320,9,240,82,2,206,91,LTAdatasets/1006/annotate/1006-2021_03_20_074918.jpg,201.5,86.5,0.6296875,0.36041666666666666,0.028125,0.0375
1006-2021_03_20_191234.jpg,van,23,202,320,27,240,134,3,225,161,LTAdatasets/1006/annotate/1006-2021_03_20_191234.jpg,213.5,147.5,0.6671875,0.6145833333333334,0.071875,0.1125
1006-2021_03_20_191234.jpg,car,9,216,320,12,240,81,1,225,93,LTAdatasets/1006/annotate/1006-2021_03_20_191234.jpg,220.5,87.0,0.6890625,0.3625,0.028125,0.05
1006-2021_03_20_191234.jpg,car,9,245,320,8,240,79,1,254,87,LTAdatasets/1006/annotate/1006-2021_03_20_191234.jpg,249.5,83.0,0.7796875,0.3458333333333333,0.028125,0.03333333333333333
1006-2021_03_20_191234.jpg,car,10,256,320,7,240,77,1,266,84,LTAdatasets/1006/annotate/1006-2021_03_20_191234.jpg,261.0,80.5,0.815625,0.33541666666666664,0.03125,0.029166666666666667
1006-2021_03_20_191234.jpg,car,9,200,320,8,240,87,1,209,95,LTAdatasets/1006/annotate/1006-2021_03_20_191234.jpg,204.5,91.0,0.6390625,0.37916666666666665,0.028125,0.03333333333333333
1006-2021_03_20_084901.jpg,lorry_truck,38,215,320,38,240,166,2,253,204,LTAdatasets/1006/annotate/1006-2021_03_20_084901.jpg,234.0,185.0,0.73125,0.7708333333333334,0.11875,0.15833333333333333
1006-2021_03_20_084901.jpg,car,28,257,320,29,240,144,1,285,173,LTAdatasets/1006/annotate/1006-2021_03_20_084901.jpg,271.0,158.5,0.846875,0.6604166666666667,0.0875,0.12083333333333333
1006-2021_03_20_084901.jpg,bike,10,216,320,13,240,118,4,226,131,LTAdatasets/1006/annotate/1006-2021_03_20_084901.jpg,221.0,124.5,0.690625,0.51875,0.03125,0.05416666666666667
1006-2021_03_20_084901.jpg,car,17,242,320,13,240,98,1,259,111,LTAdatasets/1006/annotate/1006-2021_03_20_084901.jpg,250.5,104.5,0.7828125,0.4354166666666667,0.053125,0.05416666666666667
1006-2021_03_20_084901.jpg,car,14,224,320,7,240,89,1,238,96,LTAdatasets/1006/annotate/1006-2021_03_20_084901.jpg,231.0,92.5,0.721875,0.3854166666666667,0.04375,0.029166666666666667
1006-2021_03_20_084901.jpg,van,13,209,320,14,240,92,3,222,106,LTAdatasets/1006/annotate/1006-2021_03_20_084901.jpg,215.5,99.0,0.6734375,0.4125,0.040625,0.058333333333333334
1006-2021_03_20_091302.jpg,lorry_truck,26,197,320,21,240,117,2,223,138,LTAdatasets/1006/annotate/1006-2021_03_20_091302.jpg,210.0,127.5,0.65625,0.53125,0.08125,0.0875
1006-2021_03_20_091302.jpg,bike,4,209,320,9,240,90,4,213,99,LTAdatasets/1006/annotate/1006-2021_03_20_091302.jpg,211.0,94.5,0.659375,0.39375,0.0125,0.0375
1006-2021_03_20_091302.jpg,car,8,202,320,8,240,85,1,210,93,LTAdatasets/1006/annotate/1006-2021_03_20_091302.jpg,206.0,89.0,0.64375,0.37083333333333335,0.025,0.03333333333333333
1006-2021_03_20_092543.jpg,car,37,264,320,24,240,155,1,301,179,LTAdatasets/1006/annotate/1006-2021_03_20_092543.jpg,282.5,167.0,0.8828125,0.6958333333333333,0.115625,0.1
1006-2021_03_20_092543.jpg,lorry_truck,22,209,320,25,240,130,2,231,155,LTAdatasets/1006/annotate/1006-2021_03_20_092543.jpg,220.0,142.5,0.6875,0.59375,0.06875,0.10416666666666667
1006-2021_03_20_092543.jpg,car,16,212,320,10,240,99,1,228,109,LTAdatasets/1006/annotate/1006-2021_03_20_092543.jpg,220.0,104.0,0.6875,0.43333333333333335,0.05,0.041666666666666664
1006-2021_03_20_092543.jpg,car,13,188,320,10,240,98,1,201,108,LTAdatasets/1006/annotate/1006-2021_03_20_092543.jpg,194.5,103.0,0.6078125,0.42916666666666664,0.040625,0.041666666666666664
1006-2021_03_20_092543.jpg,car,18,293,320,12,240,96,1,311,108,LTAdatasets/1006/annotate/1006-2021_03_20_092543.jpg,302.0,102.0,0.94375,0.425,0.05625,0.05
1006-2021_03_20_092543.jpg,car,11,266,320,6,240,85,1,277,91,LTAdatasets/1006/annotate/1006-2021_03_20_092543.jpg,271.5,88.0,0.8484375,0.36666666666666664,0.034375,0.025
1006-2021_03_20_092543.jpg,car,10,208,320,9,240,90,1,218,99,LTAdatasets/1006/annotate/1006-2021_03_20_092543.jpg,213.0,94.5,0.665625,0.39375,0.03125,0.0375
1006-2021_03_20_192735.jpg,car,20,197,320,17,240,127,1,217,144,LTAdatasets/1006/annotate/1006-2021_03_20_192735.jpg,207.0,135.5,0.646875,0.5645833333333333,0.0625,0.07083333333333333
1006-2021_03_20_192735.jpg,car,15,266,320,12,240,83,1,281,95,LTAdatasets/1006/annotate/1006-2021_03_20_192735.jpg,273.5,89.0,0.8546875,0.37083333333333335,0.046875,0.05
1006-2021_03_20_192735.jpg,car,9,221,320,7,240,86,1,230,93,LTAdatasets/1006/annotate/1006-2021_03_20_192735.jpg,225.5,89.5,0.7046875,0.3729166666666667,0.028125,0.029166666666666667
1006-2021_03_20_192735.jpg,car,11,200,320,10,240,85,1,211,95,LTAdatasets/1006/annotate/1006-2021_03_20_192735.jpg,205.5,90.0,0.6421875,0.375,0.034375,0.041666666666666664
1006-2021_03_20_094305.jpg,lorry_truck,52,200,320,59,240,133,2,252,192,LTAdatasets/1006/annotate/1006-2021_03_20_094305.jpg,226.0,162.5,0.70625,0.6770833333333334,0.1625,0.24583333333333332
1006-2021_03_20_094305.jpg,van,43,275,320,42,240,161,3,318,203,LTAdatasets/1006/annotate/1006-2021_03_20_094305.jpg,296.5,182.0,0.9265625,0.7583333333333333,0.134375,0.175
1006-2021_03_20_094305.jpg,car,16,235,320,18,240,116,1,251,134,LTAdatasets/1006/annotate/1006-2021_03_20_094305.jpg,243.0,125.0,0.759375,0.5208333333333334,0.05,0.075
1006-2021_03_20_094305.jpg,car,19,256,320,9,240,110,1,275,119,LTAdatasets/1006/annotate/1006-2021_03_20_094305.jpg,265.5,114.5,0.8296875,0.47708333333333336,0.059375,0.0375
1006-2021_03_20_094305.jpg,car,13,241,320,9,240,101,1,254,110,LTAdatasets/1006/annotate/1006-2021_03_20_094305.jpg,247.5,105.5,0.7734375,0.4395833333333333,0.040625,0.0375
1006-2021_03_20_094305.jpg,car,17,213,320,10,240,100,1,230,110,LTAdatasets/1006/annotate/1006-2021_03_20_094305.jpg,221.5,105.0,0.6921875,0.4375,0.053125,0.041666666666666664
1006-2021_03_20_094305.jpg,car,15,228,320,9,240,93,1,243,102,LTAdatasets/1006/annotate/1006-2021_03_20_094305.jpg,235.5,97.5,0.7359375,0.40625,0.046875,0.0375
1006-2021_03_20_094305.jpg,bike,15,196,320,16,240,103,4,211,119,LTAdatasets/1006/annotate/1006-2021_03_20_094305.jpg,203.5,111.0,0.6359375,0.4625,0.046875,0.06666666666666667
1006-2021_03_20_094305.jpg,car,12,214,320,10,240,86,1,226,96,LTAdatasets/1006/annotate/1006-2021_03_20_094305.jpg,220.0,91.0,0.6875,0.37916666666666665,0.0375,0.041666666666666664
1006-2021_03_20_094305.jpg,lorry_truck,21,296,320,13,240,74,2,317,87,LTAdatasets/1006/annotate/1006-2021_03_20_094305.jpg,306.5,80.5,0.9578125,0.33541666666666664,0.065625,0.05416666666666667
1006-2021_03_20_082220.jpg,van,23,241,320,22,240,127,3,264,149,LTAdatasets/1006/annotate/1006-2021_03_20_082220.jpg,252.5,138.0,0.7890625,0.575,0.071875,0.09166666666666666
1006-2021_03_20_082220.jpg,car,27,276,320,17,240,127,1,303,144,LTAdatasets/1006/annotate/1006-2021_03_20_082220.jpg,289.5,135.5,0.9046875,0.5645833333333333,0.084375,0.07083333333333333
1006-2021_03_20_082220.jpg,bike,13,204,320,18,240,118,4,217,136,LTAdatasets/1006/annotate/1006-2021_03_20_082220.jpg,210.5,127.0,0.6578125,0.5291666666666667,0.040625,0.075
1006-2021_03_20_082220.jpg,bike,8,242,320,10,240,96,4,250,106,LTAdatasets/1006/annotate/1006-2021_03_20_082220.jpg,246.0,101.0,0.76875,0.42083333333333334,0.025,0.041666666666666664
1006-2021_03_20_082220.jpg,car,22,252,320,15,240,111,1,274,126,LTAdatasets/1006/annotate/1006-2021_03_20_082220.jpg,263.0,118.5,0.821875,0.49375,0.06875,0.0625
1006-2021_03_20_082220.jpg,car,15,278,320,10,240,89,1,293,99,LTAdatasets/1006/annotate/1006-2021_03_20_082220.jpg,285.5,94.0,0.8921875,0.39166666666666666,0.046875,0.041666666666666664
1006-2021_03_20_082220.jpg,car,11,265,320,7,240,81,1,276,88,LTAdatasets/1006/annotate/1006-2021_03_20_082220.jpg,270.5,84.5,0.8453125,0.35208333333333336,0.034375,0.029166666666666667
1006-2021_03_20_201917.jpg,car,30,242,320,22,240,143,1,272,165,LTAdatasets/1006/annotate/1006-2021_03_20_201917.jpg,257.0,154.0,0.803125,0.6416666666666667,0.09375,0.09166666666666666
1006-2021_03_20_201917.jpg,car,16,215,320,11,240,103,1,231,114,LTAdatasets/1006/annotate/1006-2021_03_20_201917.jpg,223.0,108.5,0.696875,0.45208333333333334,0.05,0.04583333333333333
1006-2021_03_20_201917.jpg,car,12,193,320,12,240,106,1,205,118,LTAdatasets/1006/annotate/1006-2021_03_20_201917.jpg,199.0,112.0,0.621875,0.4666666666666667,0.0375,0.05
1006-2021_03_20_201917.jpg,car,12,236,320,10,240,95,1,248,105,LTAdatasets/1006/annotate/1006-2021_03_20_201917.jpg,242.0,100.0,0.75625,0.4166666666666667,0.0375,0.041666666666666664
1006-2021_03_20_201317.jpg,car,12,227,320,7,240,92,1,239,99,LTAdatasets/1006/annotate/1006-2021_03_20_201317.jpg,233.0,95.5,0.728125,0.39791666666666664,0.0375,0.029166666666666667
1006-2021_03_20_201317.jpg,car,20,246,320,12,240,103,1,266,115,LTAdatasets/1006/annotate/1006-2021_03_20_201317.jpg,256.0,109.0,0.8,0.45416666666666666,0.0625,0.05
1006-2021_03_20_201317.jpg,car,12,214,320,9,240,101,1,226,110,LTAdatasets/1006/annotate/1006-2021_03_20_201317.jpg,220.0,105.5,0.6875,0.4395833333333333,0.0375,0.0375
1006-2021_03_20_201317.jpg,car,25,251,320,22,240,143,1,276,165,LTAdatasets/1006/annotate/1006-2021_03_20_201317.jpg,263.5,154.0,0.8234375,0.6416666666666667,0.078125,0.09166666666666666
1006-2021_03_20_205739.jpg,car,25,230,320,15,240,117,1,255,132,LTAdatasets/1006/annotate/1006-2021_03_20_205739.jpg,242.5,124.5,0.7578125,0.51875,0.078125,0.0625
1006-2021_03_20_205739.jpg,van,49,237,320,40,240,200,3,286,240,LTAdatasets/1006/annotate/1006-2021_03_20_205739.jpg,261.5,220.0,0.8171875,0.9166666666666666,0.153125,0.16666666666666666
1006-2021_03_20_182151.jpg,car,30,212,320,27,240,163,1,242,190,LTAdatasets/1006/annotate/1006-2021_03_20_182151.jpg,227.0,176.5,0.709375,0.7354166666666667,0.09375,0.1125
1006-2021_03_20_182151.jpg,car,21,256,320,15,240,112,1,277,127,LTAdatasets/1006/annotate/1006-2021_03_20_182151.jpg,266.5,119.5,0.8328125,0.4979166666666667,0.065625,0.0625
1006-2021_03_20_182151.jpg,car,14,237,320,12,240,94,1,251,106,LTAdatasets/1006/annotate/1006-2021_03_20_182151.jpg,244.0,100.0,0.7625,0.4166666666666667,0.04375,0.05
1006-2021_03_20_182151.jpg,van,15,205,320,12,240,95,3,220,107,LTAdatasets/1006/annotate/1006-2021_03_20_182151.jpg,212.5,101.0,0.6640625,0.42083333333333334,0.046875,0.05
1006-2021_03_20_182151.jpg,car,11,220,320,10,240,86,1,231,96,LTAdatasets/1006/annotate/1006-2021_03_20_182151.jpg,225.5,91.0,0.7046875,0.37916666666666665,0.034375,0.041666666666666664
1006-2021_03_20_182151.jpg,car,14,275,320,11,240,91,1,289,102,LTAdatasets/1006/annotate/1006-2021_03_20_182151.jpg,282.0,96.5,0.88125,0.40208333333333335,0.04375,0.04583333333333333
1006-2021_03_20_182151.jpg,car,13,275,320,8,240,84,1,288,92,LTAdatasets/1006/annotate/1006-2021_03_20_182151.jpg,281.5,88.0,0.8796875,0.36666666666666664,0.040625,0.03333333333333333
1006-2021_03_20_075138.jpg,car,31,286,320,29,240,174,1,317,203,LTAdatasets/1006/annotate/1006-2021_03_20_075138.jpg,301.5,188.5,0.9421875,0.7854166666666667,0.096875,0.12083333333333333
1006-2021_03_20_075138.jpg,car,15,247,320,16,240,104,1,262,120,LTAdatasets/1006/annotate/1006-2021_03_20_075138.jpg,254.5,112.0,0.7953125,0.4666666666666667,0.046875,0.06666666666666667
1006-2021_03_20_075138.jpg,bike,5,198,320,13,240,99,4,203,112,LTAdatasets/1006/annotate/1006-2021_03_20_075138.jpg,200.5,105.5,0.6265625,0.4395833333333333,0.015625,0.05416666666666667
1006-2021_03_20_060353.jpg,lorry_truck,35,209,320,32,240,154,2,244,186,LTAdatasets/1006/annotate/1006-2021_03_20_060353.jpg,226.5,170.0,0.7078125,0.7083333333333334,0.109375,0.13333333333333333
1006-2021_03_20_060353.jpg,car,24,255,320,16,240,110,1,279,126,LTAdatasets/1006/annotate/1006-2021_03_20_060353.jpg,267.0,118.0,0.834375,0.49166666666666664,0.075,0.06666666666666667
1006-2021_03_20_060353.jpg,car,14,209,320,12,240,93,1,223,105,LTAdatasets/1006/annotate/1006-2021_03_20_060353.jpg,216.0,99.0,0.675,0.4125,0.04375,0.05
1006-2021_03_20_184613.jpg,bike,13,220,320,21,240,154,4,233,175,LTAdatasets/1006/annotate/1006-2021_03_20_184613.jpg,226.5,164.5,0.7078125,0.6854166666666667,0.040625,0.0875
1006-2021_03_20_184613.jpg,car,17,270,320,16,240,114,1,287,130,LTAdatasets/1006/annotate/1006-2021_03_20_184613.jpg,278.5,122.0,0.8703125,0.5083333333333333,0.053125,0.06666666666666667
1006-2021_03_20_184613.jpg,car,18,197,320,15,240,120,1,215,135,LTAdatasets/1006/annotate/1006-2021_03_20_184613.jpg,206.0,127.5,0.64375,0.53125,0.05625,0.0625
1006-2021_03_20_184613.jpg,car,18,217,320,11,240,106,1,235,117,LTAdatasets/1006/annotate/1006-2021_03_20_184613.jpg,226.0,111.5,0.70625,0.46458333333333335,0.05625,0.04583333333333333
1006-2021_03_20_184613.jpg,car,12,265,320,12,240,84,1,277,96,LTAdatasets/1006/annotate/1006-2021_03_20_184613.jpg,271.0,90.0,0.846875,0.375,0.0375,0.05
1006-2021_03_20_220403.jpg,car,32,252,320,20,240,147,1,284,167,LTAdatasets/1006/annotate/1006-2021_03_20_220403.jpg,268.0,157.0,0.8375,0.6541666666666667,0.1,0.08333333333333333
1006-2021_03_20_220403.jpg,car,47,224,320,32,240,208,1,271,240,LTAdatasets/1006/annotate/1006-2021_03_20_220403.jpg,247.5,224.0,0.7734375,0.9333333333333333,0.146875,0.13333333333333333
1006-2021_03_20_220403.jpg,car,13,214,320,12,240,100,1,227,112,LTAdatasets/1006/annotate/1006-2021_03_20_220403.jpg,220.5,106.0,0.6890625,0.44166666666666665,0.040625,0.05
1006-2021_03_20_211300.jpg,car,13,230,320,11,240,92,1,243,103,LTAdatasets/1006/annotate/1006-2021_03_20_211300.jpg,236.5,97.5,0.7390625,0.40625,0.040625,0.04583333333333333
1006-2021_03_20_081319.jpg,car,39,247,320,30,240,173,1,286,203,LTAdatasets/1006/annotate/1006-2021_03_20_081319.jpg,266.5,188.0,0.8328125,0.7833333333333333,0.121875,0.125
1006-2021_03_20_073417.jpg,lorry_truck,61,209,320,58,240,182,2,270,240,LTAdatasets/1006/annotate/1006-2021_03_20_073417.jpg,239.5,211.0,0.7484375,0.8791666666666667,0.190625,0.24166666666666667
1006-2021_03_20_073417.jpg,car,14,220,320,8,240,87,1,234,95,LTAdatasets/1006/annotate/1006-2021_03_20_073417.jpg,227.0,91.0,0.709375,0.37916666666666665,0.04375,0.03333333333333333
1006-2021_03_20_093424.jpg,van,36,266,320,32,240,153,3,302,185,LTAdatasets/1006/annotate/1006-2021_03_20_093424.jpg,284.0,169.0,0.8875,0.7041666666666667,0.1125,0.13333333333333333
1006-2021_03_20_093424.jpg,car,16,242,320,14,240,98,1,258,112,LTAdatasets/1006/annotate/1006-2021_03_20_093424.jpg,250.0,105.0,0.78125,0.4375,0.05,0.058333333333333334
1006-2021_03_20_093424.jpg,van,17,211,320,12,240,98,3,228,110,LTAdatasets/1006/annotate/1006-2021_03_20_093424.jpg,219.5,104.0,0.6859375,0.43333333333333335,0.053125,0.05
1006-2021_03_20_093424.jpg,car,11,202,320,7,240,89,1,213,96,LTAdatasets/1006/annotate/1006-2021_03_20_093424.jpg,207.5,92.5,0.6484375,0.3854166666666667,0.034375,0.029166666666666667
1006-2021_03_20_093424.jpg,car,11,256,320,10,240,80,1,267,90,LTAdatasets/1006/annotate/1006-2021_03_20_093424.jpg,261.5,85.0,0.8171875,0.3541666666666667,0.034375,0.041666666666666664
1006-2021_03_20_083340.jpg,car,23,249,320,13,240,114,1,272,127,LTAdatasets/1006/annotate/1006-2021_03_20_083340.jpg,260.5,120.5,0.8140625,0.5020833333333333,0.071875,0.05416666666666667
1006-2021_03_20_180410.jpg,car,33,227,320,33,240,183,1,260,216,LTAdatasets/1006/annotate/1006-2021_03_20_180410.jpg,243.5,199.5,0.7609375,0.83125,0.103125,0.1375
1006-2021_03_20_180410.jpg,car,21,244,320,17,240,128,1,265,145,LTAdatasets/1006/annotate/1006-2021_03_20_180410.jpg,254.5,136.5,0.7953125,0.56875,0.065625,0.07083333333333333
1006-2021_03_20_180410.jpg,car,22,266,320,13,240,119,1,288,132,LTAdatasets/1006/annotate/1006-2021_03_20_180410.jpg,277.0,125.5,0.865625,0.5229166666666667,0.06875,0.05416666666666667
1006-2021_03_20_180410.jpg,car,20,193,320,14,240,117,1,213,131,LTAdatasets/1006/annotate/1006-2021_03_20_180410.jpg,203.0,124.0,0.634375,0.5166666666666667,0.0625,0.058333333333333334
1006-2021_03_20_180410.jpg,lorry_truck,34,261,320,36,240,144,2,295,180,LTAdatasets/1006/annotate/1006-2021_03_20_180410.jpg,278.0,162.0,0.86875,0.675,0.10625,0.15
1006-2021_03_20_180410.jpg,car,13,207,320,12,240,96,1,220,108,LTAdatasets/1006/annotate/1006-2021_03_20_180410.jpg,213.5,102.0,0.6671875,0.425,0.040625,0.05
1006-2021_03_20_180410.jpg,car,28,292,320,36,240,204,1,320,240,LTAdatasets/1006/annotate/1006-2021_03_20_180410.jpg,306.0,222.0,0.95625,0.925,0.0875,0.15
1006-2021_03_20_214902.jpg,car,10,201,320,20,240,142,1,211,162,LTAdatasets/1006/annotate/1006-2021_03_20_214902.jpg,206.0,152.0,0.64375,0.6333333333333333,0.03125,0.08333333333333333
1006-2021_03_20_214902.jpg,car,14,192,320,12,240,105,1,206,117,LTAdatasets/1006/annotate/1006-2021_03_20_214902.jpg,199.0,111.0,0.621875,0.4625,0.04375,0.05
1006-2021_03_20_214902.jpg,car,33,281,320,21,240,130,1,314,151,LTAdatasets/1006/annotate/1006-2021_03_20_214902.jpg,297.5,140.5,0.9296875,0.5854166666666667,0.103125,0.0875
1006-2021_03_20_185753.jpg,car,23,297,320,37,240,186,1,320,223,LTAdatasets/1006/annotate/1006-2021_03_20_185753.jpg,308.5,204.5,0.9640625,0.8520833333333333,0.071875,0.15416666666666667
1006-2021_03_20_185753.jpg,car,19,254,320,17,240,110,1,273,127,LTAdatasets/1006/annotate/1006-2021_03_20_185753.jpg,263.5,118.5,0.8234375,0.49375,0.059375,0.07083333333333333
1006-2021_03_20_185753.jpg,car,9,270,320,9,240,80,1,279,89,LTAdatasets/1006/annotate/1006-2021_03_20_185753.jpg,274.5,84.5,0.8578125,0.35208333333333336,0.028125,0.0375
1006-2021_03_20_185753.jpg,car,16,230,320,12,240,93,1,246,105,LTAdatasets/1006/annotate/1006-2021_03_20_185753.jpg,238.0,99.0,0.74375,0.4125,0.05,0.05
1006-2021_03_20_080719.jpg,bike,13,264,320,22,240,146,4,277,168,LTAdatasets/1006/annotate/1006-2021_03_20_080719.jpg,270.5,157.0,0.8453125,0.6541666666666667,0.040625,0.09166666666666666
1006-2021_03_20_080719.jpg,car,20,251,320,16,240,106,1,271,122,LTAdatasets/1006/annotate/1006-2021_03_20_080719.jpg,261.0,114.0,0.815625,0.475,0.0625,0.06666666666666667
1006-2021_03_20_080719.jpg,car,16,215,320,12,240,105,1,231,117,LTAdatasets/1006/annotate/1006-2021_03_20_080719.jpg,223.0,111.0,0.696875,0.4625,0.05,0.05
1006-2021_03_20_080719.jpg,bike,12,308,320,31,240,191,4,320,222,LTAdatasets/1006/annotate/1006-2021_03_20_080719.jpg,314.0,206.5,0.98125,0.8604166666666667,0.0375,0.12916666666666668
1006-2021_03_20_181851.jpg,car,27,220,320,17,240,143,1,247,160,LTAdatasets/1006/annotate/1006-2021_03_20_181851.jpg,233.5,151.5,0.7296875,0.63125,0.084375,0.07083333333333333
1006-2021_03_20_181851.jpg,car,19,301,320,18,240,144,1,320,162,LTAdatasets/1006/annotate/1006-2021_03_20_181851.jpg,310.5,153.0,0.9703125,0.6375,0.059375,0.075
1006-2021_03_20_181851.jpg,car,18,231,320,13,240,117,1,249,130,LTAdatasets/1006/annotate/1006-2021_03_20_181851.jpg,240.0,123.5,0.75,0.5145833333333333,0.05625,0.05416666666666667
1006-2021_03_20_181851.jpg,car,17,258,320,13,240,111,1,275,124,LTAdatasets/1006/annotate/1006-2021_03_20_181851.jpg,266.5,117.5,0.8328125,0.4895833333333333,0.053125,0.05416666666666667
1006-2021_03_20_181851.jpg,car,20,196,320,12,240,118,1,216,130,LTAdatasets/1006/annotate/1006-2021_03_20_181851.jpg,206.0,124.0,0.64375,0.5166666666666667,0.0625,0.05
1006-2021_03_20_181851.jpg,car,45,231,320,22,240,218,1,276,240,LTAdatasets/1006/annotate/1006-2021_03_20_181851.jpg,253.5,229.0,0.7921875,0.9541666666666667,0.140625,0.09166666666666666
1006-2021_03_20_181851.jpg,lorry_truck,13,213,320,12,240,98,2,226,110,LTAdatasets/1006/annotate/1006-2021_03_20_181851.jpg,219.5,104.0,0.6859375,0.43333333333333335,0.040625,0.05
1006-2021_03_20_181851.jpg,lorry_truck,11,191,320,14,240,96,2,202,110,LTAdatasets/1006/annotate/1006-2021_03_20_181851.jpg,196.5,103.0,0.6140625,0.42916666666666664,0.034375,0.058333333333333334
1006-2021_03_20_181851.jpg,car,13,221,320,8,240,89,1,234,97,LTAdatasets/1006/annotate/1006-2021_03_20_181851.jpg,227.5,93.0,0.7109375,0.3875,0.040625,0.03333333333333333
1006-2021_03_20_181851.jpg,bike,9,260,320,10,240,82,4,269,92,LTAdatasets/1006/annotate/1006-2021_03_20_181851.jpg,264.5,87.0,0.8265625,0.3625,0.028125,0.041666666666666664
1006-2021_03_20_181851.jpg,car,12,203,320,6,240,92,1,215,98,LTAdatasets/1006/annotate/1006-2021_03_20_181851.jpg,209.0,95.0,0.653125,0.3958333333333333,0.0375,0.025
1006-2021_03_20_090702.jpg,lorry_truck,36,203,320,39,240,118,2,239,157,LTAdatasets/1006/annotate/1006-2021_03_20_090702.jpg,221.0,137.5,0.690625,0.5729166666666666,0.1125,0.1625
1006-2021_03_20_090702.jpg,car,33,287,320,45,240,191,1,320,236,LTAdatasets/1006/annotate/1006-2021_03_20_090702.jpg,303.5,213.5,0.9484375,0.8895833333333333,0.103125,0.1875
1006-2021_03_20_090702.jpg,car,16,191,320,10,240,100,1,207,110,LTAdatasets/1006/annotate/1006-2021_03_20_090702.jpg,199.0,105.0,0.621875,0.4375,0.05,0.041666666666666664
1006-2021_03_20_090702.jpg,car,14,213,320,9,240,89,1,227,98,LTAdatasets/1006/annotate/1006-2021_03_20_090702.jpg,220.0,93.5,0.6875,0.38958333333333334,0.04375,0.0375
1006-2021_03_20_090702.jpg,car,16,279,320,9,240,83,1,295,92,LTAdatasets/1006/annotate/1006-2021_03_20_090702.jpg,287.0,87.5,0.896875,0.3645833333333333,0.05,0.0375
1006-2021_03_20_200416.jpg,car,16,217,320,14,240,102,1,233,116,LTAdatasets/1006/annotate/1006-2021_03_20_200416.jpg,225.0,109.0,0.703125,0.45416666666666666,0.05,0.058333333333333334
1006-2021_03_20_074318.jpg,car,22,194,320,17,240,131,1,216,148,LTAdatasets/1006/annotate/1006-2021_03_20_074318.jpg,205.0,139.5,0.640625,0.58125,0.06875,0.07083333333333333
1006-2021_03_20_074318.jpg,lorry_truck,39,251,320,33,240,138,2,290,171,LTAdatasets/1006/annotate/1006-2021_03_20_074318.jpg,270.5,154.5,0.8453125,0.64375,0.121875,0.1375
1006-2021_03_20_205139.jpg,bus,43,199,320,49,240,131,5,242,180,LTAdatasets/1006/annotate/1006-2021_03_20_205139.jpg,220.5,155.5,0.6890625,0.6479166666666667,0.134375,0.20416666666666666
1006-2021_03_20_205139.jpg,car,30,286,320,23,240,132,1,316,155,LTAdatasets/1006/annotate/1006-2021_03_20_205139.jpg,301.0,143.5,0.940625,0.5979166666666667,0.09375,0.09583333333333334
1006-2021_03_20_205139.jpg,car,21,223,320,21,240,110,1,244,131,LTAdatasets/1006/annotate/1006-2021_03_20_205139.jpg,233.5,120.5,0.7296875,0.5020833333333333,0.065625,0.0875
1006-2021_03_20_212801.jpg,car,42,234,320,27,240,213,1,276,240,LTAdatasets/1006/annotate/1006-2021_03_20_212801.jpg,255.0,226.5,0.796875,0.94375,0.13125,0.1125
1006-2021_03_20_062153.jpg,car,16,191,320,13,240,110,1,207,123,LTAdatasets/1006/annotate/1006-2021_03_20_062153.jpg,199.0,116.5,0.621875,0.48541666666666666,0.05,0.05416666666666667
1006-2021_03_20_193415.jpg,car,16,215,320,6,240,88,1,231,94,LTAdatasets/1006/annotate/1006-2021_03_20_193415.jpg,223.0,91.0,0.696875,0.37916666666666665,0.05,0.025
1006-2021_03_20_202437.jpg,car,17,229,320,17,240,117,1,246,134,LTAdatasets/1006/annotate/1006-2021_03_20_202437.jpg,237.5,125.5,0.7421875,0.5229166666666667,0.053125,0.07083333333333333
1006-2021_03_20_202437.jpg,car,23,297,320,25,240,138,1,320,163,LTAdatasets/1006/annotate/1006-2021_03_20_202437.jpg,308.5,150.5,0.9640625,0.6270833333333333,0.071875,0.10416666666666667
1006-2021_03_20_064855.jpg,car,21,189,320,18,240,119,1,210,137,LTAdatasets/1006/annotate/1006-2021_03_20_064855.jpg,199.5,128.0,0.6234375,0.5333333333333333,0.065625,0.075
1006-2021_03_20_194916.jpg,car,29,238,320,19,240,130,1,267,149,LTAdatasets/1006/annotate/1006-2021_03_20_194916.jpg,252.5,139.5,0.7890625,0.58125,0.090625,0.07916666666666666
1006-2021_03_20_073717.jpg,car,17,196,320,11,240,110,1,213,121,LTAdatasets/1006/annotate/1006-2021_03_20_073717.jpg,204.5,115.5,0.6390625,0.48125,0.053125,0.04583333333333333
1006-2021_03_20_073717.jpg,car,26,294,320,29,240,135,1,320,164,LTAdatasets/1006/annotate/1006-2021_03_20_073717.jpg,307.0,149.5,0.959375,0.6229166666666667,0.08125,0.12083333333333333
1006-2021_03_20_073717.jpg,bike,10,223,320,10,240,109,4,233,119,LTAdatasets/1006/annotate/1006-2021_03_20_073717.jpg,228.0,114.0,0.7125,0.475,0.03125,0.041666666666666664
1006-2021_03_20_073717.jpg,bike,9,208,320,13,240,93,4,217,106,LTAdatasets/1006/annotate/1006-2021_03_20_073717.jpg,212.5,99.5,0.6640625,0.41458333333333336,0.028125,0.05416666666666667
1006-2021_03_20_073717.jpg,car,15,233,320,10,240,94,1,248,104,LTAdatasets/1006/annotate/1006-2021_03_20_073717.jpg,240.5,99.0,0.7515625,0.4125,0.046875,0.041666666666666664
1006-2021_03_20_183712.jpg,car,29,219,320,21,240,170,1,248,191,LTAdatasets/1006/annotate/1006-2021_03_20_183712.jpg,233.5,180.5,0.7296875,0.7520833333333333,0.090625,0.0875
1006-2021_03_20_183712.jpg,car,23,246,320,21,240,135,1,269,156,LTAdatasets/1006/annotate/1006-2021_03_20_183712.jpg,257.5,145.5,0.8046875,0.60625,0.071875,0.0875
1006-2021_03_20_183712.jpg,car,23,275,320,21,240,121,1,298,142,LTAdatasets/1006/annotate/1006-2021_03_20_183712.jpg,286.5,131.5,0.8953125,0.5479166666666667,0.071875,0.0875
1006-2021_03_20_183712.jpg,car,15,218,320,12,240,109,1,233,121,LTAdatasets/1006/annotate/1006-2021_03_20_183712.jpg,225.5,115.0,0.7046875,0.4791666666666667,0.046875,0.05
1006-2021_03_20_183712.jpg,car,15,237,320,13,240,98,1,252,111,LTAdatasets/1006/annotate/1006-2021_03_20_183712.jpg,244.5,104.5,0.7640625,0.4354166666666667,0.046875,0.05416666666666667
1006-2021_03_20_183712.jpg,car,11,253,320,10,240,82,1,264,92,LTAdatasets/1006/annotate/1006-2021_03_20_183712.jpg,258.5,87.0,0.8078125,0.3625,0.034375,0.041666666666666664
1006-2021_03_20_183712.jpg,bike,11,199,320,21,240,144,4,210,165,LTAdatasets/1006/annotate/1006-2021_03_20_183712.jpg,204.5,154.5,0.6390625,0.64375,0.034375,0.0875
1006-2021_03_20_183712.jpg,car,12,275,320,8,240,83,1,287,91,LTAdatasets/1006/annotate/1006-2021_03_20_183712.jpg,281.0,87.0,0.878125,0.3625,0.0375,0.03333333333333333
1006-2021_03_20_215802.jpg,car,15,193,320,16,240,118,1,208,134,LTAdatasets/1006/annotate/1006-2021_03_20_215802.jpg,200.5,126.0,0.6265625,0.525,0.046875,0.06666666666666667
1006-2021_03_20_215802.jpg,car,17,219,320,11,240,108,1,236,119,LTAdatasets/1006/annotate/1006-2021_03_20_215802.jpg,227.5,113.5,0.7109375,0.47291666666666665,0.053125,0.04583333333333333
1006-2021_03_20_095505.jpg,car,23,242,320,18,240,129,1,265,147,LTAdatasets/1006/annotate/1006-2021_03_20_095505.jpg,253.5,138.0,0.7921875,0.575,0.071875,0.075
1006-2021_03_20_095505.jpg,car,26,236,320,23,240,156,1,262,179,LTAdatasets/1006/annotate/1006-2021_03_20_095505.jpg,249.0,167.5,0.778125,0.6979166666666666,0.08125,0.09583333333333334
1006-2021_03_20_095505.jpg,car,30,290,320,37,240,181,1,320,218,LTAdatasets/1006/annotate/1006-2021_03_20_095505.jpg,305.0,199.5,0.953125,0.83125,0.09375,0.15416666666666667
1006-2021_03_20_095505.jpg,car,26,284,320,21,240,125,1,310,146,LTAdatasets/1006/annotate/1006-2021_03_20_095505.jpg,297.0,135.5,0.928125,0.5645833333333333,0.08125,0.0875
1006-2021_03_20_095505.jpg,car,23,257,320,14,240,108,1,280,122,LTAdatasets/1006/annotate/1006-2021_03_20_095505.jpg,268.5,115.0,0.8390625,0.4791666666666667,0.071875,0.058333333333333334
1006-2021_03_20_095505.jpg,car,18,226,320,11,240,115,1,244,126,LTAdatasets/1006/annotate/1006-2021_03_20_095505.jpg,235.0,120.5,0.734375,0.5020833333333333,0.05625,0.04583333333333333
1006-2021_03_20_095505.jpg,car,15,195,320,10,240,117,1,210,127,LTAdatasets/1006/annotate/1006-2021_03_20_095505.jpg,202.5,122.0,0.6328125,0.5083333333333333,0.046875,0.041666666666666664
1006-2021_03_20_095505.jpg,car,12,192,320,12,240,103,1,204,115,LTAdatasets/1006/annotate/1006-2021_03_20_095505.jpg,198.0,109.0,0.61875,0.45416666666666666,0.0375,0.05
1006-2021_03_20_095505.jpg,car,15,214,320,6,240,98,1,229,104,LTAdatasets/1006/annotate/1006-2021_03_20_095505.jpg,221.5,101.0,0.6921875,0.42083333333333334,0.046875,0.025
1006-2021_03_20_095505.jpg,car,12,237,320,13,240,94,1,249,107,LTAdatasets/1006/annotate/1006-2021_03_20_095505.jpg,243.0,100.5,0.759375,0.41875,0.0375,0.05416666666666667
1006-2021_03_20_095505.jpg,lorry_truck,11,205,320,10,240,88,2,216,98,LTAdatasets/1006/annotate/1006-2021_03_20_095505.jpg,210.5,93.0,0.6578125,0.3875,0.034375,0.041666666666666664
1006-2021_03_20_183412.jpg,car,25,210,320,18,240,143,1,235,161,LTAdatasets/1006/annotate/1006-2021_03_20_183412.jpg,222.5,152.0,0.6953125,0.6333333333333333,0.078125,0.075
1006-2021_03_20_183412.jpg,car,21,230,320,16,240,117,1,251,133,LTAdatasets/1006/annotate/1006-2021_03_20_183412.jpg,240.5,125.0,0.7515625,0.5208333333333334,0.065625,0.06666666666666667
1006-2021_03_20_183412.jpg,car,15,253,320,13,240,107,1,268,120,LTAdatasets/1006/annotate/1006-2021_03_20_183412.jpg,260.5,113.5,0.8140625,0.47291666666666665,0.046875,0.05416666666666667
1006-2021_03_20_183412.jpg,car,17,208,320,9,240,96,1,225,105,LTAdatasets/1006/annotate/1006-2021_03_20_183412.jpg,216.5,100.5,0.6765625,0.41875,0.053125,0.0375
1006-2021_03_20_183412.jpg,car,17,303,320,27,240,143,1,320,170,LTAdatasets/1006/annotate/1006-2021_03_20_183412.jpg,311.5,156.5,0.9734375,0.6520833333333333,0.053125,0.1125
1006-2021_03_20_183412.jpg,car,36,235,320,35,240,193,1,271,228,LTAdatasets/1006/annotate/1006-2021_03_20_183412.jpg,253.0,210.5,0.790625,0.8770833333333333,0.1125,0.14583333333333334
1006-2021_03_20_183412.jpg,car,17,303,320,32,240,194,1,320,226,LTAdatasets/1006/annotate/1006-2021_03_20_183412.jpg,311.5,210.0,0.9734375,0.875,0.053125,0.13333333333333333
1006-2021_03_20_070416.jpg,lorry_truck,37,229,320,43,240,163,2,266,206,LTAdatasets/1006/annotate/1006-2021_03_20_070416.jpg,247.5,184.5,0.7734375,0.76875,0.115625,0.17916666666666667
1006-2021_03_20_070416.jpg,bike,13,209,320,20,240,134,4,222,154,LTAdatasets/1006/annotate/1006-2021_03_20_070416.jpg,215.5,144.0,0.6734375,0.6,0.040625,0.08333333333333333
1006-2021_03_20_070416.jpg,car,13,213,320,12,240,99,1,226,111,LTAdatasets/1006/annotate/1006-2021_03_20_070416.jpg,219.5,105.0,0.6859375,0.4375,0.040625,0.05
1006-2021_03_20_192214.jpg,car,33,264,320,32,240,154,1,297,186,LTAdatasets/1006/annotate/1006-2021_03_20_192214.jpg,280.5,170.0,0.8765625,0.7083333333333334,0.103125,0.13333333333333333
1006-2021_03_20_192214.jpg,car,20,259,320,15,240,113,1,279,128,LTAdatasets/1006/annotate/1006-2021_03_20_192214.jpg,269.0,120.5,0.840625,0.5020833333333333,0.0625,0.0625
1006-2021_03_20_192214.jpg,car,14,262,320,11,240,84,1,276,95,LTAdatasets/1006/annotate/1006-2021_03_20_192214.jpg,269.0,89.5,0.840625,0.3729166666666667,0.04375,0.04583333333333333
1006-2021_03_20_192214.jpg,van,12,285,320,9,240,84,3,297,93,LTAdatasets/1006/annotate/1006-2021_03_20_192214.jpg,291.0,88.5,0.909375,0.36875,0.0375,0.0375
1006-2021_03_20_192214.jpg,car,18,302,320,13,240,94,1,320,107,LTAdatasets/1006/annotate/1006-2021_03_20_192214.jpg,311.0,100.5,0.971875,0.41875,0.05625,0.05416666666666667
1006-2021_03_20_072817.jpg,bike,10,207,320,22,240,152,4,217,174,LTAdatasets/1006/annotate/1006-2021_03_20_072817.jpg,212.0,163.0,0.6625,0.6791666666666667,0.03125,0.09166666666666666
1006-2021_03_20_063354.jpg,bike,10,223,320,15,240,101,4,233,116,LTAdatasets/1006/annotate/1006-2021_03_20_063354.jpg,228.0,108.5,0.7125,0.45208333333333334,0.03125,0.0625
1006-2021_03_20_063354.jpg,lorry_truck,18,182,320,19,240,89,2,200,108,LTAdatasets/1006/annotate/1006-2021_03_20_063354.jpg,191.0,98.5,0.596875,0.41041666666666665,0.05625,0.07916666666666666
1006-2021_03_20_212501.jpg,car,15,214,320,10,240,101,1,229,111,LTAdatasets/1006/annotate/1006-2021_03_20_212501.jpg,221.5,106.0,0.6921875,0.44166666666666665,0.046875,0.041666666666666664
1006-2021_03_20_085822.jpg,car,25,248,320,17,240,132,1,273,149,LTAdatasets/1006/annotate/1006-2021_03_20_085822.jpg,260.5,140.5,0.8140625,0.5854166666666667,0.078125,0.07083333333333333
1006-2021_03_20_085822.jpg,car,17,191,320,15,240,118,1,208,133,LTAdatasets/1006/annotate/1006-2021_03_20_085822.jpg,199.5,125.5,0.6234375,0.5229166666666667,0.053125,0.0625
1006-2021_03_20_085822.jpg,car,17,223,320,11,240,108,1,240,119,LTAdatasets/1006/annotate/1006-2021_03_20_085822.jpg,231.5,113.5,0.7234375,0.47291666666666665,0.053125,0.04583333333333333
1006-2021_03_20_085822.jpg,car,16,241,320,12,240,100,1,257,112,LTAdatasets/1006/annotate/1006-2021_03_20_085822.jpg,249.0,106.0,0.778125,0.44166666666666665,0.05,0.05
1006-2021_03_20_085822.jpg,lorry_truck,28,206,320,24,240,136,2,234,160,LTAdatasets/1006/annotate/1006-2021_03_20_085822.jpg,220.0,148.0,0.6875,0.6166666666666667,0.0875,0.1
1006-2021_03_20_085822.jpg,van,39,272,320,34,240,160,3,311,194,LTAdatasets/1006/annotate/1006-2021_03_20_085822.jpg,291.5,177.0,0.9109375,0.7375,0.121875,0.14166666666666666
1006-2021_03_20_085822.jpg,car,10,188,320,10,240,100,1,198,110,LTAdatasets/1006/annotate/1006-2021_03_20_085822.jpg,193.0,105.0,0.603125,0.4375,0.03125,0.041666666666666664
1006-2021_03_20_075818.jpg,bike,14,274,320,25,240,164,4,288,189,LTAdatasets/1006/annotate/1006-2021_03_20_075818.jpg,281.0,176.5,0.878125,0.7354166666666667,0.04375,0.10416666666666667
1006-2021_03_20_075818.jpg,car,33,211,320,24,240,162,1,244,186,LTAdatasets/1006/annotate/1006-2021_03_20_075818.jpg,227.5,174.0,0.7109375,0.725,0.103125,0.1
1006-2021_03_20_075818.jpg,car,28,240,320,16,240,135,1,268,151,LTAdatasets/1006/annotate/1006-2021_03_20_075818.jpg,254.0,143.0,0.79375,0.5958333333333333,0.0875,0.06666666666666667
1006-2021_03_20_075818.jpg,lorry_truck,21,193,320,20,240,119,2,214,139,LTAdatasets/1006/annotate/1006-2021_03_20_075818.jpg,203.5,129.0,0.6359375,0.5375,0.065625,0.08333333333333333
1006-2021_03_20_084301.jpg,lorry_truck,26,192,320,35,240,111,2,218,146,LTAdatasets/1006/annotate/1006-2021_03_20_084301.jpg,205.0,128.5,0.640625,0.5354166666666667,0.08125,0.14583333333333334
1006-2021_03_20_084301.jpg,car,34,267,320,24,240,158,1,301,182,LTAdatasets/1006/annotate/1006-2021_03_20_084301.jpg,284.0,170.0,0.8875,0.7083333333333334,0.10625,0.1
1006-2021_03_20_084301.jpg,car,28,270,320,14,240,120,1,298,134,LTAdatasets/1006/annotate/1006-2021_03_20_084301.jpg,284.0,127.0,0.8875,0.5291666666666667,0.0875,0.058333333333333334
1006-2021_03_20_084301.jpg,car,17,222,320,11,240,110,1,239,121,LTAdatasets/1006/annotate/1006-2021_03_20_084301.jpg,230.5,115.5,0.7203125,0.48125,0.053125,0.04583333333333333
1006-2021_03_20_084301.jpg,car,15,241,320,9,240,100,1,256,109,LTAdatasets/1006/annotate/1006-2021_03_20_084301.jpg,248.5,104.5,0.7765625,0.4354166666666667,0.046875,0.0375
1006-2021_03_20_082740.jpg,van,28,232,320,15,240,124,3,260,139,LTAdatasets/1006/annotate/1006-2021_03_20_082740.jpg,246.0,131.5,0.76875,0.5479166666666667,0.0875,0.0625
1006-2021_03_20_082740.jpg,van,18,193,320,19,240,122,3,211,141,LTAdatasets/1006/annotate/1006-2021_03_20_082740.jpg,202.0,131.5,0.63125,0.5479166666666667,0.05625,0.07916666666666666
1006-2021_03_20_082740.jpg,van,17,190,320,12,240,105,3,207,117,LTAdatasets/1006/annotate/1006-2021_03_20_082740.jpg,198.5,111.0,0.6203125,0.4625,0.053125,0.05
1006-2021_03_20_082740.jpg,car,12,211,320,11,240,94,1,223,105,LTAdatasets/1006/annotate/1006-2021_03_20_082740.jpg,217.0,99.5,0.678125,0.41458333333333336,0.0375,0.04583333333333333
1006-2021_03_20_062754.jpg,bike,12,202,320,21,240,124,4,214,145,LTAdatasets/1006/annotate/1006-2021_03_20_062754.jpg,208.0,134.5,0.65,0.5604166666666667,0.0375,0.0875
1006-2021_03_20_062754.jpg,car,21,226,320,16,240,122,1,247,138,LTAdatasets/1006/annotate/1006-2021_03_20_062754.jpg,236.5,130.0,0.7390625,0.5416666666666666,0.065625,0.06666666666666667
1006-2021_03_20_071836.jpg,car,28,292,320,37,240,189,1,320,226,LTAdatasets/1006/annotate/1006-2021_03_20_071836.jpg,306.0,207.5,0.95625,0.8645833333333334,0.0875,0.15416666666666667
1006-2021_03_20_071836.jpg,car,26,205,320,18,240,134,1,231,152,LTAdatasets/1006/annotate/1006-2021_03_20_071836.jpg,218.0,143.0,0.68125,0.5958333333333333,0.08125,0.075
1006-2021_03_20_071836.jpg,car,17,272,320,20,240,117,1,289,137,LTAdatasets/1006/annotate/1006-2021_03_20_071836.jpg,280.5,127.0,0.8765625,0.5291666666666667,0.053125,0.08333333333333333
1006-2021_03_20_071836.jpg,car,17,234,320,9,240,100,1,251,109,LTAdatasets/1006/annotate/1006-2021_03_20_071836.jpg,242.5,104.5,0.7578125,0.4354166666666667,0.053125,0.0375
1006-2021_03_20_071836.jpg,car,16,197,320,13,240,110,1,213,123,LTAdatasets/1006/annotate/1006-2021_03_20_071836.jpg,205.0,116.5,0.640625,0.48541666666666666,0.05,0.05416666666666667
1006-2021_03_20_071836.jpg,van,13,205,320,9,240,92,3,218,101,LTAdatasets/1006/annotate/1006-2021_03_20_071836.jpg,211.5,96.5,0.6609375,0.40208333333333335,0.040625,0.0375
1006-2021_03_20_071836.jpg,van,10,219,320,6,240,86,3,229,92,LTAdatasets/1006/annotate/1006-2021_03_20_071836.jpg,224.0,89.0,0.7,0.37083333333333335,0.03125,0.025
1006-2021_03_20_071836.jpg,car,12,289,320,8,240,81,1,301,89,LTAdatasets/1006/annotate/1006-2021_03_20_071836.jpg,295.0,85.0,0.921875,0.3541666666666667,0.0375,0.03333333333333333
1006-2021_03_20_064254.jpg,car,20,199,320,19,240,112,1,219,131,LTAdatasets/1006/annotate/1006-2021_03_20_064254.jpg,209.0,121.5,0.653125,0.50625,0.0625,0.07916666666666666
1006-2021_03_20_210940.jpg,car,16,193,320,15,240,115,1,209,130,LTAdatasets/1006/annotate/1006-2021_03_20_210940.jpg,201.0,122.5,0.628125,0.5104166666666666,0.05,0.0625
1006-2021_03_20_211900.jpg,bus,70,250,320,76,240,124,5,320,200,LTAdatasets/1006/annotate/1006-2021_03_20_211900.jpg,285.0,162.0,0.890625,0.675,0.21875,0.31666666666666665
1006-2021_03_20_211900.jpg,car,42,225,320,40,240,195,1,267,235,LTAdatasets/1006/annotate/1006-2021_03_20_211900.jpg,246.0,215.0,0.76875,0.8958333333333334,0.13125,0.16666666666666666
1006-2021_03_20_211900.jpg,car,23,195,320,16,240,111,1,218,127,LTAdatasets/1006/annotate/1006-2021_03_20_211900.jpg,206.5,119.0,0.6453125,0.49583333333333335,0.071875,0.06666666666666667
1006-2021_03_20_211900.jpg,car,14,219,320,14,240,101,1,233,115,LTAdatasets/1006/annotate/1006-2021_03_20_211900.jpg,226.0,108.0,0.70625,0.45,0.04375,0.058333333333333334
1006-2021_03_20_090402.jpg,car,33,258,320,20,240,155,1,291,175,LTAdatasets/1006/annotate/1006-2021_03_20_090402.jpg,274.5,165.0,0.8578125,0.6875,0.103125,0.08333333333333333
1006-2021_03_20_090402.jpg,car,29,263,320,19,240,119,1,292,138,LTAdatasets/1006/annotate/1006-2021_03_20_090402.jpg,277.5,128.5,0.8671875,0.5354166666666667,0.090625,0.07916666666666666
1006-2021_03_20_090402.jpg,car,20,243,320,11,240,104,1,263,115,LTAdatasets/1006/annotate/1006-2021_03_20_090402.jpg,253.0,109.5,0.790625,0.45625,0.0625,0.04583333333333333
1006-2021_03_20_090402.jpg,van,14,214,320,12,240,94,3,228,106,LTAdatasets/1006/annotate/1006-2021_03_20_090402.jpg,221.0,100.0,0.690625,0.4166666666666667,0.04375,0.05
1006-2021_03_20_090402.jpg,car,11,230,320,10,240,89,1,241,99,LTAdatasets/1006/annotate/1006-2021_03_20_090402.jpg,235.5,94.0,0.7359375,0.39166666666666666,0.034375,0.041666666666666664
1006-2021_03_20_090402.jpg,car,12,203,320,6,240,92,1,215,98,LTAdatasets/1006/annotate/1006-2021_03_20_090402.jpg,209.0,95.0,0.653125,0.3958333333333333,0.0375,0.025
1006-2021_03_20_072216.jpg,car,14,217,320,15,240,102,1,231,117,LTAdatasets/1006/annotate/1006-2021_03_20_072216.jpg,224.0,109.5,0.7,0.45625,0.04375,0.0625
1006-2021_03_20_100405.jpg,car,35,285,320,30,240,182,1,320,212,LTAdatasets/1006/annotate/1006-2021_03_20_100405.jpg,302.5,197.0,0.9453125,0.8208333333333333,0.109375,0.125
1006-2021_03_20_100405.jpg,lorry_truck,67,226,320,57,240,183,2,293,240,LTAdatasets/1006/annotate/1006-2021_03_20_100405.jpg,259.5,211.5,0.8109375,0.88125,0.209375,0.2375
1006-2021_03_20_100405.jpg,lorry_truck,31,190,320,33,240,101,2,221,134,LTAdatasets/1006/annotate/1006-2021_03_20_100405.jpg,205.5,117.5,0.6421875,0.4895833333333333,0.096875,0.1375
1006-2021_03_20_100405.jpg,car,21,252,320,14,240,104,1,273,118,LTAdatasets/1006/annotate/1006-2021_03_20_100405.jpg,262.5,111.0,0.8203125,0.4625,0.065625,0.058333333333333334
1006-2021_03_20_100405.jpg,car,12,237,320,12,240,92,1,249,104,LTAdatasets/1006/annotate/1006-2021_03_20_100405.jpg,243.0,98.0,0.759375,0.4083333333333333,0.0375,0.05
1006-2021_03_20_100405.jpg,car,10,223,320,10,240,86,1,233,96,LTAdatasets/1006/annotate/1006-2021_03_20_100405.jpg,228.0,91.0,0.7125,0.37916666666666665,0.03125,0.041666666666666664
1006-2021_03_20_100405.jpg,car,11,214,320,10,240,93,1,225,103,LTAdatasets/1006/annotate/1006-2021_03_20_100405.jpg,219.5,98.0,0.6859375,0.4083333333333333,0.034375,0.041666666666666664
1006-2021_03_20_100405.jpg,lorry_truck,17,266,320,10,240,69,2,283,79,LTAdatasets/1006/annotate/1006-2021_03_20_100405.jpg,274.5,74.0,0.8578125,0.30833333333333335,0.053125,0.041666666666666664
1006-2021_03_20_203358.jpg,car,20,219,320,14,240,108,1,239,122,LTAdatasets/1006/annotate/1006-2021_03_20_203358.jpg,229.0,115.0,0.715625,0.4791666666666667,0.0625,0.058333333333333334
1006-2021_03_20_100105.jpg,car,34,209,320,27,240,174,1,243,201,LTAdatasets/1006/annotate/1006-2021_03_20_100105.jpg,226.0,187.5,0.70625,0.78125,0.10625,0.1125
1006-2021_03_20_100105.jpg,car,36,275,320,25,240,172,1,311,197,LTAdatasets/1006/annotate/1006-2021_03_20_100105.jpg,293.0,184.5,0.915625,0.76875,0.1125,0.10416666666666667
1006-2021_03_20_100105.jpg,van,26,201,320,25,240,125,3,227,150,LTAdatasets/1006/annotate/1006-2021_03_20_100105.jpg,214.0,137.5,0.66875,0.5729166666666666,0.08125,0.10416666666666667
1006-2021_03_20_100105.jpg,car,20,256,320,11,240,112,1,276,123,LTAdatasets/1006/annotate/1006-2021_03_20_100105.jpg,266.0,117.5,0.83125,0.4895833333333333,0.0625,0.04583333333333333
1006-2021_03_20_100105.jpg,car,19,221,320,13,240,105,1,240,118,LTAdatasets/1006/annotate/1006-2021_03_20_100105.jpg,230.5,111.5,0.7203125,0.46458333333333335,0.059375,0.05416666666666667
1006-2021_03_20_100105.jpg,car,13,196,320,15,240,110,1,209,125,LTAdatasets/1006/annotate/1006-2021_03_20_100105.jpg,202.5,117.5,0.6328125,0.4895833333333333,0.040625,0.0625
1006-2021_03_20_100105.jpg,car,13,237,320,12,240,95,1,250,107,LTAdatasets/1006/annotate/1006-2021_03_20_100105.jpg,243.5,101.0,0.7609375,0.42083333333333334,0.040625,0.05
1006-2021_03_20_100105.jpg,car,13,213,320,12,240,97,1,226,109,LTAdatasets/1006/annotate/1006-2021_03_20_100105.jpg,219.5,103.0,0.6859375,0.42916666666666664,0.040625,0.05
1006-2021_03_20_100105.jpg,car,38,226,320,21,240,219,1,264,240,LTAdatasets/1006/annotate/1006-2021_03_20_100105.jpg,245.0,229.5,0.765625,0.95625,0.11875,0.0875
1006-2021_03_20_100105.jpg,car,12,228,320,6,240,89,1,240,95,LTAdatasets/1006/annotate/1006-2021_03_20_100105.jpg,234.0,92.0,0.73125,0.38333333333333336,0.0375,0.025
1006-2021_03_20_101005.jpg,car,33,283,320,27,240,166,1,316,193,LTAdatasets/1006/annotate/1006-2021_03_20_101005.jpg,299.5,179.5,0.9359375,0.7479166666666667,0.103125,0.1125
1006-2021_03_20_101005.jpg,car,17,300,320,15,240,95,1,317,110,LTAdatasets/1006/annotate/1006-2021_03_20_101005.jpg,308.5,102.5,0.9640625,0.4270833333333333,0.053125,0.0625
1006-2021_03_20_101005.jpg,car,16,250,320,10,240,104,1,266,114,LTAdatasets/1006/annotate/1006-2021_03_20_101005.jpg,258.0,109.0,0.80625,0.45416666666666666,0.05,0.041666666666666664
1006-2021_03_20_101005.jpg,car,18,229,320,13,240,117,1,247,130,LTAdatasets/1006/annotate/1006-2021_03_20_101005.jpg,238.0,123.5,0.74375,0.5145833333333333,0.05625,0.05416666666666667
1006-2021_03_20_101005.jpg,car,16,191,320,14,240,110,1,207,124,LTAdatasets/1006/annotate/1006-2021_03_20_101005.jpg,199.0,117.0,0.621875,0.4875,0.05,0.058333333333333334
1006-2021_03_20_101005.jpg,car,13,211,320,9,240,95,1,224,104,LTAdatasets/1006/annotate/1006-2021_03_20_101005.jpg,217.5,99.5,0.6796875,0.41458333333333336,0.040625,0.0375
1006-2021_03_20_101005.jpg,car,11,229,320,9,240,86,1,240,95,LTAdatasets/1006/annotate/1006-2021_03_20_101005.jpg,234.5,90.5,0.7328125,0.3770833333333333,0.034375,0.0375
1006-2021_03_20_101005.jpg,lorry_truck,30,209,320,33,240,138,2,239,171,LTAdatasets/1006/annotate/1006-2021_03_20_101005.jpg,224.0,154.5,0.7,0.64375,0.09375,0.1375
1006-2021_03_20_101005.jpg,car,11,202,320,6,240,85,1,213,91,LTAdatasets/1006/annotate/1006-2021_03_20_101005.jpg,207.5,88.0,0.6484375,0.36666666666666664,0.034375,0.025
1006-2021_03_20_195736.jpg,car,26,265,320,15,240,111,1,291,126,LTAdatasets/1006/annotate/1006-2021_03_20_195736.jpg,278.0,118.5,0.86875,0.49375,0.08125,0.0625
1006-2021_03_20_195736.jpg,car,14,242,320,14,240,96,1,256,110,LTAdatasets/1006/annotate/1006-2021_03_20_195736.jpg,249.0,103.0,0.778125,0.42916666666666664,0.04375,0.058333333333333334
1006-2021_03_20_195736.jpg,car,15,213,320,12,240,98,1,228,110,LTAdatasets/1006/annotate/1006-2021_03_20_195736.jpg,220.5,104.0,0.6890625,0.43333333333333335,0.046875,0.05
1006-2021_03_20_185153.jpg,car,24,290,320,21,240,130,1,314,151,LTAdatasets/1006/annotate/1006-2021_03_20_185153.jpg,302.0,140.5,0.94375,0.5854166666666667,0.075,0.0875
1006-2021_03_20_185153.jpg,car,20,224,320,12,240,115,1,244,127,LTAdatasets/1006/annotate/1006-2021_03_20_185153.jpg,234.0,121.0,0.73125,0.5041666666666667,0.0625,0.05
1006-2021_03_20_185153.jpg,lorry_truck,29,202,320,40,240,119,2,231,159,LTAdatasets/1006/annotate/1006-2021_03_20_185153.jpg,216.5,139.0,0.6765625,0.5791666666666667,0.090625,0.16666666666666666
1006-2021_03_20_185153.jpg,car,15,192,320,14,240,108,1,207,122,LTAdatasets/1006/annotate/1006-2021_03_20_185153.jpg,199.5,115.0,0.6234375,0.4791666666666667,0.046875,0.058333333333333334
1006-2021_03_20_185153.jpg,bike,10,183,320,15,240,114,4,193,129,LTAdatasets/1006/annotate/1006-2021_03_20_185153.jpg,188.0,121.5,0.5875,0.50625,0.03125,0.0625
1006-2021_03_20_185153.jpg,car,14,232,320,9,240,96,1,246,105,LTAdatasets/1006/annotate/1006-2021_03_20_185153.jpg,239.0,100.5,0.746875,0.41875,0.04375,0.0375
1006-2021_03_20_185153.jpg,car,15,215,320,8,240,102,1,230,110,LTAdatasets/1006/annotate/1006-2021_03_20_185153.jpg,222.5,106.0,0.6953125,0.44166666666666665,0.046875,0.03333333333333333
1006-2021_03_20_185153.jpg,car,12,262,320,9,240,84,1,274,93,LTAdatasets/1006/annotate/1006-2021_03_20_185153.jpg,268.0,88.5,0.8375,0.36875,0.0375,0.0375
1006-2021_03_20_181251.jpg,car,25,241,320,19,240,130,1,266,149,LTAdatasets/1006/annotate/1006-2021_03_20_181251.jpg,253.5,139.5,0.7921875,0.58125,0.078125,0.07916666666666666
1006-2021_03_20_181251.jpg,car,26,294,320,25,240,138,1,320,163,LTAdatasets/1006/annotate/1006-2021_03_20_181251.jpg,307.0,150.5,0.959375,0.6270833333333333,0.08125,0.10416666666666667
1006-2021_03_20_181251.jpg,car,15,250,320,11,240,105,1,265,116,LTAdatasets/1006/annotate/1006-2021_03_20_181251.jpg,257.5,110.5,0.8046875,0.46041666666666664,0.046875,0.04583333333333333
1006-2021_03_20_181251.jpg,car,14,213,320,8,240,94,1,227,102,LTAdatasets/1006/annotate/1006-2021_03_20_181251.jpg,220.0,98.0,0.6875,0.4083333333333333,0.04375,0.03333333333333333
1006-2021_03_20_181251.jpg,car,14,189,320,9,240,105,1,203,114,LTAdatasets/1006/annotate/1006-2021_03_20_181251.jpg,196.0,109.5,0.6125,0.45625,0.04375,0.0375
1006-2021_03_20_181251.jpg,car,12,277,320,9,240,93,1,289,102,LTAdatasets/1006/annotate/1006-2021_03_20_181251.jpg,283.0,97.5,0.884375,0.40625,0.0375,0.0375
1006-2021_03_20_080419.jpg,car,25,261,320,17,240,133,1,286,150,LTAdatasets/1006/annotate/1006-2021_03_20_080419.jpg,273.5,141.5,0.8546875,0.5895833333333333,0.078125,0.07083333333333333
1006-2021_03_20_080419.jpg,car,15,196,320,12,240,116,1,211,128,LTAdatasets/1006/annotate/1006-2021_03_20_080419.jpg,203.5,122.0,0.6359375,0.5083333333333333,0.046875,0.05
1006-2021_03_20_080419.jpg,car,14,193,320,10,240,104,1,207,114,LTAdatasets/1006/annotate/1006-2021_03_20_080419.jpg,200.0,109.0,0.625,0.45416666666666666,0.04375,0.041666666666666664
1006-2021_03_20_080419.jpg,bike,11,232,320,11,240,108,4,243,119,LTAdatasets/1006/annotate/1006-2021_03_20_080419.jpg,237.5,113.5,0.7421875,0.47291666666666665,0.034375,0.04583333333333333
1006-2021_03_20_080419.jpg,car,17,279,320,8,240,92,1,296,100,LTAdatasets/1006/annotate/1006-2021_03_20_080419.jpg,287.5,96.0,0.8984375,0.4,0.053125,0.03333333333333333
1006-2021_03_20_193635.jpg,car,23,259,320,14,240,113,1,282,127,LTAdatasets/1006/annotate/1006-2021_03_20_193635.jpg,270.5,120.0,0.8453125,0.5,0.071875,0.058333333333333334
1006-2021_03_20_092803.jpg,car,32,200,320,23,240,142,1,232,165,LTAdatasets/1006/annotate/1006-2021_03_20_092803.jpg,216.0,153.5,0.675,0.6395833333333333,0.1,0.09583333333333334
1006-2021_03_20_092803.jpg,car,18,226,320,14,240,112,1,244,126,LTAdatasets/1006/annotate/1006-2021_03_20_092803.jpg,235.0,119.0,0.734375,0.49583333333333335,0.05625,0.058333333333333334
1006-2021_03_20_092803.jpg,car,20,191,320,12,240,109,1,211,121,LTAdatasets/1006/annotate/1006-2021_03_20_092803.jpg,201.0,115.0,0.628125,0.4791666666666667,0.0625,0.05
1006-2021_03_20_092803.jpg,car,13,230,320,8,240,91,1,243,99,LTAdatasets/1006/annotate/1006-2021_03_20_092803.jpg,236.5,95.0,0.7390625,0.3958333333333333,0.040625,0.03333333333333333
1006-2021_03_20_083640.jpg,car,36,276,320,29,240,170,1,312,199,LTAdatasets/1006/annotate/1006-2021_03_20_083640.jpg,294.0,184.5,0.91875,0.76875,0.1125,0.12083333333333333
1006-2021_03_20_083640.jpg,car,17,256,320,13,240,109,1,273,122,LTAdatasets/1006/annotate/1006-2021_03_20_083640.jpg,264.5,115.5,0.8265625,0.48125,0.053125,0.05416666666666667
1006-2021_03_20_083640.jpg,car,13,217,320,9,240,101,1,230,110,LTAdatasets/1006/annotate/1006-2021_03_20_083640.jpg,223.5,105.5,0.6984375,0.4395833333333333,0.040625,0.0375
1006-2021_03_20_083640.jpg,car,16,233,320,9,240,94,1,249,103,LTAdatasets/1006/annotate/1006-2021_03_20_083640.jpg,241.0,98.5,0.753125,0.41041666666666665,0.05,0.0375
1006-2021_03_20_214302.jpg,bike,14,274,320,24,240,158,4,288,182,LTAdatasets/1006/annotate/1006-2021_03_20_214302.jpg,281.0,170.0,0.878125,0.7083333333333334,0.04375,0.1
1006-2021_03_20_214302.jpg,car,21,225,320,15,240,114,1,246,129,LTAdatasets/1006/annotate/1006-2021_03_20_214302.jpg,235.5,121.5,0.7359375,0.50625,0.065625,0.0625
1006-2021_03_20_204238.jpg,car,33,277,320,32,240,161,1,310,193,LTAdatasets/1006/annotate/1006-2021_03_20_204238.jpg,293.5,177.0,0.9171875,0.7375,0.103125,0.13333333333333333
1006-2021_03_20_204238.jpg,car,19,252,320,15,240,105,1,271,120,LTAdatasets/1006/annotate/1006-2021_03_20_204238.jpg,261.5,112.5,0.8171875,0.46875,0.059375,0.0625
1006-2021_03_20_182752.jpg,car,31,257,320,25,240,161,1,288,186,LTAdatasets/1006/annotate/1006-2021_03_20_182752.jpg,272.5,173.5,0.8515625,0.7229166666666667,0.096875,0.10416666666666667
1006-2021_03_20_182752.jpg,car,21,251,320,12,240,106,1,272,118,LTAdatasets/1006/annotate/1006-2021_03_20_182752.jpg,261.5,112.0,0.8171875,0.4666666666666667,0.065625,0.05
1006-2021_03_20_182752.jpg,car,15,188,320,11,240,101,1,203,112,LTAdatasets/1006/annotate/1006-2021_03_20_182752.jpg,195.5,106.5,0.6109375,0.44375,0.046875,0.04583333333333333
1006-2021_03_20_190634.jpg,car,23,200,320,19,240,129,1,223,148,LTAdatasets/1006/annotate/1006-2021_03_20_190634.jpg,211.5,138.5,0.6609375,0.5770833333333333,0.071875,0.07916666666666666
1006-2021_03_20_190634.jpg,car,21,226,320,14,240,119,1,247,133,LTAdatasets/1006/annotate/1006-2021_03_20_190634.jpg,236.5,126.0,0.7390625,0.525,0.065625,0.058333333333333334
1006-2021_03_20_190634.jpg,car,13,265,320,8,240,79,1,278,87,LTAdatasets/1006/annotate/1006-2021_03_20_190634.jpg,271.5,83.0,0.8484375,0.3458333333333333,0.040625,0.03333333333333333
1001-2021_03_20_072216.jpg,bike,18,288,320,21,240,81,4,306,102,LTAdatasets/1001/annotate/1001-2021_03_20_072216.jpg,297.0,91.5,0.928125,0.38125,0.05625,0.0875
1001-2021_03_20_080719.jpg,lorry_truck,70,76,320,52,240,188,2,146,240,LTAdatasets/1001/annotate/1001-2021_03_20_080719.jpg,111.0,214.0,0.346875,0.8916666666666667,0.21875,0.21666666666666667
1001-2021_03_20_074318.jpg,car,21,246,320,19,240,45,1,267,64,LTAdatasets/1001/annotate/1001-2021_03_20_074318.jpg,256.5,54.5,0.8015625,0.22708333333333333,0.065625,0.07916666666666666
1001-2021_03_20_194616.jpg,car,33,83,320,37,240,119,1,116,156,LTAdatasets/1001/annotate/1001-2021_03_20_194616.jpg,99.5,137.5,0.3109375,0.5729166666666666,0.103125,0.15416666666666667
1001-2021_03_20_214302.jpg,car,38,270,320,40,240,101,1,308,141,LTAdatasets/1001/annotate/1001-2021_03_20_214302.jpg,289.0,121.0,0.903125,0.5041666666666667,0.11875,0.16666666666666666
1001-2021_03_20_215222.jpg,lorry_truck,33,84,320,56,240,73,2,117,129,LTAdatasets/1001/annotate/1001-2021_03_20_215222.jpg,100.5,101.0,0.3140625,0.42083333333333334,0.103125,0.23333333333333334
1001-2021_03_20_205739.jpg,car,15,223,320,13,240,32,1,238,45,LTAdatasets/1001/annotate/1001-2021_03_20_205739.jpg,230.5,38.5,0.7203125,0.16041666666666668,0.046875,0.05416666666666667
1001-2021_03_20_211300.jpg,car,18,81,320,23,240,56,1,99,79,LTAdatasets/1001/annotate/1001-2021_03_20_211300.jpg,90.0,67.5,0.28125,0.28125,0.05625,0.09583333333333334
1001-2021_03_20_211300.jpg,car,31,275,320,23,240,67,1,306,90,LTAdatasets/1001/annotate/1001-2021_03_20_211300.jpg,290.5,78.5,0.9078125,0.32708333333333334,0.096875,0.09583333333333334
1001-2021_03_20_211300.jpg,car,15,305,320,24,240,130,1,320,154,LTAdatasets/1001/annotate/1001-2021_03_20_211300.jpg,312.5,142.0,0.9765625,0.5916666666666667,0.046875,0.1
1001-2021_03_20_201317.jpg,bike,13,282,320,24,240,103,4,295,127,LTAdatasets/1001/annotate/1001-2021_03_20_201317.jpg,288.5,115.0,0.9015625,0.4791666666666667,0.040625,0.1
1001-2021_03_20_201317.jpg,car,18,218,320,10,240,44,1,236,54,LTAdatasets/1001/annotate/1001-2021_03_20_201317.jpg,227.0,49.0,0.709375,0.20416666666666666,0.05625,0.041666666666666664
1001-2021_03_20_201317.jpg,van,22,81,320,18,240,49,3,103,67,LTAdatasets/1001/annotate/1001-2021_03_20_201317.jpg,92.0,58.0,0.2875,0.24166666666666667,0.06875,0.075
1001-2021_03_20_212140.jpg,car,32,284,320,27,240,104,1,316,131,LTAdatasets/1001/annotate/1001-2021_03_20_212140.jpg,300.0,117.5,0.9375,0.4895833333333333,0.1,0.1125
1001-2021_03_20_212140.jpg,car,27,254,320,16,240,48,1,281,64,LTAdatasets/1001/annotate/1001-2021_03_20_212140.jpg,267.5,56.0,0.8359375,0.23333333333333334,0.084375,0.06666666666666667
1001-2021_03_20_220643.jpg,car,24,89,320,12,240,55,1,113,67,LTAdatasets/1001/annotate/1001-2021_03_20_220643.jpg,101.0,61.0,0.315625,0.25416666666666665,0.075,0.05
1001-2021_03_20_183112.jpg,car,27,121,320,32,240,92,1,148,124,LTAdatasets/1001/annotate/1001-2021_03_20_183112.jpg,134.5,108.0,0.4203125,0.45,0.084375,0.13333333333333333
1001-2021_03_20_183112.jpg,car,16,214,320,16,240,37,1,230,53,LTAdatasets/1001/annotate/1001-2021_03_20_183112.jpg,222.0,45.0,0.69375,0.1875,0.05,0.06666666666666667
1001-2021_03_20_185153.jpg,car,25,264,320,19,240,57,1,289,76,LTAdatasets/1001/annotate/1001-2021_03_20_185153.jpg,276.5,66.5,0.8640625,0.27708333333333335,0.078125,0.07916666666666666
1001-2021_03_20_204238.jpg,car,24,217,320,21,240,40,1,241,61,LTAdatasets/1001/annotate/1001-2021_03_20_204238.jpg,229.0,50.5,0.715625,0.21041666666666667,0.075,0.0875
1001-2021_03_20_192735.jpg,car,26,243,320,22,240,69,1,269,91,LTAdatasets/1001/annotate/1001-2021_03_20_192735.jpg,256.0,80.0,0.8,0.3333333333333333,0.08125,0.09166666666666666
1001-2021_03_20_195736.jpg,car,23,253,320,24,240,85,1,276,109,LTAdatasets/1001/annotate/1001-2021_03_20_195736.jpg,264.5,97.0,0.8265625,0.4041666666666667,0.071875,0.1
1001-2021_03_20_073417.jpg,lorry_truck,28,87,320,34,240,111,2,115,145,LTAdatasets/1001/annotate/1001-2021_03_20_073417.jpg,101.0,128.0,0.315625,0.5333333333333333,0.0875,0.14166666666666666
1001-2021_03_20_095205.jpg,car,22,263,320,24,240,55,1,285,79,LTAdatasets/1001/annotate/1001-2021_03_20_095205.jpg,274.0,67.0,0.85625,0.2791666666666667,0.06875,0.1
1001-2021_03_20_083120.jpg,car,31,127,320,48,240,138,1,158,186,LTAdatasets/1001/annotate/1001-2021_03_20_083120.jpg,142.5,162.0,0.4453125,0.675,0.096875,0.2
1001-2021_03_20_200116.jpg,car,50,157,320,64,240,172,1,207,236,LTAdatasets/1001/annotate/1001-2021_03_20_200116.jpg,182.0,204.0,0.56875,0.85,0.15625,0.26666666666666666
1001-2021_03_20_200116.jpg,car,23,261,320,20,240,55,1,284,75,LTAdatasets/1001/annotate/1001-2021_03_20_200116.jpg,272.5,65.0,0.8515625,0.2708333333333333,0.071875,0.08333333333333333
1001-2021_03_20_183712.jpg,car,18,247,320,17,240,57,1,265,74,LTAdatasets/1001/annotate/1001-2021_03_20_183712.jpg,256.0,65.5,0.8,0.27291666666666664,0.05625,0.07083333333333333
1001-2021_03_20_081920.jpg,lorry_truck,39,259,320,39,240,78,2,298,117,LTAdatasets/1001/annotate/1001-2021_03_20_081920.jpg,278.5,97.5,0.8703125,0.40625,0.121875,0.1625
1001-2021_03_20_220403.jpg,car,18,253,320,16,240,32,1,271,48,LTAdatasets/1001/annotate/1001-2021_03_20_220403.jpg,262.0,40.0,0.81875,0.16666666666666666,0.05625,0.06666666666666667
1001-2021_03_20_220403.jpg,car,17,80,320,11,240,39,1,97,50,LTAdatasets/1001/annotate/1001-2021_03_20_220403.jpg,88.5,44.5,0.2765625,0.18541666666666667,0.053125,0.04583333333333333
1001-2021_03_20_193415.jpg,car,26,234,320,20,240,68,1,260,88,LTAdatasets/1001/annotate/1001-2021_03_20_193415.jpg,247.0,78.0,0.771875,0.325,0.08125,0.08333333333333333
1001-2021_03_20_193415.jpg,car,23,269,320,23,240,59,1,292,82,LTAdatasets/1001/annotate/1001-2021_03_20_193415.jpg,280.5,70.5,0.8765625,0.29375,0.071875,0.09583333333333334
1001-2021_03_20_193415.jpg,car,23,296,320,23,240,57,1,319,80,LTAdatasets/1001/annotate/1001-2021_03_20_193415.jpg,307.5,68.5,0.9609375,0.28541666666666665,0.071875,0.09583333333333334
1001-2021_03_20_194315.jpg,bike,10,235,320,11,240,39,4,245,50,LTAdatasets/1001/annotate/1001-2021_03_20_194315.jpg,240.0,44.5,0.75,0.18541666666666667,0.03125,0.04583333333333333
1001-2021_03_20_213701.jpg,car,42,87,320,48,240,191,1,129,239,LTAdatasets/1001/annotate/1001-2021_03_20_213701.jpg,108.0,215.0,0.3375,0.8958333333333334,0.13125,0.2
1001-2021_03_20_192214.jpg,car,20,108,320,17,240,57,1,128,74,LTAdatasets/1001/annotate/1001-2021_03_20_192214.jpg,118.0,65.5,0.36875,0.27291666666666664,0.0625,0.07083333333333333
1001-2021_03_20_192214.jpg,car,21,299,320,18,240,68,1,320,86,LTAdatasets/1001/annotate/1001-2021_03_20_192214.jpg,309.5,77.0,0.9671875,0.32083333333333336,0.065625,0.075
1001-2021_03_20_202758.jpg,car,39,139,320,40,240,131,1,178,171,LTAdatasets/1001/annotate/1001-2021_03_20_202758.jpg,158.5,151.0,0.4953125,0.6291666666666667,0.121875,0.16666666666666666
1001-2021_03_20_202758.jpg,car,26,85,320,25,240,103,1,111,128,LTAdatasets/1001/annotate/1001-2021_03_20_202758.jpg,98.0,115.5,0.30625,0.48125,0.08125,0.10416666666666667
1001-2021_03_20_202758.jpg,car,20,223,320,15,240,49,1,243,64,LTAdatasets/1001/annotate/1001-2021_03_20_202758.jpg,233.0,56.5,0.728125,0.23541666666666666,0.0625,0.0625
1001-2021_03_20_094605.jpg,lorry_truck,38,227,320,40,240,41,2,265,81,LTAdatasets/1001/annotate/1001-2021_03_20_094605.jpg,246.0,61.0,0.76875,0.25416666666666665,0.11875,0.16666666666666666
1001-2021_03_20_191234.jpg,car,20,217,320,21,240,46,1,237,67,LTAdatasets/1001/annotate/1001-2021_03_20_191234.jpg,227.0,56.5,0.709375,0.23541666666666666,0.0625,0.0875
1001-2021_03_20_180710.jpg,car,18,109,320,15,240,58,1,127,73,LTAdatasets/1001/annotate/1001-2021_03_20_180710.jpg,118.0,65.5,0.36875,0.27291666666666664,0.05625,0.0625
1001-2021_03_20_064254.jpg,car,31,116,320,32,240,116,1,147,148,LTAdatasets/1001/annotate/1001-2021_03_20_064254.jpg,131.5,132.0,0.4109375,0.55,0.096875,0.13333333333333333
1001-2021_03_20_190634.jpg,car,26,276,320,17,240,51,1,302,68,LTAdatasets/1001/annotate/1001-2021_03_20_190634.jpg,289.0,59.5,0.903125,0.24791666666666667,0.08125,0.07083333333333333
1001-2021_03_20_090402.jpg,car,19,208,320,16,240,36,1,227,52,LTAdatasets/1001/annotate/1001-2021_03_20_090402.jpg,217.5,44.0,0.6796875,0.18333333333333332,0.059375,0.06666666666666667
1001-2021_03_20_204919.jpg,car,19,276,320,13,240,50,1,295,63,LTAdatasets/1001/annotate/1001-2021_03_20_204919.jpg,285.5,56.5,0.8921875,0.23541666666666666,0.059375,0.05416666666666667
1001-2021_03_20_204919.jpg,bus,42,211,320,44,240,27,5,253,71,LTAdatasets/1001/annotate/1001-2021_03_20_204919.jpg,232.0,49.0,0.725,0.20416666666666666,0.13125,0.18333333333333332
1001-2021_03_20_202217.jpg,car,36,130,320,36,240,126,1,166,162,LTAdatasets/1001/annotate/1001-2021_03_20_202217.jpg,148.0,144.0,0.4625,0.6,0.1125,0.15
1001-2021_03_20_182151.jpg,car,18,228,320,13,240,29,1,246,42,LTAdatasets/1001/annotate/1001-2021_03_20_182151.jpg,237.0,35.5,0.740625,0.14791666666666667,0.05625,0.05416666666666667
1001-2021_03_20_092803.jpg,car,20,77,320,16,240,52,1,97,68,LTAdatasets/1001/annotate/1001-2021_03_20_092803.jpg,87.0,60.0,0.271875,0.25,0.0625,0.06666666666666667
1001-2021_03_20_092803.jpg,bus,50,270,320,88,240,63,5,320,151,LTAdatasets/1001/annotate/1001-2021_03_20_092803.jpg,295.0,107.0,0.921875,0.44583333333333336,0.15625,0.36666666666666664
1001-2021_03_20_091623.jpg,car,13,307,320,24,240,91,1,320,115,LTAdatasets/1001/annotate/1001-2021_03_20_091623.jpg,313.5,103.0,0.9796875,0.42916666666666664,0.040625,0.1
1001-2021_03_20_091623.jpg,car,19,215,320,19,240,44,1,234,63,LTAdatasets/1001/annotate/1001-2021_03_20_091623.jpg,224.5,53.5,0.7015625,0.22291666666666668,0.059375,0.07916666666666666
1001-2021_03_20_203658.jpg,car,30,268,320,20,240,56,1,298,76,LTAdatasets/1001/annotate/1001-2021_03_20_203658.jpg,283.0,66.0,0.884375,0.275,0.09375,0.08333333333333333
1001-2021_03_20_212801.jpg,car,24,273,320,16,240,57,1,297,73,LTAdatasets/1001/annotate/1001-2021_03_20_212801.jpg,285.0,65.0,0.890625,0.2708333333333333,0.075,0.06666666666666667
1001-2021_03_20_212801.jpg,car,23,204,320,16,240,32,1,227,48,LTAdatasets/1001/annotate/1001-2021_03_20_212801.jpg,215.5,40.0,0.6734375,0.16666666666666666,0.071875,0.06666666666666667
1001-2021_03_20_210720.jpg,car,24,296,320,20,240,61,1,320,81,LTAdatasets/1001/annotate/1001-2021_03_20_210720.jpg,308.0,71.0,0.9625,0.29583333333333334,0.075,0.08333333333333333
1001-2021_03_20_210720.jpg,car,22,79,320,19,240,55,1,101,74,LTAdatasets/1001/annotate/1001-2021_03_20_210720.jpg,90.0,64.5,0.28125,0.26875,0.06875,0.07916666666666666
1001-2021_03_20_203358.jpg,car,36,97,320,35,240,136,1,133,171,LTAdatasets/1001/annotate/1001-2021_03_20_203358.jpg,115.0,153.5,0.359375,0.6395833333333333,0.1125,0.14583333333333334
1001-2021_03_20_203358.jpg,car,27,263,320,25,240,88,1,290,113,LTAdatasets/1001/annotate/1001-2021_03_20_203358.jpg,276.5,100.5,0.8640625,0.41875,0.084375,0.10416666666666667
1001-2021_03_20_203358.jpg,car,20,300,320,24,240,89,1,320,113,LTAdatasets/1001/annotate/1001-2021_03_20_203358.jpg,310.0,101.0,0.96875,0.42083333333333334,0.0625,0.1
1001-2021_03_20_184913.jpg,car,15,207,320,14,240,39,1,222,53,LTAdatasets/1001/annotate/1001-2021_03_20_184913.jpg,214.5,46.0,0.6703125,0.19166666666666668,0.046875,0.058333333333333334
1001-2021_03_20_184913.jpg,car,22,237,320,14,240,39,1,259,53,LTAdatasets/1001/annotate/1001-2021_03_20_184913.jpg,248.0,46.0,0.775,0.19166666666666668,0.06875,0.058333333333333334
1001-2021_03_20_195136.jpg,car,11,309,320,21,240,128,1,320,149,LTAdatasets/1001/annotate/1001-2021_03_20_195136.jpg,314.5,138.5,0.9828125,0.5770833333333333,0.034375,0.0875
1001-2021_03_20_201617.jpg,car,19,224,320,8,240,25,1,243,33,LTAdatasets/1001/annotate/1001-2021_03_20_201617.jpg,233.5,29.0,0.7296875,0.12083333333333333,0.059375,0.03333333333333333
1001-2021_03_20_201617.jpg,bike,11,309,320,16,240,69,4,320,85,LTAdatasets/1001/annotate/1001-2021_03_20_201617.jpg,314.5,77.0,0.9828125,0.32083333333333336,0.034375,0.06666666666666667
1001-2021_03_20_084601.jpg,car,29,291,320,50,240,118,1,320,168,LTAdatasets/1001/annotate/1001-2021_03_20_084601.jpg,305.5,143.0,0.9546875,0.5958333333333333,0.090625,0.20833333333333334
1001-2021_03_20_213341.jpg,car,30,90,320,33,240,100,1,120,133,LTAdatasets/1001/annotate/1001-2021_03_20_213341.jpg,105.0,116.5,0.328125,0.48541666666666666,0.09375,0.1375
1001-2021_03_20_213341.jpg,car,20,201,320,16,240,31,1,221,47,LTAdatasets/1001/annotate/1001-2021_03_20_213341.jpg,211.0,39.0,0.659375,0.1625,0.0625,0.06666666666666667
1001-2021_03_20_100105.jpg,bus,58,90,320,82,240,158,5,148,240,LTAdatasets/1001/annotate/1001-2021_03_20_100105.jpg,119.0,199.0,0.371875,0.8291666666666667,0.18125,0.3416666666666667
9706-2021_03_20_200637.jpg,car,40,362,640,51,360,180,1,402,231,LTAdatasets/9706/annotate/9706-2021_03_20_200637.jpg,382.0,205.5,0.596875,0.5708333333333333,0.0625,0.14166666666666666
9706-2021_03_20_200637.jpg,lorry_truck,42,404,640,64,360,147,2,446,211,LTAdatasets/9706/annotate/9706-2021_03_20_200637.jpg,425.0,179.0,0.6640625,0.49722222222222223,0.065625,0.17777777777777778
9706-2021_03_20_200637.jpg,car,17,235,640,16,360,87,1,252,103,LTAdatasets/9706/annotate/9706-2021_03_20_200637.jpg,243.5,95.0,0.38046875,0.2638888888888889,0.0265625,0.044444444444444446
9706-2021_03_20_200637.jpg,car,19,288,640,17,360,68,1,307,85,LTAdatasets/9706/annotate/9706-2021_03_20_200637.jpg,297.5,76.5,0.46484375,0.2125,0.0296875,0.04722222222222222
9706-2021_03_20_200637.jpg,car,16,223,640,9,360,56,1,239,65,LTAdatasets/9706/annotate/9706-2021_03_20_200637.jpg,231.0,60.5,0.3609375,0.16805555555555557,0.025,0.025
9706-2021_03_20_200637.jpg,car,11,238,640,9,360,49,1,249,58,LTAdatasets/9706/annotate/9706-2021_03_20_200637.jpg,243.5,53.5,0.38046875,0.1486111111111111,0.0171875,0.025
9706-2021_03_20_200637.jpg,car,10,223,640,7,360,46,1,233,53,LTAdatasets/9706/annotate/9706-2021_03_20_200637.jpg,228.0,49.5,0.35625,0.1375,0.015625,0.019444444444444445
9706-2021_03_20_200637.jpg,car,9,222,640,10,360,33,1,231,43,LTAdatasets/9706/annotate/9706-2021_03_20_200637.jpg,226.5,38.0,0.35390625,0.10555555555555556,0.0140625,0.027777777777777776
9706-2021_03_20_200637.jpg,car,9,234,640,7,360,33,1,243,40,LTAdatasets/9706/annotate/9706-2021_03_20_200637.jpg,238.5,36.5,0.37265625,0.10138888888888889,0.0140625,0.019444444444444445
9706-2021_03_20_193415.jpg,car,39,361,640,42,360,186,1,400,228,LTAdatasets/9706/annotate/9706-2021_03_20_193415.jpg,380.5,207.0,0.59453125,0.575,0.0609375,0.11666666666666667
9706-2021_03_20_193415.jpg,lorry_truck,40,409,640,47,360,162,2,449,209,LTAdatasets/9706/annotate/9706-2021_03_20_193415.jpg,429.0,185.5,0.6703125,0.5152777777777777,0.0625,0.13055555555555556
9706-2021_03_20_193415.jpg,bus,42,171,640,73,360,95,5,213,168,LTAdatasets/9706/annotate/9706-2021_03_20_193415.jpg,192.0,131.5,0.3,0.36527777777777776,0.065625,0.20277777777777778
9706-2021_03_20_193415.jpg,car,23,225,640,16,360,118,1,248,134,LTAdatasets/9706/annotate/9706-2021_03_20_193415.jpg,236.5,126.0,0.36953125,0.35,0.0359375,0.044444444444444446
9706-2021_03_20_193415.jpg,car,18,232,640,15,360,81,1,250,96,LTAdatasets/9706/annotate/9706-2021_03_20_193415.jpg,241.0,88.5,0.3765625,0.24583333333333332,0.028125,0.041666666666666664
9706-2021_03_20_193415.jpg,car,33,143,640,42,360,190,1,176,232,LTAdatasets/9706/annotate/9706-2021_03_20_193415.jpg,159.5,211.0,0.24921875,0.5861111111111111,0.0515625,0.11666666666666667
9706-2021_03_20_193415.jpg,car,38,187,640,51,360,256,1,225,307,LTAdatasets/9706/annotate/9706-2021_03_20_193415.jpg,206.0,281.5,0.321875,0.7819444444444444,0.059375,0.14166666666666666
9706-2021_03_20_193415.jpg,car,58,100,640,49,360,311,1,158,360,LTAdatasets/9706/annotate/9706-2021_03_20_193415.jpg,129.0,335.5,0.2015625,0.9319444444444445,0.090625,0.1361111111111111
9706-2021_03_20_193415.jpg,car,12,214,640,10,360,43,1,226,53,LTAdatasets/9706/annotate/9706-2021_03_20_193415.jpg,220.0,48.0,0.34375,0.13333333333333333,0.01875,0.027777777777777776
9706-2021_03_20_193415.jpg,car,10,236,640,9,360,41,1,246,50,LTAdatasets/9706/annotate/9706-2021_03_20_193415.jpg,241.0,45.5,0.3765625,0.12638888888888888,0.015625,0.025
9706-2021_03_20_193415.jpg,car,12,301,640,11,360,41,1,313,52,LTAdatasets/9706/annotate/9706-2021_03_20_193415.jpg,307.0,46.5,0.4796875,0.12916666666666668,0.01875,0.030555555555555555
9706-2021_03_20_193415.jpg,car,12,223,640,15,360,34,1,235,49,LTAdatasets/9706/annotate/9706-2021_03_20_193415.jpg,229.0,41.5,0.3578125,0.11527777777777778,0.01875,0.041666666666666664
9706-2021_03_20_193415.jpg,lorry_truck,60,0,640,46,360,314,2,60,360,LTAdatasets/9706/annotate/9706-2021_03_20_193415.jpg,30.0,337.0,0.046875,0.9361111111111111,0.09375,0.12777777777777777
9706-2021_03_20_202217.jpg,car,10,229,640,7,360,33,1,239,40,LTAdatasets/9706/annotate/9706-2021_03_20_202217.jpg,234.0,36.5,0.365625,0.10138888888888889,0.015625,0.019444444444444445
9706-2021_03_20_202217.jpg,car,7,213,640,6,360,35,1,220,41,LTAdatasets/9706/annotate/9706-2021_03_20_202217.jpg,216.5,38.0,0.33828125,0.10555555555555556,0.0109375,0.016666666666666666
9706-2021_03_20_202217.jpg,car,13,206,640,10,360,56,1,219,66,LTAdatasets/9706/annotate/9706-2021_03_20_202217.jpg,212.5,61.0,0.33203125,0.16944444444444445,0.0203125,0.027777777777777776
9706-2021_03_20_202217.jpg,car,9,226,640,9,360,49,1,235,58,LTAdatasets/9706/annotate/9706-2021_03_20_202217.jpg,230.5,53.5,0.36015625,0.1486111111111111,0.0140625,0.025
9706-2021_03_20_202217.jpg,car,15,223,640,8,360,67,1,238,75,LTAdatasets/9706/annotate/9706-2021_03_20_202217.jpg,230.5,71.0,0.36015625,0.19722222222222222,0.0234375,0.022222222222222223
9706-2021_03_20_202217.jpg,car,11,244,640,8,360,62,1,255,70,LTAdatasets/9706/annotate/9706-2021_03_20_202217.jpg,249.5,66.0,0.38984375,0.18333333333333332,0.0171875,0.022222222222222223
9706-2021_03_20_202217.jpg,car,9,241,640,6,360,43,1,250,49,LTAdatasets/9706/annotate/9706-2021_03_20_202217.jpg,245.5,46.0,0.38359375,0.12777777777777777,0.0140625,0.016666666666666666
9706-2021_03_20_202217.jpg,car,15,242,640,11,360,88,1,257,99,LTAdatasets/9706/annotate/9706-2021_03_20_202217.jpg,249.5,93.5,0.38984375,0.25972222222222224,0.0234375,0.030555555555555555
9706-2021_03_20_202217.jpg,car,17,215,640,13,360,83,1,232,96,LTAdatasets/9706/annotate/9706-2021_03_20_202217.jpg,223.5,89.5,0.34921875,0.24861111111111112,0.0265625,0.03611111111111111
9706-2021_03_20_202217.jpg,van,22,190,640,20,360,122,3,212,142,LTAdatasets/9706/annotate/9706-2021_03_20_202217.jpg,201.0,132.0,0.3140625,0.36666666666666664,0.034375,0.05555555555555555
9706-2021_03_20_202217.jpg,car,26,158,640,37,360,176,1,184,213,LTAdatasets/9706/annotate/9706-2021_03_20_202217.jpg,171.0,194.5,0.2671875,0.5402777777777777,0.040625,0.10277777777777777
9706-2021_03_20_202217.jpg,lorry_truck,40,97,640,60,360,177,2,137,237,LTAdatasets/9706/annotate/9706-2021_03_20_202217.jpg,117.0,207.0,0.1828125,0.575,0.0625,0.16666666666666666
9706-2021_03_20_202217.jpg,car,25,331,640,24,360,108,1,356,132,LTAdatasets/9706/annotate/9706-2021_03_20_202217.jpg,343.5,120.0,0.53671875,0.3333333333333333,0.0390625,0.06666666666666667
9706-2021_03_20_202217.jpg,bike,12,393,640,15,360,127,4,405,142,LTAdatasets/9706/annotate/9706-2021_03_20_202217.jpg,399.0,134.5,0.6234375,0.3736111111111111,0.01875,0.041666666666666664
9706-2021_03_20_202217.jpg,bike,10,301,640,13,360,90,4,311,103,LTAdatasets/9706/annotate/9706-2021_03_20_202217.jpg,306.0,96.5,0.478125,0.26805555555555555,0.015625,0.03611111111111111
9706-2021_03_20_202217.jpg,car,14,311,640,17,360,74,1,325,91,LTAdatasets/9706/annotate/9706-2021_03_20_202217.jpg,318.0,82.5,0.496875,0.22916666666666666,0.021875,0.04722222222222222
9706-2021_03_20_202217.jpg,car,16,289,640,17,360,68,1,305,85,LTAdatasets/9706/annotate/9706-2021_03_20_202217.jpg,297.0,76.5,0.4640625,0.2125,0.025,0.04722222222222222
9706-2021_03_20_202217.jpg,car,17,318,640,9,360,61,1,335,70,LTAdatasets/9706/annotate/9706-2021_03_20_202217.jpg,326.5,65.5,0.51015625,0.18194444444444444,0.0265625,0.025
9706-2021_03_20_202217.jpg,bike,7,296,640,11,360,58,4,303,69,LTAdatasets/9706/annotate/9706-2021_03_20_202217.jpg,299.5,63.5,0.46796875,0.1763888888888889,0.0109375,0.030555555555555555
9706-2021_03_20_083340.jpg,lorry_truck,46,389,640,58,360,222,2,435,280,LTAdatasets/9706/annotate/9706-2021_03_20_083340.jpg,412.0,251.0,0.64375,0.6972222222222222,0.071875,0.16111111111111112
9706-2021_03_20_083340.jpg,car,35,324,640,43,360,192,1,359,235,LTAdatasets/9706/annotate/9706-2021_03_20_083340.jpg,341.5,213.5,0.53359375,0.5930555555555556,0.0546875,0.11944444444444445
9706-2021_03_20_083340.jpg,van,25,344,640,26,360,107,3,369,133,LTAdatasets/9706/annotate/9706-2021_03_20_083340.jpg,356.5,120.0,0.55703125,0.3333333333333333,0.0390625,0.07222222222222222
9706-2021_03_20_083340.jpg,lorry_truck,35,175,640,48,360,120,2,210,168,LTAdatasets/9706/annotate/9706-2021_03_20_083340.jpg,192.5,144.0,0.30078125,0.4,0.0546875,0.13333333333333333
9706-2021_03_20_083340.jpg,lorry_truck,43,106,640,54,360,152,2,149,206,LTAdatasets/9706/annotate/9706-2021_03_20_083340.jpg,127.5,179.0,0.19921875,0.49722222222222223,0.0671875,0.15
9706-2021_03_20_083340.jpg,lorry_truck,19,191,640,33,360,65,2,210,98,LTAdatasets/9706/annotate/9706-2021_03_20_083340.jpg,200.5,81.5,0.31328125,0.2263888888888889,0.0296875,0.09166666666666666
9706-2021_03_20_083340.jpg,lorry_truck,18,306,640,16,360,40,2,324,56,LTAdatasets/9706/annotate/9706-2021_03_20_083340.jpg,315.0,48.0,0.4921875,0.13333333333333333,0.028125,0.044444444444444446
9706-2021_03_20_083340.jpg,lorry_truck,10,287,640,8,360,31,2,297,39,LTAdatasets/9706/annotate/9706-2021_03_20_083340.jpg,292.0,35.0,0.45625,0.09722222222222222,0.015625,0.022222222222222223
9706-2021_03_20_083340.jpg,car,17,311,640,17,360,71,1,328,88,LTAdatasets/9706/annotate/9706-2021_03_20_083340.jpg,319.5,79.5,0.49921875,0.22083333333333333,0.0265625,0.04722222222222222
9706-2021_03_20_083340.jpg,car,14,286,640,8,360,43,1,300,51,LTAdatasets/9706/annotate/9706-2021_03_20_083340.jpg,293.0,47.0,0.4578125,0.13055555555555556,0.021875,0.022222222222222223
9706-2021_03_20_083340.jpg,car,10,239,640,12,360,59,1,249,71,LTAdatasets/9706/annotate/9706-2021_03_20_083340.jpg,244.0,65.0,0.38125,0.18055555555555555,0.015625,0.03333333333333333
9706-2021_03_20_083340.jpg,car,18,236,640,15,360,88,1,254,103,LTAdatasets/9706/annotate/9706-2021_03_20_083340.jpg,245.0,95.5,0.3828125,0.2652777777777778,0.028125,0.041666666666666664
9706-2021_03_20_083340.jpg,car,10,209,640,11,360,49,1,219,60,LTAdatasets/9706/annotate/9706-2021_03_20_083340.jpg,214.0,54.5,0.334375,0.15138888888888888,0.015625,0.030555555555555555
9706-2021_03_20_083340.jpg,car,11,224,640,15,360,61,1,235,76,LTAdatasets/9706/annotate/9706-2021_03_20_083340.jpg,229.5,68.5,0.35859375,0.19027777777777777,0.0171875,0.041666666666666664
9706-2021_03_20_083340.jpg,bus,15,223,640,17,360,39,5,238,56,LTAdatasets/9706/annotate/9706-2021_03_20_083340.jpg,230.5,47.5,0.36015625,0.13194444444444445,0.0234375,0.04722222222222222
9706-2021_03_20_083340.jpg,car,6,238,640,4,360,40,1,244,44,LTAdatasets/9706/annotate/9706-2021_03_20_083340.jpg,241.0,42.0,0.3765625,0.11666666666666667,0.009375,0.011111111111111112
9706-2021_03_20_082740.jpg,lorry_truck,18,183,640,28,360,82,2,201,110,LTAdatasets/9706/annotate/9706-2021_03_20_082740.jpg,192.0,96.0,0.3,0.26666666666666666,0.028125,0.07777777777777778
9706-2021_03_20_082740.jpg,bike,9,299,640,18,360,77,4,308,95,LTAdatasets/9706/annotate/9706-2021_03_20_082740.jpg,303.5,86.0,0.47421875,0.2388888888888889,0.0140625,0.05
9706-2021_03_20_082740.jpg,car,25,318,640,36,360,165,1,343,201,LTAdatasets/9706/annotate/9706-2021_03_20_082740.jpg,330.5,183.0,0.51640625,0.5083333333333333,0.0390625,0.1
9706-2021_03_20_082740.jpg,lorry_truck,38,363,640,51,360,166,2,401,217,LTAdatasets/9706/annotate/9706-2021_03_20_082740.jpg,382.0,191.5,0.596875,0.5319444444444444,0.059375,0.14166666666666666
9706-2021_03_20_082740.jpg,lorry_truck,39,388,640,50,360,121,2,427,171,LTAdatasets/9706/annotate/9706-2021_03_20_082740.jpg,407.5,146.0,0.63671875,0.40555555555555556,0.0609375,0.1388888888888889
9706-2021_03_20_082740.jpg,lorry_truck,24,315,640,25,360,72,2,339,97,LTAdatasets/9706/annotate/9706-2021_03_20_082740.jpg,327.0,84.5,0.5109375,0.23472222222222222,0.0375,0.06944444444444445
9706-2021_03_20_082740.jpg,car,14,304,640,11,360,60,1,318,71,LTAdatasets/9706/annotate/9706-2021_03_20_082740.jpg,311.0,65.5,0.4859375,0.18194444444444444,0.021875,0.030555555555555555
9706-2021_03_20_082740.jpg,car,12,223,640,8,360,47,1,235,55,LTAdatasets/9706/annotate/9706-2021_03_20_082740.jpg,229.0,51.0,0.3578125,0.14166666666666666,0.01875,0.022222222222222223
9706-2021_03_20_082740.jpg,car,9,211,640,7,360,46,1,220,53,LTAdatasets/9706/annotate/9706-2021_03_20_082740.jpg,215.5,49.5,0.33671875,0.1375,0.0140625,0.019444444444444445
9706-2021_03_20_082740.jpg,van,16,288,640,11,360,42,3,304,53,LTAdatasets/9706/annotate/9706-2021_03_20_082740.jpg,296.0,47.5,0.4625,0.13194444444444445,0.025,0.030555555555555555
9706-2021_03_20_090102.jpg,car,37,334,640,56,360,232,1,371,288,LTAdatasets/9706/annotate/9706-2021_03_20_090102.jpg,352.5,260.0,0.55078125,0.7222222222222222,0.0578125,0.15555555555555556
9706-2021_03_20_090102.jpg,car,38,374,640,41,360,199,1,412,240,LTAdatasets/9706/annotate/9706-2021_03_20_090102.jpg,393.0,219.5,0.6140625,0.6097222222222223,0.059375,0.11388888888888889
9706-2021_03_20_090102.jpg,car,15,299,640,20,360,91,1,314,111,LTAdatasets/9706/annotate/9706-2021_03_20_090102.jpg,306.5,101.0,0.47890625,0.28055555555555556,0.0234375,0.05555555555555555
9706-2021_03_20_090102.jpg,van,21,199,640,22,360,98,3,220,120,LTAdatasets/9706/annotate/9706-2021_03_20_090102.jpg,209.5,109.0,0.32734375,0.30277777777777776,0.0328125,0.06111111111111111
9706-2021_03_20_090102.jpg,car,18,203,640,21,360,149,1,221,170,LTAdatasets/9706/annotate/9706-2021_03_20_090102.jpg,212.0,159.5,0.33125,0.44305555555555554,0.028125,0.058333333333333334
9706-2021_03_20_090102.jpg,lorry_truck,14,201,640,14,360,64,2,215,78,LTAdatasets/9706/annotate/9706-2021_03_20_090102.jpg,208.0,71.0,0.325,0.19722222222222222,0.021875,0.03888888888888889
9706-2021_03_20_090102.jpg,lorry_truck,15,314,640,9,360,56,2,329,65,LTAdatasets/9706/annotate/9706-2021_03_20_090102.jpg,321.5,60.5,0.50234375,0.16805555555555557,0.0234375,0.025
9706-2021_03_20_090102.jpg,car,10,221,640,6,360,60,1,231,66,LTAdatasets/9706/annotate/9706-2021_03_20_090102.jpg,226.0,63.0,0.353125,0.175,0.015625,0.016666666666666666
9706-2021_03_20_090102.jpg,car,13,306,640,10,360,46,1,319,56,LTAdatasets/9706/annotate/9706-2021_03_20_090102.jpg,312.5,51.0,0.48828125,0.14166666666666666,0.0203125,0.027777777777777776
9706-2021_03_20_090102.jpg,car,12,237,640,7,360,46,1,249,53,LTAdatasets/9706/annotate/9706-2021_03_20_090102.jpg,243.0,49.5,0.3796875,0.1375,0.01875,0.019444444444444445
9706-2021_03_20_080939.jpg,bus,79,455,640,91,360,230,5,534,321,LTAdatasets/9706/annotate/9706-2021_03_20_080939.jpg,494.5,275.5,0.77265625,0.7652777777777777,0.1234375,0.25277777777777777
9706-2021_03_20_080939.jpg,car,35,110,640,49,360,263,1,145,312,LTAdatasets/9706/annotate/9706-2021_03_20_080939.jpg,127.5,287.5,0.19921875,0.7986111111111112,0.0546875,0.1361111111111111
9706-2021_03_20_080939.jpg,car,20,171,640,29,360,163,1,191,192,LTAdatasets/9706/annotate/9706-2021_03_20_080939.jpg,181.0,177.5,0.2828125,0.4930555555555556,0.03125,0.08055555555555556
9706-2021_03_20_080939.jpg,van,16,189,640,19,360,76,3,205,95,LTAdatasets/9706/annotate/9706-2021_03_20_080939.jpg,197.0,85.5,0.3078125,0.2375,0.025,0.05277777777777778
9706-2021_03_20_080939.jpg,car,12,225,640,10,360,66,1,237,76,LTAdatasets/9706/annotate/9706-2021_03_20_080939.jpg,231.0,71.0,0.3609375,0.19722222222222222,0.01875,0.027777777777777776
9706-2021_03_20_080939.jpg,car,10,239,640,8,360,59,1,249,67,LTAdatasets/9706/annotate/9706-2021_03_20_080939.jpg,244.0,63.0,0.38125,0.175,0.015625,0.022222222222222223
9706-2021_03_20_080939.jpg,car,12,289,640,12,360,63,1,301,75,LTAdatasets/9706/annotate/9706-2021_03_20_080939.jpg,295.0,69.0,0.4609375,0.19166666666666668,0.01875,0.03333333333333333
9706-2021_03_20_080939.jpg,lorry_truck,19,201,640,11,360,61,2,220,72,LTAdatasets/9706/annotate/9706-2021_03_20_080939.jpg,210.5,66.5,0.32890625,0.18472222222222223,0.0296875,0.030555555555555555
9706-2021_03_20_080939.jpg,car,12,236,640,8,360,49,1,248,57,LTAdatasets/9706/annotate/9706-2021_03_20_080939.jpg,242.0,53.0,0.378125,0.14722222222222223,0.01875,0.022222222222222223
9706-2021_03_20_080939.jpg,car,10,235,640,9,360,38,1,245,47,LTAdatasets/9706/annotate/9706-2021_03_20_080939.jpg,240.0,42.5,0.375,0.11805555555555555,0.015625,0.025
9706-2021_03_20_080939.jpg,bike,7,225,640,6,360,43,4,232,49,LTAdatasets/9706/annotate/9706-2021_03_20_080939.jpg,228.5,46.0,0.35703125,0.12777777777777777,0.0109375,0.016666666666666666
9706-2021_03_20_080939.jpg,lorry_truck,10,212,640,9,360,44,2,222,53,LTAdatasets/9706/annotate/9706-2021_03_20_080939.jpg,217.0,48.5,0.3390625,0.13472222222222222,0.015625,0.025
9706-2021_03_20_080939.jpg,lorry_truck,15,292,640,11,360,41,2,307,52,LTAdatasets/9706/annotate/9706-2021_03_20_080939.jpg,299.5,46.5,0.46796875,0.12916666666666668,0.0234375,0.030555555555555555
9706-2021_03_20_200116.jpg,bus,38,143,640,59,360,113,5,181,172,LTAdatasets/9706/annotate/9706-2021_03_20_200116.jpg,162.0,142.5,0.253125,0.3958333333333333,0.059375,0.1638888888888889
9706-2021_03_20_200116.jpg,car,56,398,640,66,360,272,1,454,338,LTAdatasets/9706/annotate/9706-2021_03_20_200116.jpg,426.0,305.0,0.665625,0.8472222222222222,0.0875,0.18333333333333332
9706-2021_03_20_200116.jpg,van,61,485,640,64,360,283,3,546,347,LTAdatasets/9706/annotate/9706-2021_03_20_200116.jpg,515.5,315.0,0.80546875,0.875,0.0953125,0.17777777777777778
9706-2021_03_20_200116.jpg,car,26,328,640,41,360,192,1,354,233,LTAdatasets/9706/annotate/9706-2021_03_20_200116.jpg,341.0,212.5,0.5328125,0.5902777777777778,0.040625,0.11388888888888889
9706-2021_03_20_200116.jpg,car,26,206,640,43,360,204,1,232,247,LTAdatasets/9706/annotate/9706-2021_03_20_200116.jpg,219.0,225.5,0.3421875,0.6263888888888889,0.040625,0.11944444444444445
9706-2021_03_20_200116.jpg,car,24,333,640,22,360,113,1,357,135,LTAdatasets/9706/annotate/9706-2021_03_20_200116.jpg,345.0,124.0,0.5390625,0.34444444444444444,0.0375,0.06111111111111111
9706-2021_03_20_200116.jpg,bike,11,302,640,19,360,91,4,313,110,LTAdatasets/9706/annotate/9706-2021_03_20_200116.jpg,307.5,100.5,0.48046875,0.2791666666666667,0.0171875,0.05277777777777778
9706-2021_03_20_200116.jpg,van,22,354,640,23,360,94,3,376,117,LTAdatasets/9706/annotate/9706-2021_03_20_200116.jpg,365.0,105.5,0.5703125,0.29305555555555557,0.034375,0.06388888888888888
9706-2021_03_20_200116.jpg,car,20,328,640,11,360,70,1,348,81,LTAdatasets/9706/annotate/9706-2021_03_20_200116.jpg,338.0,75.5,0.528125,0.20972222222222223,0.03125,0.030555555555555555
9706-2021_03_20_200116.jpg,car,16,301,640,9,360,61,1,317,70,LTAdatasets/9706/annotate/9706-2021_03_20_200116.jpg,309.0,65.5,0.4828125,0.18194444444444444,0.025,0.025
9706-2021_03_20_200116.jpg,lorry_truck,11,210,640,14,360,59,2,221,73,LTAdatasets/9706/annotate/9706-2021_03_20_200116.jpg,215.5,66.0,0.33671875,0.18333333333333332,0.0171875,0.03888888888888889
9706-2021_03_20_200116.jpg,van,12,298,640,10,360,41,3,310,51,LTAdatasets/9706/annotate/9706-2021_03_20_200116.jpg,304.0,46.0,0.475,0.12777777777777777,0.01875,0.027777777777777776
9706-2021_03_20_200116.jpg,car,9,284,640,7,360,41,1,293,48,LTAdatasets/9706/annotate/9706-2021_03_20_200116.jpg,288.5,44.5,0.45078125,0.12361111111111112,0.0140625,0.019444444444444445
9706-2021_03_20_200116.jpg,car,9,211,640,9,360,40,1,220,49,LTAdatasets/9706/annotate/9706-2021_03_20_200116.jpg,215.5,44.5,0.33671875,0.12361111111111112,0.0140625,0.025
9706-2021_03_20_200116.jpg,car,8,224,640,5,360,40,1,232,45,LTAdatasets/9706/annotate/9706-2021_03_20_200116.jpg,228.0,42.5,0.35625,0.11805555555555555,0.0125,0.013888888888888888
9706-2021_03_20_073417.jpg,car,31,324,640,42,360,180,1,355,222,LTAdatasets/9706/annotate/9706-2021_03_20_073417.jpg,339.5,201.0,0.53046875,0.5583333333333333,0.0484375,0.11666666666666667
9706-2021_03_20_073417.jpg,lorry_truck,39,393,640,57,360,136,2,432,193,LTAdatasets/9706/annotate/9706-2021_03_20_073417.jpg,412.5,164.5,0.64453125,0.45694444444444443,0.0609375,0.15833333333333333
9706-2021_03_20_073417.jpg,lorry_truck,71,522,640,39,360,321,2,593,360,LTAdatasets/9706/annotate/9706-2021_03_20_073417.jpg,557.5,340.5,0.87109375,0.9458333333333333,0.1109375,0.10833333333333334
9706-2021_03_20_073417.jpg,lorry_truck,18,351,640,23,360,83,2,369,106,LTAdatasets/9706/annotate/9706-2021_03_20_073417.jpg,360.0,94.5,0.5625,0.2625,0.028125,0.06388888888888888
9706-2021_03_20_073417.jpg,van,24,321,640,22,360,91,3,345,113,LTAdatasets/9706/annotate/9706-2021_03_20_073417.jpg,333.0,102.0,0.5203125,0.2833333333333333,0.0375,0.06111111111111111
9706-2021_03_20_073417.jpg,car,18,295,640,14,360,81,1,313,95,LTAdatasets/9706/annotate/9706-2021_03_20_073417.jpg,304.0,88.0,0.475,0.24444444444444444,0.028125,0.03888888888888889
9706-2021_03_20_073417.jpg,car,17,308,640,13,360,64,1,325,77,LTAdatasets/9706/annotate/9706-2021_03_20_073417.jpg,316.5,70.5,0.49453125,0.19583333333333333,0.0265625,0.03611111111111111
9706-2021_03_20_073417.jpg,car,12,289,640,10,360,65,1,301,75,LTAdatasets/9706/annotate/9706-2021_03_20_073417.jpg,295.0,70.0,0.4609375,0.19444444444444445,0.01875,0.027777777777777776
9706-2021_03_20_073417.jpg,van,9,207,640,11,360,60,3,216,71,LTAdatasets/9706/annotate/9706-2021_03_20_073417.jpg,211.5,65.5,0.33046875,0.18194444444444444,0.0140625,0.030555555555555555
9706-2021_03_20_073417.jpg,van,10,240,640,12,360,54,3,250,66,LTAdatasets/9706/annotate/9706-2021_03_20_073417.jpg,245.0,60.0,0.3828125,0.16666666666666666,0.015625,0.03333333333333333
9706-2021_03_20_073417.jpg,bus,11,211,640,11,360,32,5,222,43,LTAdatasets/9706/annotate/9706-2021_03_20_073417.jpg,216.5,37.5,0.33828125,0.10416666666666667,0.0171875,0.030555555555555555
9706-2021_03_20_073417.jpg,lorry_truck,12,288,640,9,360,43,2,300,52,LTAdatasets/9706/annotate/9706-2021_03_20_073417.jpg,294.0,47.5,0.459375,0.13194444444444445,0.01875,0.025
9706-2021_03_20_073417.jpg,van,9,282,640,10,360,37,3,291,47,LTAdatasets/9706/annotate/9706-2021_03_20_073417.jpg,286.5,42.0,0.44765625,0.11666666666666667,0.0140625,0.027777777777777776
9706-2021_03_20_073417.jpg,lorry_truck,12,302,640,13,360,37,2,314,50,LTAdatasets/9706/annotate/9706-2021_03_20_073417.jpg,308.0,43.5,0.48125,0.12083333333333333,0.01875,0.03611111111111111
9706-2021_03_20_203058.jpg,car,26,339,640,29,360,124,1,365,153,LTAdatasets/9706/annotate/9706-2021_03_20_203058.jpg,352.0,138.5,0.55,0.38472222222222224,0.040625,0.08055555555555556
9706-2021_03_20_203058.jpg,bike,11,232,640,17,360,106,4,243,123,LTAdatasets/9706/annotate/9706-2021_03_20_203058.jpg,237.5,114.5,0.37109375,0.31805555555555554,0.0171875,0.04722222222222222
9706-2021_03_20_203058.jpg,bike,16,167,640,15,360,125,4,183,140,LTAdatasets/9706/annotate/9706-2021_03_20_203058.jpg,175.0,132.5,0.2734375,0.3680555555555556,0.025,0.041666666666666664
9706-2021_03_20_203058.jpg,van,16,207,640,23,360,100,3,223,123,LTAdatasets/9706/annotate/9706-2021_03_20_203058.jpg,215.0,111.5,0.3359375,0.30972222222222223,0.025,0.06388888888888888
9706-2021_03_20_203058.jpg,lorry_truck,16,196,640,15,360,77,2,212,92,LTAdatasets/9706/annotate/9706-2021_03_20_203058.jpg,204.0,84.5,0.31875,0.23472222222222222,0.025,0.041666666666666664
9706-2021_03_20_203058.jpg,lorry_truck,11,209,640,26,360,41,2,220,67,LTAdatasets/9706/annotate/9706-2021_03_20_203058.jpg,214.5,54.0,0.33515625,0.15,0.0171875,0.07222222222222222
9706-2021_03_20_203058.jpg,car,8,227,640,9,360,55,1,235,64,LTAdatasets/9706/annotate/9706-2021_03_20_203058.jpg,231.0,59.5,0.3609375,0.16527777777777777,0.0125,0.025
9706-2021_03_20_203058.jpg,car,11,225,640,9,360,41,1,236,50,LTAdatasets/9706/annotate/9706-2021_03_20_203058.jpg,230.5,45.5,0.36015625,0.12638888888888888,0.0171875,0.025
9706-2021_03_20_203058.jpg,lorry_truck,17,289,640,11,360,37,2,306,48,LTAdatasets/9706/annotate/9706-2021_03_20_203058.jpg,297.5,42.5,0.46484375,0.11805555555555555,0.0265625,0.030555555555555555
9706-2021_03_20_194315.jpg,bus,54,114,640,71,360,136,5,168,207,LTAdatasets/9706/annotate/9706-2021_03_20_194315.jpg,141.0,171.5,0.2203125,0.47638888888888886,0.084375,0.19722222222222222
9706-2021_03_20_194315.jpg,van,47,401,640,77,360,240,3,448,317,LTAdatasets/9706/annotate/9706-2021_03_20_194315.jpg,424.5,278.5,0.66328125,0.7736111111111111,0.0734375,0.21388888888888888
9706-2021_03_20_194315.jpg,car,27,327,640,21,360,103,1,354,124,LTAdatasets/9706/annotate/9706-2021_03_20_194315.jpg,340.5,113.5,0.53203125,0.31527777777777777,0.0421875,0.058333333333333334
9706-2021_03_20_194315.jpg,car,24,194,640,25,360,122,1,218,147,LTAdatasets/9706/annotate/9706-2021_03_20_194315.jpg,206.0,134.5,0.321875,0.3736111111111111,0.0375,0.06944444444444445
9706-2021_03_20_194315.jpg,car,16,212,640,19,360,78,1,228,97,LTAdatasets/9706/annotate/9706-2021_03_20_194315.jpg,220.0,87.5,0.34375,0.24305555555555555,0.025,0.05277777777777778
9706-2021_03_20_194315.jpg,car,17,239,640,7,360,53,1,256,60,LTAdatasets/9706/annotate/9706-2021_03_20_194315.jpg,247.5,56.5,0.38671875,0.15694444444444444,0.0265625,0.019444444444444445
9706-2021_03_20_194315.jpg,car,8,224,640,7,360,38,1,232,45,LTAdatasets/9706/annotate/9706-2021_03_20_194315.jpg,228.0,41.5,0.35625,0.11527777777777778,0.0125,0.019444444444444445
9706-2021_03_20_194315.jpg,bike,8,224,640,10,360,64,4,232,74,LTAdatasets/9706/annotate/9706-2021_03_20_194315.jpg,228.0,69.0,0.35625,0.19166666666666668,0.0125,0.027777777777777776
9706-2021_03_20_194315.jpg,bike,28,148,640,42,360,311,4,176,353,LTAdatasets/9706/annotate/9706-2021_03_20_194315.jpg,162.0,332.0,0.253125,0.9222222222222223,0.04375,0.11666666666666667
9706-2021_03_20_194315.jpg,lorry_truck,23,181,640,23,360,88,2,204,111,LTAdatasets/9706/annotate/9706-2021_03_20_194315.jpg,192.5,99.5,0.30078125,0.2763888888888889,0.0359375,0.06388888888888888
9706-2021_03_20_194315.jpg,lorry_truck,28,336,640,28,360,66,2,364,94,LTAdatasets/9706/annotate/9706-2021_03_20_194315.jpg,350.0,80.0,0.546875,0.2222222222222222,0.04375,0.07777777777777778
9706-2021_03_20_194315.jpg,lorry_truck,13,209,640,14,360,49,2,222,63,LTAdatasets/9706/annotate/9706-2021_03_20_194315.jpg,215.5,56.0,0.33671875,0.15555555555555556,0.0203125,0.03888888888888889
9706-2021_03_20_194315.jpg,lorry_truck,14,209,640,9,360,38,2,223,47,LTAdatasets/9706/annotate/9706-2021_03_20_194315.jpg,216.0,42.5,0.3375,0.11805555555555555,0.021875,0.025
9706-2021_03_20_095505.jpg,van,42,420,640,46,360,184,3,462,230,LTAdatasets/9706/annotate/9706-2021_03_20_095505.jpg,441.0,207.0,0.6890625,0.575,0.065625,0.12777777777777777
9706-2021_03_20_095505.jpg,van,15,209,640,19,360,74,3,224,93,LTAdatasets/9706/annotate/9706-2021_03_20_095505.jpg,216.5,83.5,0.33828125,0.23194444444444445,0.0234375,0.05277777777777778
9706-2021_03_20_095505.jpg,bike,13,148,640,23,360,196,4,161,219,LTAdatasets/9706/annotate/9706-2021_03_20_095505.jpg,154.5,207.5,0.24140625,0.5763888888888888,0.0203125,0.06388888888888888
9706-2021_03_20_095505.jpg,bike,14,231,640,15,360,73,4,245,88,LTAdatasets/9706/annotate/9706-2021_03_20_095505.jpg,238.0,80.5,0.371875,0.22361111111111112,0.021875,0.041666666666666664
9706-2021_03_20_095505.jpg,car,21,122,640,33,360,170,1,143,203,LTAdatasets/9706/annotate/9706-2021_03_20_095505.jpg,132.5,186.5,0.20703125,0.5180555555555556,0.0328125,0.09166666666666666
9706-2021_03_20_095505.jpg,car,34,61,640,45,360,249,1,95,294,LTAdatasets/9706/annotate/9706-2021_03_20_095505.jpg,78.0,271.5,0.121875,0.7541666666666667,0.053125,0.125
9706-2021_03_20_095505.jpg,lorry_truck,14,183,640,18,360,90,2,197,108,LTAdatasets/9706/annotate/9706-2021_03_20_095505.jpg,190.0,99.0,0.296875,0.275,0.021875,0.05
9706-2021_03_20_095505.jpg,car,16,205,640,12,360,98,1,221,110,LTAdatasets/9706/annotate/9706-2021_03_20_095505.jpg,213.0,104.0,0.3328125,0.28888888888888886,0.025,0.03333333333333333
9706-2021_03_20_095505.jpg,car,8,240,640,11,360,53,1,248,64,LTAdatasets/9706/annotate/9706-2021_03_20_095505.jpg,244.0,58.5,0.38125,0.1625,0.0125,0.030555555555555555
9706-2021_03_20_095505.jpg,car,10,222,640,9,360,47,1,232,56,LTAdatasets/9706/annotate/9706-2021_03_20_095505.jpg,227.0,51.5,0.3546875,0.14305555555555555,0.015625,0.025
9706-2021_03_20_095505.jpg,car,10,289,640,6,360,48,1,299,54,LTAdatasets/9706/annotate/9706-2021_03_20_095505.jpg,294.0,51.0,0.459375,0.14166666666666666,0.015625,0.016666666666666666
9706-2021_03_20_095505.jpg,lorry_truck,14,335,640,22,360,70,2,349,92,LTAdatasets/9706/annotate/9706-2021_03_20_095505.jpg,342.0,81.0,0.534375,0.225,0.021875,0.06111111111111111
9706-2021_03_20_095505.jpg,lorry_truck,13,305,640,14,360,40,2,318,54,LTAdatasets/9706/annotate/9706-2021_03_20_095505.jpg,311.5,47.0,0.48671875,0.13055555555555556,0.0203125,0.03888888888888889
9706-2021_03_20_095505.jpg,lorry_truck,13,285,640,12,360,25,2,298,37,LTAdatasets/9706/annotate/9706-2021_03_20_095505.jpg,291.5,31.0,0.45546875,0.08611111111111111,0.0203125,0.03333333333333333
9706-2021_03_20_095505.jpg,van,11,283,640,8,360,40,3,294,48,LTAdatasets/9706/annotate/9706-2021_03_20_095505.jpg,288.5,44.0,0.45078125,0.12222222222222222,0.0171875,0.022222222222222223
9706-2021_03_20_095505.jpg,lorry_truck,15,205,640,14,360,56,2,220,70,LTAdatasets/9706/annotate/9706-2021_03_20_095505.jpg,212.5,63.0,0.33203125,0.175,0.0234375,0.03888888888888889
9706-2021_03_20_180710.jpg,lorry_truck,58,462,640,88,360,230,2,520,318,LTAdatasets/9706/annotate/9706-2021_03_20_180710.jpg,491.0,274.0,0.7671875,0.7611111111111111,0.090625,0.24444444444444444
9706-2021_03_20_180710.jpg,lorry_truck,12,188,640,23,360,86,2,200,109,LTAdatasets/9706/annotate/9706-2021_03_20_180710.jpg,194.0,97.5,0.303125,0.2708333333333333,0.01875,0.06388888888888888
9706-2021_03_20_180710.jpg,lorry_truck,18,203,640,21,360,48,2,221,69,LTAdatasets/9706/annotate/9706-2021_03_20_180710.jpg,212.0,58.5,0.33125,0.1625,0.028125,0.058333333333333334
9706-2021_03_20_180710.jpg,lorry_truck,10,295,640,15,360,32,2,305,47,LTAdatasets/9706/annotate/9706-2021_03_20_180710.jpg,300.0,39.5,0.46875,0.10972222222222222,0.015625,0.041666666666666664
9706-2021_03_20_180710.jpg,bike,11,300,640,14,360,81,4,311,95,LTAdatasets/9706/annotate/9706-2021_03_20_180710.jpg,305.5,88.0,0.47734375,0.24444444444444444,0.0171875,0.03888888888888889
9706-2021_03_20_180710.jpg,bike,15,308,640,10,360,61,4,323,71,LTAdatasets/9706/annotate/9706-2021_03_20_180710.jpg,315.5,66.0,0.49296875,0.18333333333333332,0.0234375,0.027777777777777776
9706-2021_03_20_180710.jpg,bike,12,219,640,6,360,43,4,231,49,LTAdatasets/9706/annotate/9706-2021_03_20_180710.jpg,225.0,46.0,0.3515625,0.12777777777777777,0.01875,0.016666666666666666
9706-2021_03_20_180710.jpg,van,26,338,640,35,360,116,3,364,151,LTAdatasets/9706/annotate/9706-2021_03_20_180710.jpg,351.0,133.5,0.5484375,0.37083333333333335,0.040625,0.09722222222222222
9706-2021_03_20_180710.jpg,car,17,238,640,12,360,75,1,255,87,LTAdatasets/9706/annotate/9706-2021_03_20_180710.jpg,246.5,81.0,0.38515625,0.225,0.0265625,0.03333333333333333
9706-2021_03_20_180710.jpg,car,20,181,640,21,360,147,1,201,168,LTAdatasets/9706/annotate/9706-2021_03_20_180710.jpg,191.0,157.5,0.2984375,0.4375,0.03125,0.058333333333333334
9706-2021_03_20_180710.jpg,car,12,209,640,18,360,97,1,221,115,LTAdatasets/9706/annotate/9706-2021_03_20_180710.jpg,215.0,106.0,0.3359375,0.29444444444444445,0.01875,0.05
9706-2021_03_20_180710.jpg,car,37,106,640,48,360,288,1,143,336,LTAdatasets/9706/annotate/9706-2021_03_20_180710.jpg,124.5,312.0,0.19453125,0.8666666666666667,0.0578125,0.13333333333333333
9706-2021_03_20_180710.jpg,car,16,240,640,10,360,59,1,256,69,LTAdatasets/9706/annotate/9706-2021_03_20_180710.jpg,248.0,64.0,0.3875,0.17777777777777778,0.025,0.027777777777777776
9706-2021_03_20_180710.jpg,car,8,225,640,10,360,58,1,233,68,LTAdatasets/9706/annotate/9706-2021_03_20_180710.jpg,229.0,63.0,0.3578125,0.175,0.0125,0.027777777777777776
9706-2021_03_20_180710.jpg,car,15,218,640,12,360,70,1,233,82,LTAdatasets/9706/annotate/9706-2021_03_20_180710.jpg,225.5,76.0,0.35234375,0.2111111111111111,0.0234375,0.03333333333333333
9706-2021_03_20_180710.jpg,car,6,292,640,6,360,49,1,298,55,LTAdatasets/9706/annotate/9706-2021_03_20_180710.jpg,295.0,52.0,0.4609375,0.14444444444444443,0.009375,0.016666666666666666
9706-2021_03_20_180710.jpg,car,7,238,640,10,360,42,1,245,52,LTAdatasets/9706/annotate/9706-2021_03_20_180710.jpg,241.5,47.0,0.37734375,0.13055555555555556,0.0109375,0.027777777777777776
9706-2021_03_20_181011.jpg,car,44,344,640,61,360,263,1,388,324,LTAdatasets/9706/annotate/9706-2021_03_20_181011.jpg,366.0,293.5,0.571875,0.8152777777777778,0.06875,0.16944444444444445
9706-2021_03_20_181011.jpg,car,38,172,640,51,360,247,1,210,298,LTAdatasets/9706/annotate/9706-2021_03_20_181011.jpg,191.0,272.5,0.2984375,0.7569444444444444,0.059375,0.14166666666666666
9706-2021_03_20_181011.jpg,car,35,377,640,43,360,184,1,412,227,LTAdatasets/9706/annotate/9706-2021_03_20_181011.jpg,394.5,205.5,0.61640625,0.5708333333333333,0.0546875,0.11944444444444445
9706-2021_03_20_181011.jpg,car,24,309,640,30,360,136,1,333,166,LTAdatasets/9706/annotate/9706-2021_03_20_181011.jpg,321.0,151.0,0.5015625,0.41944444444444445,0.0375,0.08333333333333333
9706-2021_03_20_181011.jpg,van,26,345,640,30,360,137,3,371,167,LTAdatasets/9706/annotate/9706-2021_03_20_181011.jpg,358.0,152.0,0.559375,0.4222222222222222,0.040625,0.08333333333333333
9706-2021_03_20_181011.jpg,lorry_truck,29,326,640,25,360,59,2,355,84,LTAdatasets/9706/annotate/9706-2021_03_20_181011.jpg,340.5,71.5,0.53203125,0.1986111111111111,0.0453125,0.06944444444444445
9706-2021_03_20_181011.jpg,bike,13,302,640,15,360,89,4,315,104,LTAdatasets/9706/annotate/9706-2021_03_20_181011.jpg,308.5,96.5,0.48203125,0.26805555555555555,0.0203125,0.041666666666666664
9706-2021_03_20_181011.jpg,car,17,237,640,14,360,78,1,254,92,LTAdatasets/9706/annotate/9706-2021_03_20_181011.jpg,245.5,85.0,0.38359375,0.2361111111111111,0.0265625,0.03888888888888889
9706-2021_03_20_181011.jpg,car,9,222,640,9,360,60,1,231,69,LTAdatasets/9706/annotate/9706-2021_03_20_181011.jpg,226.5,64.5,0.35390625,0.17916666666666667,0.0140625,0.025
9706-2021_03_20_181011.jpg,lorry_truck,10,239,640,16,360,54,2,249,70,LTAdatasets/9706/annotate/9706-2021_03_20_181011.jpg,244.0,62.0,0.38125,0.17222222222222222,0.015625,0.044444444444444446
9706-2021_03_20_181011.jpg,car,14,311,640,11,360,73,1,325,84,LTAdatasets/9706/annotate/9706-2021_03_20_181011.jpg,318.0,78.5,0.496875,0.21805555555555556,0.021875,0.030555555555555555
9706-2021_03_20_181011.jpg,car,17,326,640,12,360,95,1,343,107,LTAdatasets/9706/annotate/9706-2021_03_20_181011.jpg,334.5,101.0,0.52265625,0.28055555555555556,0.0265625,0.03333333333333333
9706-2021_03_20_181011.jpg,car,13,299,640,8,360,53,1,312,61,LTAdatasets/9706/annotate/9706-2021_03_20_181011.jpg,305.5,57.0,0.47734375,0.15833333333333333,0.0203125,0.022222222222222223
9706-2021_03_20_181011.jpg,van,9,300,640,9,360,40,3,309,49,LTAdatasets/9706/annotate/9706-2021_03_20_181011.jpg,304.5,44.5,0.47578125,0.12361111111111112,0.0140625,0.025
9706-2021_03_20_181011.jpg,car,14,283,640,8,360,41,1,297,49,LTAdatasets/9706/annotate/9706-2021_03_20_181011.jpg,290.0,45.0,0.453125,0.125,0.021875,0.022222222222222223
9706-2021_03_20_185753.jpg,lorry_truck,34,83,640,52,360,225,2,117,277,LTAdatasets/9706/annotate/9706-2021_03_20_185753.jpg,100.0,251.0,0.15625,0.6972222222222222,0.053125,0.14444444444444443
9706-2021_03_20_185753.jpg,car,24,192,640,28,360,120,1,216,148,LTAdatasets/9706/annotate/9706-2021_03_20_185753.jpg,204.0,134.0,0.31875,0.37222222222222223,0.0375,0.07777777777777778
9706-2021_03_20_185753.jpg,lorry_truck,12,196,640,14,360,72,2,208,86,LTAdatasets/9706/annotate/9706-2021_03_20_185753.jpg,202.0,79.0,0.315625,0.21944444444444444,0.01875,0.03888888888888889
9706-2021_03_20_185753.jpg,lorry_truck,16,312,640,11,360,50,2,328,61,LTAdatasets/9706/annotate/9706-2021_03_20_185753.jpg,320.0,55.5,0.5,0.15416666666666667,0.025,0.030555555555555555
9706-2021_03_20_185753.jpg,car,9,241,640,11,360,65,1,250,76,LTAdatasets/9706/annotate/9706-2021_03_20_185753.jpg,245.5,70.5,0.38359375,0.19583333333333333,0.0140625,0.030555555555555555
9706-2021_03_20_185753.jpg,car,10,208,640,9,360,62,1,218,71,LTAdatasets/9706/annotate/9706-2021_03_20_185753.jpg,213.0,66.5,0.3328125,0.18472222222222223,0.015625,0.025
9706-2021_03_20_185753.jpg,car,12,209,640,10,360,51,1,221,61,LTAdatasets/9706/annotate/9706-2021_03_20_185753.jpg,215.0,56.0,0.3359375,0.15555555555555556,0.01875,0.027777777777777776
9706-2021_03_20_185753.jpg,van,15,293,640,14,360,48,3,308,62,LTAdatasets/9706/annotate/9706-2021_03_20_185753.jpg,300.5,55.0,0.46953125,0.1527777777777778,0.0234375,0.03888888888888889
9706-2021_03_20_185753.jpg,car,10,239,640,6,360,49,1,249,55,LTAdatasets/9706/annotate/9706-2021_03_20_185753.jpg,244.0,52.0,0.38125,0.14444444444444443,0.015625,0.016666666666666666
9706-2021_03_20_091002.jpg,bus,73,420,640,81,360,178,5,493,259,LTAdatasets/9706/annotate/9706-2021_03_20_091002.jpg,456.5,218.5,0.71328125,0.6069444444444444,0.1140625,0.225
9706-2021_03_20_091002.jpg,lorry_truck,15,196,640,29,360,56,2,211,85,LTAdatasets/9706/annotate/9706-2021_03_20_091002.jpg,203.5,70.5,0.31796875,0.19583333333333333,0.0234375,0.08055555555555556
9706-2021_03_20_091002.jpg,lorry_truck,56,64,640,64,360,206,2,120,270,LTAdatasets/9706/annotate/9706-2021_03_20_091002.jpg,92.0,238.0,0.14375,0.6611111111111111,0.0875,0.17777777777777778
9706-2021_03_20_091002.jpg,car,32,133,640,53,360,244,1,165,297,LTAdatasets/9706/annotate/9706-2021_03_20_091002.jpg,149.0,270.5,0.2328125,0.7513888888888889,0.05,0.14722222222222223
9706-2021_03_20_091002.jpg,car,39,310,640,41,360,190,1,349,231,LTAdatasets/9706/annotate/9706-2021_03_20_091002.jpg,329.5,210.5,0.51484375,0.5847222222222223,0.0609375,0.11388888888888889
9706-2021_03_20_091002.jpg,lorry_truck,35,378,640,54,360,187,2,413,241,LTAdatasets/9706/annotate/9706-2021_03_20_091002.jpg,395.5,214.0,0.61796875,0.5944444444444444,0.0546875,0.15
9706-2021_03_20_091002.jpg,van,22,350,640,20,360,94,3,372,114,LTAdatasets/9706/annotate/9706-2021_03_20_091002.jpg,361.0,104.0,0.5640625,0.28888888888888886,0.034375,0.05555555555555555
9706-2021_03_20_091002.jpg,van,17,319,640,19,360,82,3,336,101,LTAdatasets/9706/annotate/9706-2021_03_20_091002.jpg,327.5,91.5,0.51171875,0.25416666666666665,0.0265625,0.05277777777777778
9706-2021_03_20_091002.jpg,car,17,301,640,19,360,106,1,318,125,LTAdatasets/9706/annotate/9706-2021_03_20_091002.jpg,309.5,115.5,0.48359375,0.32083333333333336,0.0265625,0.05277777777777778
9706-2021_03_20_091002.jpg,car,22,289,640,15,360,79,1,311,94,LTAdatasets/9706/annotate/9706-2021_03_20_091002.jpg,300.0,86.5,0.46875,0.24027777777777778,0.034375,0.041666666666666664
9706-2021_03_20_091002.jpg,car,16,212,640,15,360,88,1,228,103,LTAdatasets/9706/annotate/9706-2021_03_20_091002.jpg,220.0,95.5,0.34375,0.2652777777777778,0.025,0.041666666666666664
9706-2021_03_20_091002.jpg,car,13,188,640,14,360,86,1,201,100,LTAdatasets/9706/annotate/9706-2021_03_20_091002.jpg,194.5,93.0,0.30390625,0.25833333333333336,0.0203125,0.03888888888888889
9706-2021_03_20_091002.jpg,lorry_truck,19,164,640,24,360,109,2,183,133,LTAdatasets/9706/annotate/9706-2021_03_20_091002.jpg,173.5,121.0,0.27109375,0.33611111111111114,0.0296875,0.06666666666666667
9706-2021_03_20_091002.jpg,car,15,294,640,10,360,50,1,309,60,LTAdatasets/9706/annotate/9706-2021_03_20_091002.jpg,301.5,55.0,0.47109375,0.1527777777777778,0.0234375,0.027777777777777776
9706-2021_03_20_091002.jpg,lorry_truck,12,209,640,14,360,35,2,221,49,LTAdatasets/9706/annotate/9706-2021_03_20_091002.jpg,215.0,42.0,0.3359375,0.11666666666666667,0.01875,0.03888888888888889
9706-2021_03_20_091002.jpg,lorry_truck,14,302,640,15,360,37,2,316,52,LTAdatasets/9706/annotate/9706-2021_03_20_091002.jpg,309.0,44.5,0.4828125,0.12361111111111112,0.021875,0.041666666666666664
9706-2021_03_20_091002.jpg,car,14,223,640,10,360,50,1,237,60,LTAdatasets/9706/annotate/9706-2021_03_20_091002.jpg,230.0,55.0,0.359375,0.1527777777777778,0.021875,0.027777777777777776
9706-2021_03_20_091002.jpg,car,11,287,640,11,360,32,1,298,43,LTAdatasets/9706/annotate/9706-2021_03_20_091002.jpg,292.5,37.5,0.45703125,0.10416666666666667,0.0171875,0.030555555555555555
9706-2021_03_20_091002.jpg,car,10,236,640,7,360,41,1,246,48,LTAdatasets/9706/annotate/9706-2021_03_20_091002.jpg,241.0,44.5,0.3765625,0.12361111111111112,0.015625,0.019444444444444445
9706-2021_03_20_085822.jpg,car,47,342,640,72,360,280,1,389,352,LTAdatasets/9706/annotate/9706-2021_03_20_085822.jpg,365.5,316.0,0.57109375,0.8777777777777778,0.0734375,0.2
9706-2021_03_20_085822.jpg,van,44,388,640,60,360,206,3,432,266,LTAdatasets/9706/annotate/9706-2021_03_20_085822.jpg,410.0,236.0,0.640625,0.6555555555555556,0.06875,0.16666666666666666
9706-2021_03_20_085822.jpg,van,27,344,640,36,360,119,3,371,155,LTAdatasets/9706/annotate/9706-2021_03_20_085822.jpg,357.5,137.0,0.55859375,0.38055555555555554,0.0421875,0.1
9706-2021_03_20_085822.jpg,van,16,316,640,15,360,75,3,332,90,LTAdatasets/9706/annotate/9706-2021_03_20_085822.jpg,324.0,82.5,0.50625,0.22916666666666666,0.025,0.041666666666666664
9706-2021_03_20_085822.jpg,van,13,325,640,17,360,55,3,338,72,LTAdatasets/9706/annotate/9706-2021_03_20_085822.jpg,331.5,63.5,0.51796875,0.1763888888888889,0.0203125,0.04722222222222222
9706-2021_03_20_085822.jpg,lorry_truck,22,160,640,24,360,114,2,182,138,LTAdatasets/9706/annotate/9706-2021_03_20_085822.jpg,171.0,126.0,0.2671875,0.35,0.034375,0.06666666666666667
9706-2021_03_20_085822.jpg,lorry_truck,50,386,640,55,360,128,2,436,183,LTAdatasets/9706/annotate/9706-2021_03_20_085822.jpg,411.0,155.5,0.6421875,0.43194444444444446,0.078125,0.1527777777777778
9706-2021_03_20_085822.jpg,lorry_truck,31,348,640,31,360,81,2,379,112,LTAdatasets/9706/annotate/9706-2021_03_20_085822.jpg,363.5,96.5,0.56796875,0.26805555555555555,0.0484375,0.08611111111111111
9706-2021_03_20_085822.jpg,car,17,295,640,16,360,80,1,312,96,LTAdatasets/9706/annotate/9706-2021_03_20_085822.jpg,303.5,88.0,0.47421875,0.24444444444444444,0.0265625,0.044444444444444446
9706-2021_03_20_085822.jpg,car,10,303,640,12,360,56,1,313,68,LTAdatasets/9706/annotate/9706-2021_03_20_085822.jpg,308.0,62.0,0.48125,0.17222222222222222,0.015625,0.03333333333333333
9706-2021_03_20_085822.jpg,car,10,285,640,13,360,56,1,295,69,LTAdatasets/9706/annotate/9706-2021_03_20_085822.jpg,290.0,62.5,0.453125,0.1736111111111111,0.015625,0.03611111111111111
9706-2021_03_20_085822.jpg,car,10,291,640,9,360,45,1,301,54,LTAdatasets/9706/annotate/9706-2021_03_20_085822.jpg,296.0,49.5,0.4625,0.1375,0.015625,0.025
9706-2021_03_20_085822.jpg,lorry_truck,15,309,640,16,360,42,2,324,58,LTAdatasets/9706/annotate/9706-2021_03_20_085822.jpg,316.5,50.0,0.49453125,0.1388888888888889,0.0234375,0.044444444444444446
9706-2021_03_20_085822.jpg,bike,9,226,640,11,360,81,4,235,92,LTAdatasets/9706/annotate/9706-2021_03_20_085822.jpg,230.5,86.5,0.36015625,0.24027777777777778,0.0140625,0.030555555555555555
9706-2021_03_20_085822.jpg,car,11,222,640,11,360,64,1,233,75,LTAdatasets/9706/annotate/9706-2021_03_20_085822.jpg,227.5,69.5,0.35546875,0.19305555555555556,0.0171875,0.030555555555555555
9706-2021_03_20_085822.jpg,car,9,226,640,12,360,52,1,235,64,LTAdatasets/9706/annotate/9706-2021_03_20_085822.jpg,230.5,58.0,0.36015625,0.16111111111111112,0.0140625,0.03333333333333333
9706-2021_03_20_085822.jpg,lorry_truck,11,207,640,16,360,50,2,218,66,LTAdatasets/9706/annotate/9706-2021_03_20_085822.jpg,212.5,58.0,0.33203125,0.16111111111111112,0.0171875,0.044444444444444446
9706-2021_03_20_080119.jpg,lorry_truck,51,380,640,58,360,211,2,431,269,LTAdatasets/9706/annotate/9706-2021_03_20_080119.jpg,405.5,240.0,0.63359375,0.6666666666666666,0.0796875,0.16111111111111112
9706-2021_03_20_080119.jpg,car,19,342,640,21,360,122,1,361,143,LTAdatasets/9706/annotate/9706-2021_03_20_080119.jpg,351.5,132.5,0.54921875,0.3680555555555556,0.0296875,0.058333333333333334
9706-2021_03_20_080119.jpg,car,21,312,640,24,360,136,1,333,160,LTAdatasets/9706/annotate/9706-2021_03_20_080119.jpg,322.5,148.0,0.50390625,0.4111111111111111,0.0328125,0.06666666666666667
9706-2021_03_20_080119.jpg,car,11,294,640,21,360,68,1,305,89,LTAdatasets/9706/annotate/9706-2021_03_20_080119.jpg,299.5,78.5,0.46796875,0.21805555555555556,0.0171875,0.058333333333333334
9706-2021_03_20_080119.jpg,lorry_truck,17,195,640,21,360,68,2,212,89,LTAdatasets/9706/annotate/9706-2021_03_20_080119.jpg,203.5,78.5,0.31796875,0.21805555555555556,0.0265625,0.058333333333333334
9706-2021_03_20_080119.jpg,bike,15,313,640,13,360,83,4,328,96,LTAdatasets/9706/annotate/9706-2021_03_20_080119.jpg,320.5,89.5,0.50078125,0.24861111111111112,0.0234375,0.03611111111111111
9706-2021_03_20_080119.jpg,car,12,223,640,11,360,45,1,235,56,LTAdatasets/9706/annotate/9706-2021_03_20_080119.jpg,229.0,50.5,0.3578125,0.14027777777777778,0.01875,0.030555555555555555
9706-2021_03_20_202437.jpg,car,35,194,640,44,360,222,1,229,266,LTAdatasets/9706/annotate/9706-2021_03_20_202437.jpg,211.5,244.0,0.33046875,0.6777777777777778,0.0546875,0.12222222222222222
9706-2021_03_20_202437.jpg,car,18,200,640,24,360,109,1,218,133,LTAdatasets/9706/annotate/9706-2021_03_20_202437.jpg,209.0,121.0,0.3265625,0.33611111111111114,0.028125,0.06666666666666667
9706-2021_03_20_202437.jpg,car,15,239,640,14,360,102,1,254,116,LTAdatasets/9706/annotate/9706-2021_03_20_202437.jpg,246.5,109.0,0.38515625,0.30277777777777776,0.0234375,0.03888888888888889
9706-2021_03_20_202437.jpg,car,15,323,640,14,360,75,1,338,89,LTAdatasets/9706/annotate/9706-2021_03_20_202437.jpg,330.5,82.0,0.51640625,0.22777777777777777,0.0234375,0.03888888888888889
9706-2021_03_20_202437.jpg,car,16,219,640,14,360,73,1,235,87,LTAdatasets/9706/annotate/9706-2021_03_20_202437.jpg,227.0,80.0,0.3546875,0.2222222222222222,0.025,0.03888888888888889
9706-2021_03_20_202437.jpg,car,15,238,640,9,360,81,1,253,90,LTAdatasets/9706/annotate/9706-2021_03_20_202437.jpg,245.5,85.5,0.38359375,0.2375,0.0234375,0.025
9706-2021_03_20_202437.jpg,car,12,285,640,10,360,55,1,297,65,LTAdatasets/9706/annotate/9706-2021_03_20_202437.jpg,291.0,60.0,0.4546875,0.16666666666666666,0.01875,0.027777777777777776
9706-2021_03_20_202437.jpg,car,11,289,640,10,360,44,1,300,54,LTAdatasets/9706/annotate/9706-2021_03_20_202437.jpg,294.5,49.0,0.46015625,0.1361111111111111,0.0171875,0.027777777777777776
9706-2021_03_20_202437.jpg,car,11,242,640,9,360,48,1,253,57,LTAdatasets/9706/annotate/9706-2021_03_20_202437.jpg,247.5,52.5,0.38671875,0.14583333333333334,0.0171875,0.025
9706-2021_03_20_202437.jpg,lorry_truck,14,223,640,12,360,41,2,237,53,LTAdatasets/9706/annotate/9706-2021_03_20_202437.jpg,230.0,47.0,0.359375,0.13055555555555556,0.021875,0.03333333333333333
9706-2021_03_20_202437.jpg,van,11,219,640,10,360,58,3,230,68,LTAdatasets/9706/annotate/9706-2021_03_20_202437.jpg,224.5,63.0,0.35078125,0.175,0.0171875,0.027777777777777776
9706-2021_03_20_202437.jpg,car,7,214,640,6,360,44,1,221,50,LTAdatasets/9706/annotate/9706-2021_03_20_202437.jpg,217.5,47.0,0.33984375,0.13055555555555556,0.0109375,0.016666666666666666
9706-2021_03_20_192735.jpg,car,37,382,640,47,360,195,1,419,242,LTAdatasets/9706/annotate/9706-2021_03_20_192735.jpg,400.5,218.5,0.62578125,0.6069444444444444,0.0578125,0.13055555555555556
9706-2021_03_20_192735.jpg,car,23,309,640,19,360,138,1,332,157,LTAdatasets/9706/annotate/9706-2021_03_20_192735.jpg,320.5,147.5,0.50078125,0.4097222222222222,0.0359375,0.05277777777777778
9706-2021_03_20_192735.jpg,lorry_truck,38,130,640,48,360,128,2,168,176,LTAdatasets/9706/annotate/9706-2021_03_20_192735.jpg,149.0,152.0,0.2328125,0.4222222222222222,0.059375,0.13333333333333333
9706-2021_03_20_192735.jpg,bike,17,181,640,29,360,218,4,198,247,LTAdatasets/9706/annotate/9706-2021_03_20_192735.jpg,189.5,232.5,0.29609375,0.6458333333333334,0.0265625,0.08055555555555556
9706-2021_03_20_192735.jpg,bike,11,216,640,18,360,89,4,227,107,LTAdatasets/9706/annotate/9706-2021_03_20_192735.jpg,221.5,98.0,0.34609375,0.2722222222222222,0.0171875,0.05
9706-2021_03_20_192735.jpg,car,12,194,640,17,360,75,1,206,92,LTAdatasets/9706/annotate/9706-2021_03_20_192735.jpg,200.0,83.5,0.3125,0.23194444444444445,0.01875,0.04722222222222222
9706-2021_03_20_192735.jpg,car,12,223,640,11,360,59,1,235,70,LTAdatasets/9706/annotate/9706-2021_03_20_192735.jpg,229.0,64.5,0.3578125,0.17916666666666667,0.01875,0.030555555555555555
9706-2021_03_20_192735.jpg,car,10,209,640,10,360,58,1,219,68,LTAdatasets/9706/annotate/9706-2021_03_20_192735.jpg,214.0,63.0,0.334375,0.175,0.015625,0.027777777777777776
9706-2021_03_20_192735.jpg,van,11,225,640,10,360,45,3,236,55,LTAdatasets/9706/annotate/9706-2021_03_20_192735.jpg,230.5,50.0,0.36015625,0.1388888888888889,0.0171875,0.027777777777777776
9706-2021_03_20_192735.jpg,car,13,286,640,10,360,41,1,299,51,LTAdatasets/9706/annotate/9706-2021_03_20_192735.jpg,292.5,46.0,0.45703125,0.12777777777777777,0.0203125,0.027777777777777776
9706-2021_03_20_192735.jpg,car,10,213,640,9,360,49,1,223,58,LTAdatasets/9706/annotate/9706-2021_03_20_192735.jpg,218.0,53.5,0.340625,0.1486111111111111,0.015625,0.025
9706-2021_03_20_075518.jpg,lorry_truck,93,468,640,109,360,245,2,561,354,LTAdatasets/9706/annotate/9706-2021_03_20_075518.jpg,514.5,299.5,0.80390625,0.8319444444444445,0.1453125,0.30277777777777776
9706-2021_03_20_075518.jpg,bike,26,334,640,33,360,116,4,360,149,LTAdatasets/9706/annotate/9706-2021_03_20_075518.jpg,347.0,132.5,0.5421875,0.3680555555555556,0.040625,0.09166666666666666
9706-2021_03_20_075518.jpg,bike,16,300,640,15,360,55,4,316,70,LTAdatasets/9706/annotate/9706-2021_03_20_075518.jpg,308.0,62.5,0.48125,0.1736111111111111,0.025,0.041666666666666664
9706-2021_03_20_075518.jpg,bike,9,222,640,15,360,54,4,231,69,LTAdatasets/9706/annotate/9706-2021_03_20_075518.jpg,226.5,61.5,0.35390625,0.17083333333333334,0.0140625,0.041666666666666664
9706-2021_03_20_075518.jpg,car,15,236,640,13,360,79,1,251,92,LTAdatasets/9706/annotate/9706-2021_03_20_075518.jpg,243.5,85.5,0.38046875,0.2375,0.0234375,0.03611111111111111
9706-2021_03_20_075518.jpg,car,21,319,640,15,360,88,1,340,103,LTAdatasets/9706/annotate/9706-2021_03_20_075518.jpg,329.5,95.5,0.51484375,0.2652777777777778,0.0328125,0.041666666666666664
9706-2021_03_20_075518.jpg,car,16,302,640,19,360,97,1,318,116,LTAdatasets/9706/annotate/9706-2021_03_20_075518.jpg,310.0,106.5,0.484375,0.29583333333333334,0.025,0.05277777777777778
9706-2021_03_20_075518.jpg,car,19,166,640,20,360,126,1,185,146,LTAdatasets/9706/annotate/9706-2021_03_20_075518.jpg,175.5,136.0,0.27421875,0.37777777777777777,0.0296875,0.05555555555555555
9706-2021_03_20_075518.jpg,bike,10,207,640,10,360,76,4,217,86,LTAdatasets/9706/annotate/9706-2021_03_20_075518.jpg,212.0,81.0,0.33125,0.225,0.015625,0.027777777777777776
9706-2021_03_20_075518.jpg,bike,6,317,640,10,360,69,4,323,79,LTAdatasets/9706/annotate/9706-2021_03_20_075518.jpg,320.0,74.0,0.5,0.20555555555555555,0.009375,0.027777777777777776
9706-2021_03_20_075518.jpg,van,15,312,640,11,360,45,3,327,56,LTAdatasets/9706/annotate/9706-2021_03_20_075518.jpg,319.5,50.5,0.49921875,0.14027777777777778,0.0234375,0.030555555555555555
9706-2021_03_20_075518.jpg,car,9,225,640,7,360,38,1,234,45,LTAdatasets/9706/annotate/9706-2021_03_20_075518.jpg,229.5,41.5,0.35859375,0.11527777777777778,0.0140625,0.019444444444444445
9706-2021_03_20_075518.jpg,car,9,278,640,7,360,35,1,287,42,LTAdatasets/9706/annotate/9706-2021_03_20_075518.jpg,282.5,38.5,0.44140625,0.10694444444444444,0.0140625,0.019444444444444445
9706-2021_03_20_084301.jpg,lorry_truck,59,375,640,78,360,184,2,434,262,LTAdatasets/9706/annotate/9706-2021_03_20_084301.jpg,404.5,223.0,0.63203125,0.6194444444444445,0.0921875,0.21666666666666667
9706-2021_03_20_084301.jpg,lorry_truck,32,416,640,55,360,144,2,448,199,LTAdatasets/9706/annotate/9706-2021_03_20_084301.jpg,432.0,171.5,0.675,0.47638888888888886,0.05,0.1527777777777778
9706-2021_03_20_084301.jpg,car,44,96,640,58,360,285,1,140,343,LTAdatasets/9706/annotate/9706-2021_03_20_084301.jpg,118.0,314.0,0.184375,0.8722222222222222,0.06875,0.16111111111111112
9706-2021_03_20_084301.jpg,car,14,295,640,14,360,80,1,309,94,LTAdatasets/9706/annotate/9706-2021_03_20_084301.jpg,302.0,87.0,0.471875,0.24166666666666667,0.021875,0.03888888888888889
9706-2021_03_20_084301.jpg,car,12,289,640,15,360,64,1,301,79,LTAdatasets/9706/annotate/9706-2021_03_20_084301.jpg,295.0,71.5,0.4609375,0.1986111111111111,0.01875,0.041666666666666664
9706-2021_03_20_084301.jpg,car,10,296,640,11,360,46,1,306,57,LTAdatasets/9706/annotate/9706-2021_03_20_084301.jpg,301.0,51.5,0.4703125,0.14305555555555555,0.015625,0.030555555555555555
9706-2021_03_20_084301.jpg,car,12,283,640,14,360,52,1,295,66,LTAdatasets/9706/annotate/9706-2021_03_20_084301.jpg,289.0,59.0,0.4515625,0.1638888888888889,0.01875,0.03888888888888889
9706-2021_03_20_084301.jpg,lorry_truck,20,318,640,17,360,51,2,338,68,LTAdatasets/9706/annotate/9706-2021_03_20_084301.jpg,328.0,59.5,0.5125,0.16527777777777777,0.03125,0.04722222222222222
9706-2021_03_20_084301.jpg,lorry_truck,13,315,640,19,360,66,2,328,85,LTAdatasets/9706/annotate/9706-2021_03_20_084301.jpg,321.5,75.5,0.50234375,0.20972222222222223,0.0203125,0.05277777777777778
9706-2021_03_20_084301.jpg,van,12,213,640,19,360,82,3,225,101,LTAdatasets/9706/annotate/9706-2021_03_20_084301.jpg,219.0,91.5,0.3421875,0.25416666666666665,0.01875,0.05277777777777778
9706-2021_03_20_084301.jpg,lorry_truck,10,210,640,17,360,48,2,220,65,LTAdatasets/9706/annotate/9706-2021_03_20_084301.jpg,215.0,56.5,0.3359375,0.15694444444444444,0.015625,0.04722222222222222
9706-2021_03_20_084301.jpg,lorry_truck,14,209,640,12,360,38,2,223,50,LTAdatasets/9706/annotate/9706-2021_03_20_084301.jpg,216.0,44.0,0.3375,0.12222222222222222,0.021875,0.03333333333333333
9706-2021_03_20_084301.jpg,lorry_truck,12,289,640,10,360,31,2,301,41,LTAdatasets/9706/annotate/9706-2021_03_20_084301.jpg,295.0,36.0,0.4609375,0.1,0.01875,0.027777777777777776
9706-2021_03_20_080419.jpg,lorry_truck,48,439,640,76,360,209,2,487,285,LTAdatasets/9706/annotate/9706-2021_03_20_080419.jpg,463.0,247.0,0.7234375,0.6861111111111111,0.075,0.2111111111111111
9706-2021_03_20_080419.jpg,car,39,325,640,41,360,215,1,364,256,LTAdatasets/9706/annotate/9706-2021_03_20_080419.jpg,344.5,235.5,0.53828125,0.6541666666666667,0.0609375,0.11388888888888889
9706-2021_03_20_080419.jpg,car,24,308,640,27,360,120,1,332,147,LTAdatasets/9706/annotate/9706-2021_03_20_080419.jpg,320.0,133.5,0.5,0.37083333333333335,0.0375,0.075
9706-2021_03_20_080419.jpg,car,12,238,640,12,360,49,1,250,61,LTAdatasets/9706/annotate/9706-2021_03_20_080419.jpg,244.0,55.0,0.38125,0.1527777777777778,0.01875,0.03333333333333333
9706-2021_03_20_080419.jpg,car,9,288,640,9,360,39,1,297,48,LTAdatasets/9706/annotate/9706-2021_03_20_080419.jpg,292.5,43.5,0.45703125,0.12083333333333333,0.0140625,0.025
9706-2021_03_20_080419.jpg,van,16,317,640,19,360,68,3,333,87,LTAdatasets/9706/annotate/9706-2021_03_20_080419.jpg,325.0,77.5,0.5078125,0.2152777777777778,0.025,0.05277777777777778
9706-2021_03_20_080419.jpg,lorry_truck,33,362,640,32,360,99,2,395,131,LTAdatasets/9706/annotate/9706-2021_03_20_080419.jpg,378.5,115.0,0.59140625,0.3194444444444444,0.0515625,0.08888888888888889
9706-2021_03_20_080419.jpg,lorry_truck,24,164,640,31,360,99,2,188,130,LTAdatasets/9706/annotate/9706-2021_03_20_080419.jpg,176.0,114.5,0.275,0.31805555555555554,0.0375,0.08611111111111111
9706-2021_03_20_080419.jpg,lorry_truck,17,188,640,26,360,71,2,205,97,LTAdatasets/9706/annotate/9706-2021_03_20_080419.jpg,196.5,84.0,0.30703125,0.23333333333333334,0.0265625,0.07222222222222222
9706-2021_03_20_080419.jpg,van,28,169,640,28,360,154,3,197,182,LTAdatasets/9706/annotate/9706-2021_03_20_080419.jpg,183.0,168.0,0.2859375,0.4666666666666667,0.04375,0.07777777777777778
9706-2021_03_20_080419.jpg,van,31,353,640,37,360,144,3,384,181,LTAdatasets/9706/annotate/9706-2021_03_20_080419.jpg,368.5,162.5,0.57578125,0.4513888888888889,0.0484375,0.10277777777777777
9706-2021_03_20_080419.jpg,lorry_truck,9,210,640,12,360,33,2,219,45,LTAdatasets/9706/annotate/9706-2021_03_20_080419.jpg,214.5,39.0,0.33515625,0.10833333333333334,0.0140625,0.03333333333333333
9706-2021_03_20_080419.jpg,lorry_truck,9,223,640,10,360,35,2,232,45,LTAdatasets/9706/annotate/9706-2021_03_20_080419.jpg,227.5,40.0,0.35546875,0.1111111111111111,0.0140625,0.027777777777777776
9706-2021_03_20_080419.jpg,car,8,210,640,10,360,46,1,218,56,LTAdatasets/9706/annotate/9706-2021_03_20_080419.jpg,214.0,51.0,0.334375,0.14166666666666666,0.0125,0.027777777777777776
9706-2021_03_20_080419.jpg,van,9,303,640,12,360,37,3,312,49,LTAdatasets/9706/annotate/9706-2021_03_20_080419.jpg,307.5,43.0,0.48046875,0.11944444444444445,0.0140625,0.03333333333333333
9706-2021_03_20_183412.jpg,car,49,420,640,57,360,303,1,469,360,LTAdatasets/9706/annotate/9706-2021_03_20_183412.jpg,444.5,331.5,0.69453125,0.9208333333333333,0.0765625,0.15833333333333333
9706-2021_03_20_183412.jpg,car,28,170,640,31,360,161,1,198,192,LTAdatasets/9706/annotate/9706-2021_03_20_183412.jpg,184.0,176.5,0.2875,0.49027777777777776,0.04375,0.08611111111111111
9706-2021_03_20_183412.jpg,car,33,106,640,31,360,182,1,139,213,LTAdatasets/9706/annotate/9706-2021_03_20_183412.jpg,122.5,197.5,0.19140625,0.5486111111111112,0.0515625,0.08611111111111111
9706-2021_03_20_183412.jpg,car,27,325,640,39,360,178,1,352,217,LTAdatasets/9706/annotate/9706-2021_03_20_183412.jpg,338.5,197.5,0.52890625,0.5486111111111112,0.0421875,0.10833333333333334
9706-2021_03_20_183412.jpg,car,10,239,640,16,360,87,1,249,103,LTAdatasets/9706/annotate/9706-2021_03_20_183412.jpg,244.0,95.0,0.38125,0.2638888888888889,0.015625,0.044444444444444446
9706-2021_03_20_183412.jpg,car,15,210,640,17,360,94,1,225,111,LTAdatasets/9706/annotate/9706-2021_03_20_183412.jpg,217.5,102.5,0.33984375,0.2847222222222222,0.0234375,0.04722222222222222
9706-2021_03_20_183412.jpg,car,16,169,640,21,360,114,1,185,135,LTAdatasets/9706/annotate/9706-2021_03_20_183412.jpg,177.0,124.5,0.2765625,0.3458333333333333,0.025,0.058333333333333334
9706-2021_03_20_183412.jpg,car,13,202,640,9,360,69,1,215,78,LTAdatasets/9706/annotate/9706-2021_03_20_183412.jpg,208.5,73.5,0.32578125,0.20416666666666666,0.0203125,0.025
9706-2021_03_20_183412.jpg,car,11,225,640,9,360,64,1,236,73,LTAdatasets/9706/annotate/9706-2021_03_20_183412.jpg,230.5,68.5,0.36015625,0.19027777777777777,0.0171875,0.025
9706-2021_03_20_183412.jpg,car,6,309,640,11,360,60,1,315,71,LTAdatasets/9706/annotate/9706-2021_03_20_183412.jpg,312.0,65.5,0.4875,0.18194444444444444,0.009375,0.030555555555555555
9706-2021_03_20_183412.jpg,lorry_truck,25,330,640,32,360,91,2,355,123,LTAdatasets/9706/annotate/9706-2021_03_20_183412.jpg,342.5,107.0,0.53515625,0.2972222222222222,0.0390625,0.08888888888888889
9706-2021_03_20_183412.jpg,lorry_truck,11,210,640,14,360,51,2,221,65,LTAdatasets/9706/annotate/9706-2021_03_20_183412.jpg,215.5,58.0,0.33671875,0.16111111111111112,0.0171875,0.03888888888888889
9706-2021_03_20_183412.jpg,car,11,237,640,9,360,50,1,248,59,LTAdatasets/9706/annotate/9706-2021_03_20_183412.jpg,242.5,54.5,0.37890625,0.15138888888888888,0.0171875,0.025
9706-2021_03_20_183412.jpg,car,9,287,640,12,360,40,1,296,52,LTAdatasets/9706/annotate/9706-2021_03_20_183412.jpg,291.5,46.0,0.45546875,0.12777777777777777,0.0140625,0.03333333333333333
9706-2021_03_20_183412.jpg,car,9,286,640,15,360,55,1,295,70,LTAdatasets/9706/annotate/9706-2021_03_20_183412.jpg,290.5,62.5,0.45390625,0.1736111111111111,0.0140625,0.041666666666666664
9706-2021_03_20_183412.jpg,bike,5,297,640,14,360,55,4,302,69,LTAdatasets/9706/annotate/9706-2021_03_20_183412.jpg,299.5,62.0,0.46796875,0.17222222222222222,0.0078125,0.03888888888888889
9706-2021_03_20_183412.jpg,lorry_truck,10,222,640,7,360,36,2,232,43,LTAdatasets/9706/annotate/9706-2021_03_20_183412.jpg,227.0,39.5,0.3546875,0.10972222222222222,0.015625,0.019444444444444445
9706-2021_03_20_201617.jpg,lorry_truck,70,6,640,78,360,282,2,76,360,LTAdatasets/9706/annotate/9706-2021_03_20_201617.jpg,41.0,321.0,0.0640625,0.8916666666666667,0.109375,0.21666666666666667
9706-2021_03_20_201617.jpg,lorry_truck,22,313,640,25,360,43,2,335,68,LTAdatasets/9706/annotate/9706-2021_03_20_201617.jpg,324.0,55.5,0.50625,0.15416666666666667,0.034375,0.06944444444444445
9706-2021_03_20_201617.jpg,lorry_truck,14,207,640,19,360,51,2,221,70,LTAdatasets/9706/annotate/9706-2021_03_20_201617.jpg,214.0,60.5,0.334375,0.16805555555555557,0.021875,0.05277777777777778
9706-2021_03_20_201617.jpg,bike,15,389,640,21,360,157,4,404,178,LTAdatasets/9706/annotate/9706-2021_03_20_201617.jpg,396.5,167.5,0.61953125,0.4652777777777778,0.0234375,0.058333333333333334
9706-2021_03_20_201617.jpg,bike,14,337,640,23,360,153,4,351,176,LTAdatasets/9706/annotate/9706-2021_03_20_201617.jpg,344.0,164.5,0.5375,0.45694444444444443,0.021875,0.06388888888888888
9706-2021_03_20_201617.jpg,bike,15,180,640,19,360,156,4,195,175,LTAdatasets/9706/annotate/9706-2021_03_20_201617.jpg,187.5,165.5,0.29296875,0.4597222222222222,0.0234375,0.05277777777777778
9706-2021_03_20_201617.jpg,car,21,307,640,27,360,131,1,328,158,LTAdatasets/9706/annotate/9706-2021_03_20_201617.jpg,317.5,144.5,0.49609375,0.4013888888888889,0.0328125,0.075
9706-2021_03_20_201617.jpg,car,45,322,640,45,360,225,1,367,270,LTAdatasets/9706/annotate/9706-2021_03_20_201617.jpg,344.5,247.5,0.53828125,0.6875,0.0703125,0.125
9706-2021_03_20_201617.jpg,car,43,388,640,44,360,235,1,431,279,LTAdatasets/9706/annotate/9706-2021_03_20_201617.jpg,409.5,257.0,0.63984375,0.7138888888888889,0.0671875,0.12222222222222222
9706-2021_03_20_201617.jpg,car,23,325,640,20,360,96,1,348,116,LTAdatasets/9706/annotate/9706-2021_03_20_201617.jpg,336.5,106.0,0.52578125,0.29444444444444445,0.0359375,0.05555555555555555
9706-2021_03_20_201617.jpg,car,15,292,640,17,360,76,1,307,93,LTAdatasets/9706/annotate/9706-2021_03_20_201617.jpg,299.5,84.5,0.46796875,0.23472222222222222,0.0234375,0.04722222222222222
9706-2021_03_20_201617.jpg,van,20,312,640,17,360,70,3,332,87,LTAdatasets/9706/annotate/9706-2021_03_20_201617.jpg,322.0,78.5,0.503125,0.21805555555555556,0.03125,0.04722222222222222
9706-2021_03_20_201617.jpg,van,14,218,640,19,360,71,3,232,90,LTAdatasets/9706/annotate/9706-2021_03_20_201617.jpg,225.0,80.5,0.3515625,0.22361111111111112,0.021875,0.05277777777777778
9706-2021_03_20_201617.jpg,van,17,188,640,16,360,88,3,205,104,LTAdatasets/9706/annotate/9706-2021_03_20_201617.jpg,196.5,96.0,0.30703125,0.26666666666666666,0.0265625,0.044444444444444446
9706-2021_03_20_201617.jpg,car,10,237,640,9,360,42,1,247,51,LTAdatasets/9706/annotate/9706-2021_03_20_201617.jpg,242.0,46.5,0.378125,0.12916666666666668,0.015625,0.025
9706-2021_03_20_201617.jpg,car,12,223,640,6,360,42,1,235,48,LTAdatasets/9706/annotate/9706-2021_03_20_201617.jpg,229.0,45.0,0.3578125,0.125,0.01875,0.016666666666666666
9706-2021_03_20_201617.jpg,van,47,455,640,63,360,231,3,502,294,LTAdatasets/9706/annotate/9706-2021_03_20_201617.jpg,478.5,262.5,0.74765625,0.7291666666666666,0.0734375,0.175
9706-2021_03_20_201617.jpg,car,28,351,640,32,360,155,1,379,187,LTAdatasets/9706/annotate/9706-2021_03_20_201617.jpg,365.0,171.0,0.5703125,0.475,0.04375,0.08888888888888889
9706-2021_03_20_190634.jpg,car,35,333,640,48,360,205,1,368,253,LTAdatasets/9706/annotate/9706-2021_03_20_190634.jpg,350.5,229.0,0.54765625,0.6361111111111111,0.0546875,0.13333333333333333
9706-2021_03_20_190634.jpg,car,30,355,640,28,360,152,1,385,180,LTAdatasets/9706/annotate/9706-2021_03_20_190634.jpg,370.0,166.0,0.578125,0.46111111111111114,0.046875,0.07777777777777778
9706-2021_03_20_190634.jpg,car,17,300,640,22,360,91,1,317,113,LTAdatasets/9706/annotate/9706-2021_03_20_190634.jpg,308.5,102.0,0.48203125,0.2833333333333333,0.0265625,0.06111111111111111
9706-2021_03_20_190634.jpg,car,14,207,640,16,360,84,1,221,100,LTAdatasets/9706/annotate/9706-2021_03_20_190634.jpg,214.0,92.0,0.334375,0.25555555555555554,0.021875,0.044444444444444446
9706-2021_03_20_190634.jpg,car,9,238,640,12,360,61,1,247,73,LTAdatasets/9706/annotate/9706-2021_03_20_190634.jpg,242.5,67.0,0.37890625,0.18611111111111112,0.0140625,0.03333333333333333
9706-2021_03_20_190634.jpg,lorry_truck,20,177,640,26,360,98,2,197,124,LTAdatasets/9706/annotate/9706-2021_03_20_190634.jpg,187.0,111.0,0.2921875,0.30833333333333335,0.03125,0.07222222222222222
9706-2021_03_20_190634.jpg,car,9,292,640,15,360,69,1,301,84,LTAdatasets/9706/annotate/9706-2021_03_20_190634.jpg,296.5,76.5,0.46328125,0.2125,0.0140625,0.041666666666666664
9706-2021_03_20_190634.jpg,car,14,297,640,15,360,50,1,311,65,LTAdatasets/9706/annotate/9706-2021_03_20_190634.jpg,304.0,57.5,0.475,0.1597222222222222,0.021875,0.041666666666666664
9706-2021_03_20_190634.jpg,van,14,319,640,12,360,60,3,333,72,LTAdatasets/9706/annotate/9706-2021_03_20_190634.jpg,326.0,66.0,0.509375,0.18333333333333332,0.021875,0.03333333333333333
9706-2021_03_20_190634.jpg,bike,12,299,640,14,360,62,4,311,76,LTAdatasets/9706/annotate/9706-2021_03_20_190634.jpg,305.0,69.0,0.4765625,0.19166666666666668,0.01875,0.03888888888888889
9706-2021_03_20_190634.jpg,car,11,307,640,10,360,43,1,318,53,LTAdatasets/9706/annotate/9706-2021_03_20_190634.jpg,312.5,48.0,0.48828125,0.13333333333333333,0.0171875,0.027777777777777776
9706-2021_03_20_190634.jpg,car,11,289,640,10,360,44,1,300,54,LTAdatasets/9706/annotate/9706-2021_03_20_190634.jpg,294.5,49.0,0.46015625,0.1361111111111111,0.0171875,0.027777777777777776
9706-2021_03_20_195136.jpg,car,41,379,640,47,360,195,1,420,242,LTAdatasets/9706/annotate/9706-2021_03_20_195136.jpg,399.5,218.5,0.62421875,0.6069444444444444,0.0640625,0.13055555555555556
9706-2021_03_20_195136.jpg,car,18,177,640,28,360,164,1,195,192,LTAdatasets/9706/annotate/9706-2021_03_20_195136.jpg,186.0,178.0,0.290625,0.49444444444444446,0.028125,0.07777777777777778
9706-2021_03_20_195136.jpg,car,21,135,640,27,360,162,1,156,189,LTAdatasets/9706/annotate/9706-2021_03_20_195136.jpg,145.5,175.5,0.22734375,0.4875,0.0328125,0.075
9706-2021_03_20_195136.jpg,car,15,216,640,15,360,85,1,231,100,LTAdatasets/9706/annotate/9706-2021_03_20_195136.jpg,223.5,92.5,0.34921875,0.2569444444444444,0.0234375,0.041666666666666664
9706-2021_03_20_195136.jpg,car,12,238,640,16,360,73,1,250,89,LTAdatasets/9706/annotate/9706-2021_03_20_195136.jpg,244.0,81.0,0.38125,0.225,0.01875,0.044444444444444446
9706-2021_03_20_195136.jpg,car,10,201,640,9,360,73,1,211,82,LTAdatasets/9706/annotate/9706-2021_03_20_195136.jpg,206.0,77.5,0.321875,0.2152777777777778,0.015625,0.025
9706-2021_03_20_195136.jpg,car,13,286,640,10,360,63,1,299,73,LTAdatasets/9706/annotate/9706-2021_03_20_195136.jpg,292.5,68.0,0.45703125,0.18888888888888888,0.0203125,0.027777777777777776
9706-2021_03_20_195136.jpg,car,8,226,640,9,360,57,1,234,66,LTAdatasets/9706/annotate/9706-2021_03_20_195136.jpg,230.0,61.5,0.359375,0.17083333333333334,0.0125,0.025
9706-2021_03_20_195136.jpg,car,11,241,640,10,360,54,1,252,64,LTAdatasets/9706/annotate/9706-2021_03_20_195136.jpg,246.5,59.0,0.38515625,0.1638888888888889,0.0171875,0.027777777777777776
9706-2021_03_20_195136.jpg,car,7,242,640,7,360,45,1,249,52,LTAdatasets/9706/annotate/9706-2021_03_20_195136.jpg,245.5,48.5,0.38359375,0.13472222222222222,0.0109375,0.019444444444444445
9706-2021_03_20_195136.jpg,van,10,225,640,16,360,45,3,235,61,LTAdatasets/9706/annotate/9706-2021_03_20_195136.jpg,230.0,53.0,0.359375,0.14722222222222223,0.015625,0.044444444444444446
9706-2021_03_20_195136.jpg,lorry_truck,11,211,640,11,360,46,2,222,57,LTAdatasets/9706/annotate/9706-2021_03_20_195136.jpg,216.5,51.5,0.33828125,0.14305555555555555,0.0171875,0.030555555555555555
9706-2021_03_20_195136.jpg,lorry_truck,16,308,640,19,360,37,2,324,56,LTAdatasets/9706/annotate/9706-2021_03_20_195136.jpg,316.0,46.5,0.49375,0.12916666666666668,0.025,0.05277777777777778
9706-2021_03_20_195136.jpg,car,12,290,640,7,360,47,1,302,54,LTAdatasets/9706/annotate/9706-2021_03_20_195136.jpg,296.0,50.5,0.4625,0.14027777777777778,0.01875,0.019444444444444445
9706-2021_03_20_195736.jpg,lorry_truck,77,420,640,91,360,181,2,497,272,LTAdatasets/9706/annotate/9706-2021_03_20_195736.jpg,458.5,226.5,0.71640625,0.6291666666666667,0.1203125,0.25277777777777777
9706-2021_03_20_195736.jpg,lorry_truck,18,198,640,29,360,60,2,216,89,LTAdatasets/9706/annotate/9706-2021_03_20_195736.jpg,207.0,74.5,0.3234375,0.20694444444444443,0.028125,0.08055555555555556
9706-2021_03_20_195736.jpg,car,17,297,640,14,360,85,1,314,99,LTAdatasets/9706/annotate/9706-2021_03_20_195736.jpg,305.5,92.0,0.47734375,0.25555555555555554,0.0265625,0.03888888888888889
9706-2021_03_20_195736.jpg,car,10,287,640,11,360,43,1,297,54,LTAdatasets/9706/annotate/9706-2021_03_20_195736.jpg,292.0,48.5,0.45625,0.13472222222222222,0.015625,0.030555555555555555
9706-2021_03_20_195736.jpg,car,24,171,640,26,360,171,1,195,197,LTAdatasets/9706/annotate/9706-2021_03_20_195736.jpg,183.0,184.0,0.2859375,0.5111111111111111,0.0375,0.07222222222222222
9706-2021_03_20_190413.jpg,car,43,359,640,36,360,324,1,402,360,LTAdatasets/9706/annotate/9706-2021_03_20_190413.jpg,380.5,342.0,0.59453125,0.95,0.0671875,0.1
9706-2021_03_20_190413.jpg,car,41,393,640,59,360,205,1,434,264,LTAdatasets/9706/annotate/9706-2021_03_20_190413.jpg,413.5,234.5,0.64609375,0.6513888888888889,0.0640625,0.1638888888888889
9706-2021_03_20_190413.jpg,car,27,321,640,35,360,160,1,348,195,LTAdatasets/9706/annotate/9706-2021_03_20_190413.jpg,334.5,177.5,0.52265625,0.4930555555555556,0.0421875,0.09722222222222222
9706-2021_03_20_190413.jpg,car,15,331,640,17,360,104,1,346,121,LTAdatasets/9706/annotate/9706-2021_03_20_190413.jpg,338.5,112.5,0.52890625,0.3125,0.0234375,0.04722222222222222
9706-2021_03_20_190413.jpg,van,20,361,640,23,360,102,3,381,125,LTAdatasets/9706/annotate/9706-2021_03_20_190413.jpg,371.0,113.5,0.5796875,0.31527777777777777,0.03125,0.06388888888888888
9706-2021_03_20_190413.jpg,car,18,341,640,14,360,84,1,359,98,LTAdatasets/9706/annotate/9706-2021_03_20_190413.jpg,350.0,91.0,0.546875,0.25277777777777777,0.028125,0.03888888888888889
9706-2021_03_20_190413.jpg,bike,9,309,640,12,360,113,4,318,125,LTAdatasets/9706/annotate/9706-2021_03_20_190413.jpg,313.5,119.0,0.48984375,0.33055555555555555,0.0140625,0.03333333333333333
9706-2021_03_20_190413.jpg,bike,15,188,640,22,360,128,4,203,150,LTAdatasets/9706/annotate/9706-2021_03_20_190413.jpg,195.5,139.0,0.30546875,0.3861111111111111,0.0234375,0.06111111111111111
9706-2021_03_20_190413.jpg,car,20,145,640,30,360,146,1,165,176,LTAdatasets/9706/annotate/9706-2021_03_20_190413.jpg,155.0,161.0,0.2421875,0.44722222222222224,0.03125,0.08333333333333333
9706-2021_03_20_190413.jpg,car,10,300,640,7,360,58,1,310,65,LTAdatasets/9706/annotate/9706-2021_03_20_190413.jpg,305.0,61.5,0.4765625,0.17083333333333334,0.015625,0.019444444444444445
9706-2021_03_20_190413.jpg,car,12,219,640,11,360,76,1,231,87,LTAdatasets/9706/annotate/9706-2021_03_20_190413.jpg,225.0,81.5,0.3515625,0.2263888888888889,0.01875,0.030555555555555555
9706-2021_03_20_190413.jpg,car,18,189,640,12,360,95,1,207,107,LTAdatasets/9706/annotate/9706-2021_03_20_190413.jpg,198.0,101.0,0.309375,0.28055555555555556,0.028125,0.03333333333333333
9706-2021_03_20_190413.jpg,lorry_truck,20,311,640,16,360,46,2,331,62,LTAdatasets/9706/annotate/9706-2021_03_20_190413.jpg,321.0,54.0,0.5015625,0.15,0.03125,0.044444444444444446
9706-2021_03_20_190413.jpg,lorry_truck,9,211,640,11,360,48,2,220,59,LTAdatasets/9706/annotate/9706-2021_03_20_190413.jpg,215.5,53.5,0.33671875,0.1486111111111111,0.0140625,0.030555555555555555
9706-2021_03_20_190413.jpg,bike,7,225,640,11,360,59,4,232,70,LTAdatasets/9706/annotate/9706-2021_03_20_190413.jpg,228.5,64.5,0.35703125,0.17916666666666667,0.0109375,0.030555555555555555
9706-2021_03_20_190413.jpg,car,9,238,640,8,360,46,1,247,54,LTAdatasets/9706/annotate/9706-2021_03_20_190413.jpg,242.5,50.0,0.37890625,0.1388888888888889,0.0140625,0.022222222222222223
9706-2021_03_20_190413.jpg,car,7,226,640,11,360,48,1,233,59,LTAdatasets/9706/annotate/9706-2021_03_20_190413.jpg,229.5,53.5,0.35859375,0.1486111111111111,0.0109375,0.030555555555555555
9706-2021_03_20_182151.jpg,car,57,444,640,72,360,241,1,501,313,LTAdatasets/9706/annotate/9706-2021_03_20_182151.jpg,472.5,277.0,0.73828125,0.7694444444444445,0.0890625,0.2
9706-2021_03_20_182151.jpg,car,22,406,640,30,360,156,1,428,186,LTAdatasets/9706/annotate/9706-2021_03_20_182151.jpg,417.0,171.0,0.6515625,0.475,0.034375,0.08333333333333333
9706-2021_03_20_182151.jpg,car,18,364,640,24,360,107,1,382,131,LTAdatasets/9706/annotate/9706-2021_03_20_182151.jpg,373.0,119.0,0.5828125,0.33055555555555555,0.028125,0.06666666666666667
9706-2021_03_20_182151.jpg,car,23,114,640,25,360,190,1,137,215,LTAdatasets/9706/annotate/9706-2021_03_20_182151.jpg,125.5,202.5,0.19609375,0.5625,0.0359375,0.06944444444444445
9706-2021_03_20_182151.jpg,car,16,239,640,16,360,94,1,255,110,LTAdatasets/9706/annotate/9706-2021_03_20_182151.jpg,247.0,102.0,0.3859375,0.2833333333333333,0.025,0.044444444444444446
9706-2021_03_20_182151.jpg,car,17,204,640,19,360,118,1,221,137,LTAdatasets/9706/annotate/9706-2021_03_20_182151.jpg,212.5,127.5,0.33203125,0.3541666666666667,0.0265625,0.05277777777777778
9706-2021_03_20_182151.jpg,car,22,306,640,26,360,129,1,328,155,LTAdatasets/9706/annotate/9706-2021_03_20_182151.jpg,317.0,142.0,0.4953125,0.39444444444444443,0.034375,0.07222222222222222
9706-2021_03_20_182151.jpg,car,11,297,640,17,360,77,1,308,94,LTAdatasets/9706/annotate/9706-2021_03_20_182151.jpg,302.5,85.5,0.47265625,0.2375,0.0171875,0.04722222222222222
9706-2021_03_20_182151.jpg,car,11,225,640,11,360,61,1,236,72,LTAdatasets/9706/annotate/9706-2021_03_20_182151.jpg,230.5,66.5,0.36015625,0.18472222222222223,0.0171875,0.030555555555555555
9706-2021_03_20_182151.jpg,car,11,223,640,9,360,50,1,234,59,LTAdatasets/9706/annotate/9706-2021_03_20_182151.jpg,228.5,54.5,0.35703125,0.15138888888888888,0.0171875,0.025
9706-2021_03_20_182151.jpg,car,10,239,640,12,360,45,1,249,57,LTAdatasets/9706/annotate/9706-2021_03_20_182151.jpg,244.0,51.0,0.38125,0.14166666666666666,0.015625,0.03333333333333333
9706-2021_03_20_182151.jpg,lorry_truck,20,331,640,17,360,68,2,351,85,LTAdatasets/9706/annotate/9706-2021_03_20_182151.jpg,341.0,76.5,0.5328125,0.2125,0.03125,0.04722222222222222
9706-2021_03_20_182151.jpg,lorry_truck,10,201,640,14,360,70,2,211,84,LTAdatasets/9706/annotate/9706-2021_03_20_182151.jpg,206.0,77.0,0.321875,0.21388888888888888,0.015625,0.03888888888888889
9706-2021_03_20_182151.jpg,van,11,205,640,9,360,60,3,216,69,LTAdatasets/9706/annotate/9706-2021_03_20_182151.jpg,210.5,64.5,0.32890625,0.17916666666666667,0.0171875,0.025
9706-2021_03_20_182151.jpg,van,21,207,640,16,360,88,3,228,104,LTAdatasets/9706/annotate/9706-2021_03_20_182151.jpg,217.5,96.0,0.33984375,0.26666666666666666,0.0328125,0.044444444444444446
9706-2021_03_20_182151.jpg,bike,10,237,640,12,360,69,4,247,81,LTAdatasets/9706/annotate/9706-2021_03_20_182151.jpg,242.0,75.0,0.378125,0.20833333333333334,0.015625,0.03333333333333333
9706-2021_03_20_075818.jpg,car,31,191,640,56,360,269,1,222,325,LTAdatasets/9706/annotate/9706-2021_03_20_075818.jpg,206.5,297.0,0.32265625,0.825,0.0484375,0.15555555555555556
9706-2021_03_20_075818.jpg,car,11,234,640,17,360,82,1,245,99,LTAdatasets/9706/annotate/9706-2021_03_20_075818.jpg,239.5,90.5,0.37421875,0.2513888888888889,0.0171875,0.04722222222222222
9706-2021_03_20_075818.jpg,car,14,290,640,15,360,68,1,304,83,LTAdatasets/9706/annotate/9706-2021_03_20_075818.jpg,297.0,75.5,0.4640625,0.20972222222222223,0.021875,0.041666666666666664
9706-2021_03_20_075818.jpg,lorry_truck,17,300,640,15,360,38,2,317,53,LTAdatasets/9706/annotate/9706-2021_03_20_075818.jpg,308.5,45.5,0.48203125,0.12638888888888888,0.0265625,0.041666666666666664
9706-2021_03_20_075818.jpg,lorry_truck,27,337,640,24,360,76,2,364,100,LTAdatasets/9706/annotate/9706-2021_03_20_075818.jpg,350.5,88.0,0.54765625,0.24444444444444444,0.0421875,0.06666666666666667
9706-2021_03_20_075818.jpg,lorry_truck,11,283,640,7,360,30,2,294,37,LTAdatasets/9706/annotate/9706-2021_03_20_075818.jpg,288.5,33.5,0.45078125,0.09305555555555556,0.0171875,0.019444444444444445
9706-2021_03_20_075818.jpg,lorry_truck,60,3,640,43,360,317,2,63,360,LTAdatasets/9706/annotate/9706-2021_03_20_075818.jpg,33.0,338.5,0.0515625,0.9402777777777778,0.09375,0.11944444444444445
9706-2021_03_20_081920.jpg,lorry_truck,24,155,640,31,360,119,2,179,150,LTAdatasets/9706/annotate/9706-2021_03_20_081920.jpg,167.0,134.5,0.2609375,0.3736111111111111,0.0375,0.08611111111111111
9706-2021_03_20_081920.jpg,lorry_truck,26,366,640,31,360,111,2,392,142,LTAdatasets/9706/annotate/9706-2021_03_20_081920.jpg,379.0,126.5,0.5921875,0.35138888888888886,0.040625,0.08611111111111111
9706-2021_03_20_081920.jpg,van,40,378,640,59,360,198,3,418,257,LTAdatasets/9706/annotate/9706-2021_03_20_081920.jpg,398.0,227.5,0.621875,0.6319444444444444,0.0625,0.1638888888888889
9706-2021_03_20_081920.jpg,bike,14,324,640,17,360,92,4,338,109,LTAdatasets/9706/annotate/9706-2021_03_20_081920.jpg,331.0,100.5,0.5171875,0.2791666666666667,0.021875,0.04722222222222222
9706-2021_03_20_081920.jpg,car,13,318,640,15,360,75,1,331,90,LTAdatasets/9706/annotate/9706-2021_03_20_081920.jpg,324.5,82.5,0.50703125,0.22916666666666666,0.0203125,0.041666666666666664
9706-2021_03_20_081920.jpg,car,10,288,640,10,360,63,1,298,73,LTAdatasets/9706/annotate/9706-2021_03_20_081920.jpg,293.0,68.0,0.4578125,0.18888888888888888,0.015625,0.027777777777777776
9706-2021_03_20_081920.jpg,car,8,289,640,8,360,45,1,297,53,LTAdatasets/9706/annotate/9706-2021_03_20_081920.jpg,293.0,49.0,0.4578125,0.1361111111111111,0.0125,0.022222222222222223
9706-2021_03_20_081920.jpg,car,14,198,640,21,360,119,1,212,140,LTAdatasets/9706/annotate/9706-2021_03_20_081920.jpg,205.0,129.5,0.3203125,0.3597222222222222,0.021875,0.058333333333333334
9706-2021_03_20_081920.jpg,car,33,111,640,36,360,211,1,144,247,LTAdatasets/9706/annotate/9706-2021_03_20_081920.jpg,127.5,229.0,0.19921875,0.6361111111111111,0.0515625,0.1
9706-2021_03_20_081920.jpg,lorry_truck,11,214,640,11,360,38,2,225,49,LTAdatasets/9706/annotate/9706-2021_03_20_081920.jpg,219.5,43.5,0.34296875,0.12083333333333333,0.0171875,0.030555555555555555
9706-2021_03_20_081920.jpg,bike,8,236,640,11,360,35,4,244,46,LTAdatasets/9706/annotate/9706-2021_03_20_081920.jpg,240.0,40.5,0.375,0.1125,0.0125,0.030555555555555555
9706-2021_03_20_181251.jpg,van,25,354,640,34,360,114,3,379,148,LTAdatasets/9706/annotate/9706-2021_03_20_181251.jpg,366.5,131.0,0.57265625,0.3638888888888889,0.0390625,0.09444444444444444
9706-2021_03_20_181251.jpg,car,19,306,640,23,360,119,1,325,142,LTAdatasets/9706/annotate/9706-2021_03_20_181251.jpg,315.5,130.5,0.49296875,0.3625,0.0296875,0.06388888888888888
9706-2021_03_20_181251.jpg,lorry_truck,23,128,640,42,360,159,2,151,201,LTAdatasets/9706/annotate/9706-2021_03_20_181251.jpg,139.5,180.0,0.21796875,0.5,0.0359375,0.11666666666666667
9706-2021_03_20_181251.jpg,lorry_truck,22,191,640,20,360,116,2,213,136,LTAdatasets/9706/annotate/9706-2021_03_20_181251.jpg,202.0,126.0,0.315625,0.35,0.034375,0.05555555555555555
9706-2021_03_20_181251.jpg,lorry_truck,19,196,640,23,360,63,2,215,86,LTAdatasets/9706/annotate/9706-2021_03_20_181251.jpg,205.5,74.5,0.32109375,0.20694444444444443,0.0296875,0.06388888888888888
9706-2021_03_20_181251.jpg,lorry_truck,12,320,640,15,360,57,2,332,72,LTAdatasets/9706/annotate/9706-2021_03_20_181251.jpg,326.0,64.5,0.509375,0.17916666666666667,0.01875,0.041666666666666664
9706-2021_03_20_181251.jpg,lorry_truck,14,222,640,17,360,61,2,236,78,LTAdatasets/9706/annotate/9706-2021_03_20_181251.jpg,229.0,69.5,0.3578125,0.19305555555555556,0.021875,0.04722222222222222
9706-2021_03_20_181251.jpg,car,10,238,640,5,360,48,1,248,53,LTAdatasets/9706/annotate/9706-2021_03_20_181251.jpg,243.0,50.5,0.3796875,0.14027777777777778,0.015625,0.013888888888888888
9706-2021_03_20_181251.jpg,car,12,209,640,5,360,52,1,221,57,LTAdatasets/9706/annotate/9706-2021_03_20_181251.jpg,215.0,54.5,0.3359375,0.15138888888888888,0.01875,0.013888888888888888
9706-2021_03_20_181251.jpg,car,9,225,640,8,360,47,1,234,55,LTAdatasets/9706/annotate/9706-2021_03_20_181251.jpg,229.5,51.0,0.35859375,0.14166666666666666,0.0140625,0.022222222222222223
9706-2021_03_20_181251.jpg,bike,7,189,640,15,360,88,4,196,103,LTAdatasets/9706/annotate/9706-2021_03_20_181251.jpg,192.5,95.5,0.30078125,0.2652777777777778,0.0109375,0.041666666666666664
9706-2021_03_20_181251.jpg,bike,9,321,640,10,360,77,4,330,87,LTAdatasets/9706/annotate/9706-2021_03_20_181251.jpg,325.5,82.0,0.50859375,0.22777777777777777,0.0140625,0.027777777777777776
9706-2021_03_20_093724.jpg,lorry_truck,44,119,640,58,360,130,2,163,188,LTAdatasets/9706/annotate/9706-2021_03_20_093724.jpg,141.0,159.0,0.2203125,0.44166666666666665,0.06875,0.16111111111111112
9706-2021_03_20_093724.jpg,lorry_truck,18,198,640,28,360,56,2,216,84,LTAdatasets/9706/annotate/9706-2021_03_20_093724.jpg,207.0,70.0,0.3234375,0.19444444444444445,0.028125,0.07777777777777778
9706-2021_03_20_093724.jpg,lorry_truck,10,212,640,13,360,31,2,222,44,LTAdatasets/9706/annotate/9706-2021_03_20_093724.jpg,217.0,37.5,0.3390625,0.10416666666666667,0.015625,0.03611111111111111
9706-2021_03_20_093724.jpg,car,17,300,640,17,360,102,1,317,119,LTAdatasets/9706/annotate/9706-2021_03_20_093724.jpg,308.5,110.5,0.48203125,0.30694444444444446,0.0265625,0.04722222222222222
9706-2021_03_20_093724.jpg,car,15,288,640,14,360,66,1,303,80,LTAdatasets/9706/annotate/9706-2021_03_20_093724.jpg,295.5,73.0,0.46171875,0.20277777777777778,0.0234375,0.03888888888888889
9706-2021_03_20_093724.jpg,car,11,298,640,11,360,52,1,309,63,LTAdatasets/9706/annotate/9706-2021_03_20_093724.jpg,303.5,57.5,0.47421875,0.1597222222222222,0.0171875,0.030555555555555555
9706-2021_03_20_093724.jpg,car,11,288,640,12,360,43,1,299,55,LTAdatasets/9706/annotate/9706-2021_03_20_093724.jpg,293.5,49.0,0.45859375,0.1361111111111111,0.0171875,0.03333333333333333
9706-2021_03_20_093724.jpg,car,44,154,640,43,360,317,1,198,360,LTAdatasets/9706/annotate/9706-2021_03_20_093724.jpg,176.0,338.5,0.275,0.9402777777777778,0.06875,0.11944444444444445
9706-2021_03_20_093724.jpg,bike,8,223,640,10,360,60,4,231,70,LTAdatasets/9706/annotate/9706-2021_03_20_093724.jpg,227.0,65.0,0.3546875,0.18055555555555555,0.0125,0.027777777777777776
9706-2021_03_20_201917.jpg,bike,15,198,640,19,360,105,4,213,124,LTAdatasets/9706/annotate/9706-2021_03_20_201917.jpg,205.5,114.5,0.32109375,0.31805555555555554,0.0234375,0.05277777777777778
9706-2021_03_20_201917.jpg,bike,7,325,640,12,360,58,4,332,70,LTAdatasets/9706/annotate/9706-2021_03_20_201917.jpg,328.5,64.0,0.51328125,0.17777777777777778,0.0109375,0.03333333333333333
9706-2021_03_20_201917.jpg,car,11,286,640,11,360,59,1,297,70,LTAdatasets/9706/annotate/9706-2021_03_20_201917.jpg,291.5,64.5,0.45546875,0.17916666666666667,0.0171875,0.030555555555555555
9706-2021_03_20_201917.jpg,car,12,290,640,13,360,45,1,302,58,LTAdatasets/9706/annotate/9706-2021_03_20_201917.jpg,296.0,51.5,0.4625,0.14305555555555555,0.01875,0.03611111111111111
9706-2021_03_20_201917.jpg,car,10,310,640,10,360,48,1,320,58,LTAdatasets/9706/annotate/9706-2021_03_20_201917.jpg,315.0,53.0,0.4921875,0.14722222222222223,0.015625,0.027777777777777776
9706-2021_03_20_201917.jpg,lorry_truck,82,506,640,50,360,310,2,588,360,LTAdatasets/9706/annotate/9706-2021_03_20_201917.jpg,547.0,335.0,0.8546875,0.9305555555555556,0.128125,0.1388888888888889
9706-2021_03_20_194916.jpg,lorry_truck,102,466,640,104,360,256,2,568,360,LTAdatasets/9706/annotate/9706-2021_03_20_194916.jpg,517.0,308.0,0.8078125,0.8555555555555555,0.159375,0.28888888888888886
9706-2021_03_20_194916.jpg,lorry_truck,44,99,640,58,360,161,2,143,219,LTAdatasets/9706/annotate/9706-2021_03_20_194916.jpg,121.0,190.0,0.1890625,0.5277777777777778,0.06875,0.16111111111111112
9706-2021_03_20_194916.jpg,lorry_truck,31,165,640,39,360,98,2,196,137,LTAdatasets/9706/annotate/9706-2021_03_20_194916.jpg,180.5,117.5,0.28203125,0.3263888888888889,0.0484375,0.10833333333333334
9706-2021_03_20_194916.jpg,lorry_truck,19,196,640,36,360,66,2,215,102,LTAdatasets/9706/annotate/9706-2021_03_20_194916.jpg,205.5,84.0,0.32109375,0.23333333333333334,0.0296875,0.1
9706-2021_03_20_194916.jpg,car,29,346,640,34,360,142,1,375,176,LTAdatasets/9706/annotate/9706-2021_03_20_194916.jpg,360.5,159.0,0.56328125,0.44166666666666665,0.0453125,0.09444444444444444
9706-2021_03_20_194916.jpg,car,12,299,640,10,360,52,1,311,62,LTAdatasets/9706/annotate/9706-2021_03_20_194916.jpg,305.0,57.0,0.4765625,0.15833333333333333,0.01875,0.027777777777777776
9706-2021_03_20_194916.jpg,car,11,217,640,10,360,41,1,228,51,LTAdatasets/9706/annotate/9706-2021_03_20_194916.jpg,222.5,46.0,0.34765625,0.12777777777777777,0.0171875,0.027777777777777776
9706-2021_03_20_194916.jpg,car,12,234,640,7,360,39,1,246,46,LTAdatasets/9706/annotate/9706-2021_03_20_194916.jpg,240.0,42.5,0.375,0.11805555555555555,0.01875,0.019444444444444445
9706-2021_03_20_081539.jpg,lorry_truck,55,426,640,55,360,186,2,481,241,LTAdatasets/9706/annotate/9706-2021_03_20_081539.jpg,453.5,213.5,0.70859375,0.5930555555555556,0.0859375,0.1527777777777778
9706-2021_03_20_081539.jpg,lorry_truck,56,14,640,68,360,290,2,70,358,LTAdatasets/9706/annotate/9706-2021_03_20_081539.jpg,42.0,324.0,0.065625,0.9,0.0875,0.18888888888888888
9706-2021_03_20_081539.jpg,lorry_truck,57,89,640,54,360,306,2,146,360,LTAdatasets/9706/annotate/9706-2021_03_20_081539.jpg,117.5,333.0,0.18359375,0.925,0.0890625,0.15
9706-2021_03_20_081539.jpg,lorry_truck,15,194,640,19,360,76,2,209,95,LTAdatasets/9706/annotate/9706-2021_03_20_081539.jpg,201.5,85.5,0.31484375,0.2375,0.0234375,0.05277777777777778
9706-2021_03_20_081539.jpg,van,14,299,640,11,360,50,3,313,61,LTAdatasets/9706/annotate/9706-2021_03_20_081539.jpg,306.0,55.5,0.478125,0.15416666666666667,0.021875,0.030555555555555555
9706-2021_03_20_081539.jpg,bike,17,199,640,24,360,110,4,216,134,LTAdatasets/9706/annotate/9706-2021_03_20_081539.jpg,207.5,122.0,0.32421875,0.3388888888888889,0.0265625,0.06666666666666667
9706-2021_03_20_081539.jpg,bike,15,162,640,29,360,277,4,177,306,LTAdatasets/9706/annotate/9706-2021_03_20_081539.jpg,169.5,291.5,0.26484375,0.8097222222222222,0.0234375,0.08055555555555556
9706-2021_03_20_081539.jpg,car,21,333,640,20,360,108,1,354,128,LTAdatasets/9706/annotate/9706-2021_03_20_081539.jpg,343.5,118.0,0.53671875,0.3277777777777778,0.0328125,0.05555555555555555
9706-2021_03_20_081539.jpg,car,10,318,640,13,360,76,1,328,89,LTAdatasets/9706/annotate/9706-2021_03_20_081539.jpg,323.0,82.5,0.5046875,0.22916666666666666,0.015625,0.03611111111111111
9706-2021_03_20_081539.jpg,car,12,285,640,12,360,57,1,297,69,LTAdatasets/9706/annotate/9706-2021_03_20_081539.jpg,291.0,63.0,0.4546875,0.175,0.01875,0.03333333333333333
9706-2021_03_20_081539.jpg,lorry_truck,13,208,640,15,360,45,2,221,60,LTAdatasets/9706/annotate/9706-2021_03_20_081539.jpg,214.5,52.5,0.33515625,0.14583333333333334,0.0203125,0.041666666666666664
9706-2021_03_20_081539.jpg,bike,7,223,640,9,360,46,4,230,55,LTAdatasets/9706/annotate/9706-2021_03_20_081539.jpg,226.5,50.5,0.35390625,0.14027777777777778,0.0109375,0.025
9706-2021_03_20_191614.jpg,car,38,335,640,55,360,242,1,373,297,LTAdatasets/9706/annotate/9706-2021_03_20_191614.jpg,354.0,269.5,0.553125,0.7486111111111111,0.059375,0.1527777777777778
9706-2021_03_20_191614.jpg,car,32,357,640,32,360,156,1,389,188,LTAdatasets/9706/annotate/9706-2021_03_20_191614.jpg,373.0,172.0,0.5828125,0.4777777777777778,0.05,0.08888888888888889
9706-2021_03_20_191614.jpg,car,31,172,640,74,360,286,1,203,360,LTAdatasets/9706/annotate/9706-2021_03_20_191614.jpg,187.5,323.0,0.29296875,0.8972222222222223,0.0484375,0.20555555555555555
9706-2021_03_20_191614.jpg,car,19,232,640,21,360,103,1,251,124,LTAdatasets/9706/annotate/9706-2021_03_20_191614.jpg,241.5,113.5,0.37734375,0.31527777777777777,0.0296875,0.058333333333333334
9706-2021_03_20_191614.jpg,car,15,199,640,17,360,96,1,214,113,LTAdatasets/9706/annotate/9706-2021_03_20_191614.jpg,206.5,104.5,0.32265625,0.2902777777777778,0.0234375,0.04722222222222222
9706-2021_03_20_191614.jpg,car,17,294,640,17,360,81,1,311,98,LTAdatasets/9706/annotate/9706-2021_03_20_191614.jpg,302.5,89.5,0.47265625,0.24861111111111112,0.0265625,0.04722222222222222
9706-2021_03_20_191614.jpg,car,10,300,640,12,360,53,1,310,65,LTAdatasets/9706/annotate/9706-2021_03_20_191614.jpg,305.0,59.0,0.4765625,0.1638888888888889,0.015625,0.03333333333333333
9706-2021_03_20_191614.jpg,car,12,287,640,6,360,43,1,299,49,LTAdatasets/9706/annotate/9706-2021_03_20_191614.jpg,293.0,46.0,0.4578125,0.12777777777777777,0.01875,0.016666666666666666
9706-2021_03_20_191614.jpg,car,10,284,640,10,360,54,1,294,64,LTAdatasets/9706/annotate/9706-2021_03_20_191614.jpg,289.0,59.0,0.4515625,0.1638888888888889,0.015625,0.027777777777777776
9706-2021_03_20_191614.jpg,lorry_truck,23,156,640,33,360,123,2,179,156,LTAdatasets/9706/annotate/9706-2021_03_20_191614.jpg,167.5,139.5,0.26171875,0.3875,0.0359375,0.09166666666666666
9706-2021_03_20_191614.jpg,car,9,224,640,12,360,41,1,233,53,LTAdatasets/9706/annotate/9706-2021_03_20_191614.jpg,228.5,47.0,0.35703125,0.13055555555555556,0.0140625,0.03333333333333333
9706-2021_03_20_191614.jpg,car,11,233,640,11,360,35,1,244,46,LTAdatasets/9706/annotate/9706-2021_03_20_191614.jpg,238.5,40.5,0.37265625,0.1125,0.0171875,0.030555555555555555
9706-2021_03_20_191614.jpg,lorry_truck,11,209,640,9,360,37,2,220,46,LTAdatasets/9706/annotate/9706-2021_03_20_191614.jpg,214.5,41.5,0.33515625,0.11527777777777778,0.0171875,0.025
9706-2021_03_20_084901.jpg,lorry_truck,42,386,640,60,360,203,2,428,263,LTAdatasets/9706/annotate/9706-2021_03_20_084901.jpg,407.0,233.0,0.6359375,0.6472222222222223,0.065625,0.16666666666666666
9706-2021_03_20_084901.jpg,lorry_truck,26,349,640,31,360,71,2,375,102,LTAdatasets/9706/annotate/9706-2021_03_20_084901.jpg,362.0,86.5,0.565625,0.24027777777777778,0.040625,0.08611111111111111
9706-2021_03_20_084901.jpg,car,18,297,640,22,360,89,1,315,111,LTAdatasets/9706/annotate/9706-2021_03_20_084901.jpg,306.0,100.0,0.478125,0.2777777777777778,0.028125,0.06111111111111111
9706-2021_03_20_084901.jpg,car,32,312,640,31,360,157,1,344,188,LTAdatasets/9706/annotate/9706-2021_03_20_084901.jpg,328.0,172.5,0.5125,0.4791666666666667,0.05,0.08611111111111111
9706-2021_03_20_084901.jpg,car,48,332,640,57,360,262,1,380,319,LTAdatasets/9706/annotate/9706-2021_03_20_084901.jpg,356.0,290.5,0.55625,0.8069444444444445,0.075,0.15833333333333333
9706-2021_03_20_084901.jpg,car,28,144,640,33,360,196,1,172,229,LTAdatasets/9706/annotate/9706-2021_03_20_084901.jpg,158.0,212.5,0.246875,0.5902777777777778,0.04375,0.09166666666666666
9706-2021_03_20_084901.jpg,van,16,178,640,23,360,95,3,194,118,LTAdatasets/9706/annotate/9706-2021_03_20_084901.jpg,186.0,106.5,0.290625,0.29583333333333334,0.025,0.06388888888888888
9706-2021_03_20_084901.jpg,car,11,204,640,13,360,75,1,215,88,LTAdatasets/9706/annotate/9706-2021_03_20_084901.jpg,209.5,81.5,0.32734375,0.2263888888888889,0.0171875,0.03611111111111111
9706-2021_03_20_084901.jpg,car,16,287,640,17,360,60,1,303,77,LTAdatasets/9706/annotate/9706-2021_03_20_084901.jpg,295.0,68.5,0.4609375,0.19027777777777777,0.025,0.04722222222222222
9706-2021_03_20_075138.jpg,car,39,387,640,45,360,227,1,426,272,LTAdatasets/9706/annotate/9706-2021_03_20_075138.jpg,406.5,249.5,0.63515625,0.6930555555555555,0.0609375,0.125
9706-2021_03_20_075138.jpg,car,30,312,640,42,360,164,1,342,206,LTAdatasets/9706/annotate/9706-2021_03_20_075138.jpg,327.0,185.0,0.5109375,0.5138888888888888,0.046875,0.11666666666666667
9706-2021_03_20_075138.jpg,car,25,165,640,25,360,157,1,190,182,LTAdatasets/9706/annotate/9706-2021_03_20_075138.jpg,177.5,169.5,0.27734375,0.4708333333333333,0.0390625,0.06944444444444445
9706-2021_03_20_075138.jpg,bike,12,228,640,22,360,91,4,240,113,LTAdatasets/9706/annotate/9706-2021_03_20_075138.jpg,234.0,102.0,0.365625,0.2833333333333333,0.01875,0.06111111111111111
9706-2021_03_20_075138.jpg,bike,15,317,640,24,360,103,4,332,127,LTAdatasets/9706/annotate/9706-2021_03_20_075138.jpg,324.5,115.0,0.50703125,0.3194444444444444,0.0234375,0.06666666666666667
9706-2021_03_20_075138.jpg,bike,8,295,640,10,360,47,4,303,57,LTAdatasets/9706/annotate/9706-2021_03_20_075138.jpg,299.0,52.0,0.4671875,0.14444444444444443,0.0125,0.027777777777777776
9706-2021_03_20_075138.jpg,car,17,287,640,14,360,64,1,304,78,LTAdatasets/9706/annotate/9706-2021_03_20_075138.jpg,295.5,71.0,0.46171875,0.19722222222222222,0.0265625,0.03888888888888889
9706-2021_03_20_075138.jpg,car,14,238,640,10,360,48,1,252,58,LTAdatasets/9706/annotate/9706-2021_03_20_075138.jpg,245.0,53.0,0.3828125,0.14722222222222223,0.021875,0.027777777777777776
9706-2021_03_20_075138.jpg,lorry_truck,14,223,640,17,360,40,2,237,57,LTAdatasets/9706/annotate/9706-2021_03_20_075138.jpg,230.0,48.5,0.359375,0.13472222222222222,0.021875,0.04722222222222222
9706-2021_03_20_075138.jpg,lorry_truck,11,212,640,15,360,43,2,223,58,LTAdatasets/9706/annotate/9706-2021_03_20_075138.jpg,217.5,50.5,0.33984375,0.14027777777777778,0.0171875,0.041666666666666664
9706-2021_03_20_075138.jpg,car,14,206,640,12,360,61,1,220,73,LTAdatasets/9706/annotate/9706-2021_03_20_075138.jpg,213.0,67.0,0.3328125,0.18611111111111112,0.021875,0.03333333333333333
9706-2021_03_20_075138.jpg,van,31,362,640,37,360,153,3,393,190,LTAdatasets/9706/annotate/9706-2021_03_20_075138.jpg,377.5,171.5,0.58984375,0.47638888888888886,0.0484375,0.10277777777777777
9706-2021_03_20_203658.jpg,lorry_truck,16,327,640,12,360,63,2,343,75,LTAdatasets/9706/annotate/9706-2021_03_20_203658.jpg,335.0,69.0,0.5234375,0.19166666666666668,0.025,0.03333333333333333
9706-2021_03_20_203658.jpg,car,19,231,640,20,360,87,1,250,107,LTAdatasets/9706/annotate/9706-2021_03_20_203658.jpg,240.5,97.0,0.37578125,0.26944444444444443,0.0296875,0.05555555555555555
9706-2021_03_20_203658.jpg,car,12,202,640,16,360,63,1,214,79,LTAdatasets/9706/annotate/9706-2021_03_20_203658.jpg,208.0,71.0,0.325,0.19722222222222222,0.01875,0.044444444444444446
9706-2021_03_20_203658.jpg,car,8,213,640,12,360,41,1,221,53,LTAdatasets/9706/annotate/9706-2021_03_20_203658.jpg,217.0,47.0,0.3390625,0.13055555555555556,0.0125,0.03333333333333333
9706-2021_03_20_203658.jpg,car,8,238,640,6,360,41,1,246,47,LTAdatasets/9706/annotate/9706-2021_03_20_203658.jpg,242.0,44.0,0.378125,0.12222222222222222,0.0125,0.016666666666666666
9706-2021_03_20_203658.jpg,car,11,224,640,11,360,36,1,235,47,LTAdatasets/9706/annotate/9706-2021_03_20_203658.jpg,229.5,41.5,0.35859375,0.11527777777777778,0.0171875,0.030555555555555555
9706-2021_03_20_203658.jpg,car,8,291,640,9,360,46,1,299,55,LTAdatasets/9706/annotate/9706-2021_03_20_203658.jpg,295.0,50.5,0.4609375,0.14027777777777778,0.0125,0.025
9706-2021_03_20_094024.jpg,car,17,306,640,26,360,109,1,323,135,LTAdatasets/9706/annotate/9706-2021_03_20_094024.jpg,314.5,122.0,0.49140625,0.3388888888888889,0.0265625,0.07222222222222222
9706-2021_03_20_094024.jpg,car,22,163,640,18,360,119,1,185,137,LTAdatasets/9706/annotate/9706-2021_03_20_094024.jpg,174.0,128.0,0.271875,0.35555555555555557,0.034375,0.05
9706-2021_03_20_094024.jpg,car,15,207,640,15,360,91,1,222,106,LTAdatasets/9706/annotate/9706-2021_03_20_094024.jpg,214.5,98.5,0.33515625,0.27361111111111114,0.0234375,0.041666666666666664
9706-2021_03_20_094024.jpg,car,11,237,640,15,360,82,1,248,97,LTAdatasets/9706/annotate/9706-2021_03_20_094024.jpg,242.5,89.5,0.37890625,0.24861111111111112,0.0171875,0.041666666666666664
9706-2021_03_20_094024.jpg,car,9,198,640,11,360,76,1,207,87,LTAdatasets/9706/annotate/9706-2021_03_20_094024.jpg,202.5,81.5,0.31640625,0.2263888888888889,0.0140625,0.030555555555555555
9706-2021_03_20_094024.jpg,car,12,242,640,10,360,64,1,254,74,LTAdatasets/9706/annotate/9706-2021_03_20_094024.jpg,248.0,69.0,0.3875,0.19166666666666668,0.01875,0.027777777777777776
9706-2021_03_20_094024.jpg,car,13,236,640,8,360,51,1,249,59,LTAdatasets/9706/annotate/9706-2021_03_20_094024.jpg,242.5,55.0,0.37890625,0.1527777777777778,0.0203125,0.022222222222222223
9706-2021_03_20_094024.jpg,car,11,221,640,6,360,57,1,232,63,LTAdatasets/9706/annotate/9706-2021_03_20_094024.jpg,226.5,60.0,0.35390625,0.16666666666666666,0.0171875,0.016666666666666666
9706-2021_03_20_094024.jpg,car,13,204,640,6,360,61,1,217,67,LTAdatasets/9706/annotate/9706-2021_03_20_094024.jpg,210.5,64.0,0.32890625,0.17777777777777778,0.0203125,0.016666666666666666
9706-2021_03_20_094024.jpg,lorry_truck,24,159,640,44,360,164,2,183,208,LTAdatasets/9706/annotate/9706-2021_03_20_094024.jpg,171.0,186.0,0.2671875,0.5166666666666667,0.0375,0.12222222222222222
9706-2021_03_20_094024.jpg,lorry_truck,31,348,640,33,360,143,2,379,176,LTAdatasets/9706/annotate/9706-2021_03_20_094024.jpg,363.5,159.5,0.56796875,0.44305555555555554,0.0484375,0.09166666666666666
9706-2021_03_20_094024.jpg,lorry_truck,24,332,640,29,360,62,2,356,91,LTAdatasets/9706/annotate/9706-2021_03_20_094024.jpg,344.0,76.5,0.5375,0.2125,0.0375,0.08055555555555556
9706-2021_03_20_094024.jpg,lorry_truck,23,321,640,16,360,86,2,344,102,LTAdatasets/9706/annotate/9706-2021_03_20_094024.jpg,332.5,94.0,0.51953125,0.2611111111111111,0.0359375,0.044444444444444446
9706-2021_03_20_094024.jpg,lorry_truck,17,310,640,20,360,42,2,327,62,LTAdatasets/9706/annotate/9706-2021_03_20_094024.jpg,318.5,52.0,0.49765625,0.14444444444444443,0.0265625,0.05555555555555555
9706-2021_03_20_094024.jpg,van,14,298,640,10,360,57,3,312,67,LTAdatasets/9706/annotate/9706-2021_03_20_094024.jpg,305.0,62.0,0.4765625,0.17222222222222222,0.021875,0.027777777777777776
9706-2021_03_20_094024.jpg,van,11,223,640,10,360,63,3,234,73,LTAdatasets/9706/annotate/9706-2021_03_20_094024.jpg,228.5,68.0,0.35703125,0.18888888888888888,0.0171875,0.027777777777777776
9706-2021_03_20_094024.jpg,lorry_truck,14,207,640,19,360,37,2,221,56,LTAdatasets/9706/annotate/9706-2021_03_20_094024.jpg,214.0,46.5,0.334375,0.12916666666666668,0.021875,0.05277777777777778
9706-2021_03_20_094024.jpg,car,7,225,640,7,360,42,1,232,49,LTAdatasets/9706/annotate/9706-2021_03_20_094024.jpg,228.5,45.5,0.35703125,0.12638888888888888,0.0109375,0.019444444444444445
9706-2021_03_20_074318.jpg,lorry_truck,87,456,640,95,360,222,2,543,317,LTAdatasets/9706/annotate/9706-2021_03_20_074318.jpg,499.5,269.5,0.78046875,0.7486111111111111,0.1359375,0.2638888888888889
9706-2021_03_20_074318.jpg,lorry_truck,17,319,640,18,360,50,2,336,68,LTAdatasets/9706/annotate/9706-2021_03_20_074318.jpg,327.5,59.0,0.51171875,0.1638888888888889,0.0265625,0.05
9706-2021_03_20_074318.jpg,bike,10,336,640,19,360,121,4,346,140,LTAdatasets/9706/annotate/9706-2021_03_20_074318.jpg,341.0,130.5,0.5328125,0.3625,0.015625,0.05277777777777778
9706-2021_03_20_074318.jpg,van,19,230,640,21,360,105,3,249,126,LTAdatasets/9706/annotate/9706-2021_03_20_074318.jpg,239.5,115.5,0.37421875,0.32083333333333336,0.0296875,0.058333333333333334
9706-2021_03_20_074318.jpg,car,17,197,640,16,360,120,1,214,136,LTAdatasets/9706/annotate/9706-2021_03_20_074318.jpg,205.5,128.0,0.32109375,0.35555555555555557,0.0265625,0.044444444444444446
9706-2021_03_20_074318.jpg,car,15,303,640,12,360,62,1,318,74,LTAdatasets/9706/annotate/9706-2021_03_20_074318.jpg,310.5,68.0,0.48515625,0.18888888888888888,0.0234375,0.03333333333333333
9706-2021_03_20_074318.jpg,car,14,286,640,6,360,45,1,300,51,LTAdatasets/9706/annotate/9706-2021_03_20_074318.jpg,293.0,48.0,0.4578125,0.13333333333333333,0.021875,0.016666666666666666
9706-2021_03_20_074318.jpg,car,8,224,640,7,360,58,1,232,65,LTAdatasets/9706/annotate/9706-2021_03_20_074318.jpg,228.0,61.5,0.35625,0.17083333333333334,0.0125,0.019444444444444445
9706-2021_03_20_074318.jpg,car,15,237,640,10,360,46,1,252,56,LTAdatasets/9706/annotate/9706-2021_03_20_074318.jpg,244.5,51.0,0.38203125,0.14166666666666666,0.0234375,0.027777777777777776
9706-2021_03_20_074318.jpg,bus,49,126,640,54,360,129,5,175,183,LTAdatasets/9706/annotate/9706-2021_03_20_074318.jpg,150.5,156.0,0.23515625,0.43333333333333335,0.0765625,0.15
9706-2021_03_20_074318.jpg,car,10,213,640,8,360,36,1,223,44,LTAdatasets/9706/annotate/9706-2021_03_20_074318.jpg,218.0,40.0,0.340625,0.1111111111111111,0.015625,0.022222222222222223
9706-2021_03_20_092803.jpg,bike,22,406,640,39,360,237,4,428,276,LTAdatasets/9706/annotate/9706-2021_03_20_092803.jpg,417.0,256.5,0.6515625,0.7125,0.034375,0.10833333333333334
9706-2021_03_20_092803.jpg,car,47,343,640,49,360,311,1,390,360,LTAdatasets/9706/annotate/9706-2021_03_20_092803.jpg,366.5,335.5,0.57265625,0.9319444444444445,0.0734375,0.1361111111111111
9706-2021_03_20_092803.jpg,car,32,195,640,42,360,212,1,227,254,LTAdatasets/9706/annotate/9706-2021_03_20_092803.jpg,211.0,233.0,0.3296875,0.6472222222222223,0.05,0.11666666666666667
9706-2021_03_20_092803.jpg,car,29,314,640,33,360,157,1,343,190,LTAdatasets/9706/annotate/9706-2021_03_20_092803.jpg,328.5,173.5,0.51328125,0.48194444444444445,0.0453125,0.09166666666666666
9706-2021_03_20_092803.jpg,car,22,335,640,33,360,113,1,357,146,LTAdatasets/9706/annotate/9706-2021_03_20_092803.jpg,346.0,129.5,0.540625,0.3597222222222222,0.034375,0.09166666666666666
9706-2021_03_20_092803.jpg,car,22,298,640,18,360,106,1,320,124,LTAdatasets/9706/annotate/9706-2021_03_20_092803.jpg,309.0,115.0,0.4828125,0.3194444444444444,0.034375,0.05
9706-2021_03_20_092803.jpg,car,19,342,640,15,360,85,1,361,100,LTAdatasets/9706/annotate/9706-2021_03_20_092803.jpg,351.5,92.5,0.54921875,0.2569444444444444,0.0296875,0.041666666666666664
9706-2021_03_20_092803.jpg,car,16,172,640,17,360,103,1,188,120,LTAdatasets/9706/annotate/9706-2021_03_20_092803.jpg,180.0,111.5,0.28125,0.30972222222222223,0.025,0.04722222222222222
9706-2021_03_20_092803.jpg,car,17,318,640,16,360,83,1,335,99,LTAdatasets/9706/annotate/9706-2021_03_20_092803.jpg,326.5,91.0,0.51015625,0.25277777777777777,0.0265625,0.044444444444444446
9706-2021_03_20_092803.jpg,car,11,291,640,9,360,71,1,302,80,LTAdatasets/9706/annotate/9706-2021_03_20_092803.jpg,296.5,75.5,0.46328125,0.20972222222222223,0.0171875,0.025
9706-2021_03_20_092803.jpg,car,13,236,640,11,360,76,1,249,87,LTAdatasets/9706/annotate/9706-2021_03_20_092803.jpg,242.5,81.5,0.37890625,0.2263888888888889,0.0203125,0.030555555555555555
9706-2021_03_20_092803.jpg,lorry_truck,13,326,640,15,360,61,2,339,76,LTAdatasets/9706/annotate/9706-2021_03_20_092803.jpg,332.5,68.5,0.51953125,0.19027777777777777,0.0203125,0.041666666666666664
9706-2021_03_20_092803.jpg,lorry_truck,23,181,640,31,360,134,2,204,165,LTAdatasets/9706/annotate/9706-2021_03_20_092803.jpg,192.5,149.5,0.30078125,0.4152777777777778,0.0359375,0.08611111111111111
9706-2021_03_20_092803.jpg,lorry_truck,18,188,640,25,360,71,2,206,96,LTAdatasets/9706/annotate/9706-2021_03_20_092803.jpg,197.0,83.5,0.3078125,0.23194444444444445,0.028125,0.06944444444444445
9706-2021_03_20_092803.jpg,lorry_truck,15,201,640,17,360,63,2,216,80,LTAdatasets/9706/annotate/9706-2021_03_20_092803.jpg,208.5,71.5,0.32578125,0.1986111111111111,0.0234375,0.04722222222222222
9706-2021_03_20_092803.jpg,car,14,224,640,15,360,49,1,238,64,LTAdatasets/9706/annotate/9706-2021_03_20_092803.jpg,231.0,56.5,0.3609375,0.15694444444444444,0.021875,0.041666666666666664
9706-2021_03_20_092803.jpg,car,13,298,640,11,360,57,1,311,68,LTAdatasets/9706/annotate/9706-2021_03_20_092803.jpg,304.5,62.5,0.47578125,0.1736111111111111,0.0203125,0.030555555555555555
9706-2021_03_20_092803.jpg,van,36,111,640,34,360,165,3,147,199,LTAdatasets/9706/annotate/9706-2021_03_20_092803.jpg,129.0,182.0,0.2015625,0.5055555555555555,0.05625,0.09444444444444444
9706-2021_03_20_092803.jpg,van,34,409,640,36,360,173,3,443,209,LTAdatasets/9706/annotate/9706-2021_03_20_092803.jpg,426.0,191.0,0.665625,0.5305555555555556,0.053125,0.1
9706-2021_03_20_092803.jpg,bus,43,371,640,54,360,105,5,414,159,LTAdatasets/9706/annotate/9706-2021_03_20_092803.jpg,392.5,132.0,0.61328125,0.36666666666666664,0.0671875,0.15
9706-2021_03_20_092803.jpg,lorry_truck,10,208,640,14,360,44,2,218,58,LTAdatasets/9706/annotate/9706-2021_03_20_092803.jpg,213.0,51.0,0.3328125,0.14166666666666666,0.015625,0.03888888888888889
9706-2021_03_20_082220.jpg,lorry_truck,85,469,640,123,360,235,2,554,358,LTAdatasets/9706/annotate/9706-2021_03_20_082220.jpg,511.5,296.5,0.79921875,0.8236111111111111,0.1328125,0.3416666666666667
9706-2021_03_20_082220.jpg,lorry_truck,38,361,640,39,360,97,2,399,136,LTAdatasets/9706/annotate/9706-2021_03_20_082220.jpg,380.0,116.5,0.59375,0.3236111111111111,0.059375,0.10833333333333334
9706-2021_03_20_082220.jpg,lorry_truck,41,116,640,61,360,244,2,157,305,LTAdatasets/9706/annotate/9706-2021_03_20_082220.jpg,136.5,274.5,0.21328125,0.7625,0.0640625,0.16944444444444445
9706-2021_03_20_082220.jpg,lorry_truck,14,300,640,15,360,49,2,314,64,LTAdatasets/9706/annotate/9706-2021_03_20_082220.jpg,307.0,56.5,0.4796875,0.15694444444444444,0.021875,0.041666666666666664
9706-2021_03_20_082220.jpg,bike,12,312,640,13,360,77,4,324,90,LTAdatasets/9706/annotate/9706-2021_03_20_082220.jpg,318.0,83.5,0.496875,0.23194444444444445,0.01875,0.03611111111111111
9706-2021_03_20_082220.jpg,bike,12,322,640,12,360,63,4,334,75,LTAdatasets/9706/annotate/9706-2021_03_20_082220.jpg,328.0,69.0,0.5125,0.19166666666666668,0.01875,0.03333333333333333
9706-2021_03_20_082220.jpg,car,16,230,640,14,360,88,1,246,102,LTAdatasets/9706/annotate/9706-2021_03_20_082220.jpg,238.0,95.0,0.371875,0.2638888888888889,0.025,0.03888888888888889
9706-2021_03_20_082220.jpg,car,9,290,640,13,360,62,1,299,75,LTAdatasets/9706/annotate/9706-2021_03_20_082220.jpg,294.5,68.5,0.46015625,0.19027777777777777,0.0140625,0.03611111111111111
9706-2021_03_20_082220.jpg,car,12,240,640,5,360,55,1,252,60,LTAdatasets/9706/annotate/9706-2021_03_20_082220.jpg,246.0,57.5,0.384375,0.1597222222222222,0.01875,0.013888888888888888
9706-2021_03_20_082220.jpg,car,10,209,640,8,360,48,1,219,56,LTAdatasets/9706/annotate/9706-2021_03_20_082220.jpg,214.0,52.0,0.334375,0.14444444444444443,0.015625,0.022222222222222223
9706-2021_03_20_082220.jpg,car,9,224,640,6,360,39,1,233,45,LTAdatasets/9706/annotate/9706-2021_03_20_082220.jpg,228.5,42.0,0.35703125,0.11666666666666667,0.0140625,0.016666666666666666
9706-2021_03_20_180410.jpg,car,44,338,640,61,360,245,1,382,306,LTAdatasets/9706/annotate/9706-2021_03_20_180410.jpg,360.0,275.5,0.5625,0.7652777777777777,0.06875,0.16944444444444445
9706-2021_03_20_180410.jpg,car,18,306,640,20,360,114,1,324,134,LTAdatasets/9706/annotate/9706-2021_03_20_180410.jpg,315.0,124.0,0.4921875,0.34444444444444444,0.028125,0.05555555555555555
9706-2021_03_20_180410.jpg,van,21,342,640,26,360,123,3,363,149,LTAdatasets/9706/annotate/9706-2021_03_20_180410.jpg,352.5,136.0,0.55078125,0.37777777777777777,0.0328125,0.07222222222222222
9706-2021_03_20_180410.jpg,bus,15,313,640,20,360,44,5,328,64,LTAdatasets/9706/annotate/9706-2021_03_20_180410.jpg,320.5,54.0,0.50078125,0.15,0.0234375,0.05555555555555555
9706-2021_03_20_180410.jpg,car,10,301,640,7,360,58,1,311,65,LTAdatasets/9706/annotate/9706-2021_03_20_180410.jpg,306.0,61.5,0.478125,0.17083333333333334,0.015625,0.019444444444444445
9706-2021_03_20_180410.jpg,car,14,285,640,10,360,58,1,299,68,LTAdatasets/9706/annotate/9706-2021_03_20_180410.jpg,292.0,63.0,0.45625,0.175,0.021875,0.027777777777777776
9706-2021_03_20_180410.jpg,car,28,94,640,30,360,203,1,122,233,LTAdatasets/9706/annotate/9706-2021_03_20_180410.jpg,108.0,218.0,0.16875,0.6055555555555555,0.04375,0.08333333333333333
9706-2021_03_20_180410.jpg,car,10,218,640,11,360,81,1,228,92,LTAdatasets/9706/annotate/9706-2021_03_20_180410.jpg,223.0,86.5,0.3484375,0.24027777777777778,0.015625,0.030555555555555555
9706-2021_03_20_180410.jpg,car,15,208,640,13,360,94,1,223,107,LTAdatasets/9706/annotate/9706-2021_03_20_180410.jpg,215.5,100.5,0.33671875,0.2791666666666667,0.0234375,0.03611111111111111
9706-2021_03_20_180410.jpg,lorry_truck,15,198,640,16,360,73,2,213,89,LTAdatasets/9706/annotate/9706-2021_03_20_180410.jpg,205.5,81.0,0.32109375,0.225,0.0234375,0.044444444444444446
9706-2021_03_20_180410.jpg,lorry_truck,25,153,640,20,360,127,2,178,147,LTAdatasets/9706/annotate/9706-2021_03_20_180410.jpg,165.5,137.0,0.25859375,0.38055555555555554,0.0390625,0.05555555555555555
9706-2021_03_20_180410.jpg,lorry_truck,21,189,640,29,360,114,2,210,143,LTAdatasets/9706/annotate/9706-2021_03_20_180410.jpg,199.5,128.5,0.31171875,0.35694444444444445,0.0328125,0.08055555555555556
9706-2021_03_20_180410.jpg,car,10,226,640,11,360,61,1,236,72,LTAdatasets/9706/annotate/9706-2021_03_20_180410.jpg,231.0,66.5,0.3609375,0.18472222222222223,0.015625,0.030555555555555555
9706-2021_03_20_180410.jpg,car,10,240,640,14,360,56,1,250,70,LTAdatasets/9706/annotate/9706-2021_03_20_180410.jpg,245.0,63.0,0.3828125,0.175,0.015625,0.03888888888888889
9706-2021_03_20_180410.jpg,car,16,229,640,15,360,118,1,245,133,LTAdatasets/9706/annotate/9706-2021_03_20_180410.jpg,237.0,125.5,0.3703125,0.3486111111111111,0.025,0.041666666666666664
9706-2021_03_20_180410.jpg,lorry_truck,12,211,640,10,360,46,2,223,56,LTAdatasets/9706/annotate/9706-2021_03_20_180410.jpg,217.0,51.0,0.3390625,0.14166666666666666,0.01875,0.027777777777777776
9706-2021_03_20_180410.jpg,car,8,226,640,9,360,41,1,234,50,LTAdatasets/9706/annotate/9706-2021_03_20_180410.jpg,230.0,45.5,0.359375,0.12638888888888888,0.0125,0.025
9706-2021_03_20_180410.jpg,lorry_truck,10,222,640,9,360,52,2,232,61,LTAdatasets/9706/annotate/9706-2021_03_20_180410.jpg,227.0,56.5,0.3546875,0.15694444444444444,0.015625,0.025
9706-2021_03_20_183112.jpg,car,23,203,640,43,360,214,1,226,257,LTAdatasets/9706/annotate/9706-2021_03_20_183112.jpg,214.5,235.5,0.33515625,0.6541666666666667,0.0359375,0.11944444444444445
9706-2021_03_20_183112.jpg,car,37,379,640,47,360,210,1,416,257,LTAdatasets/9706/annotate/9706-2021_03_20_183112.jpg,397.5,233.5,0.62109375,0.6486111111111111,0.0578125,0.13055555555555556
9706-2021_03_20_183112.jpg,car,18,349,640,26,360,127,1,367,153,LTAdatasets/9706/annotate/9706-2021_03_20_183112.jpg,358.0,140.0,0.559375,0.3888888888888889,0.028125,0.07222222222222222
9706-2021_03_20_183112.jpg,car,11,310,640,15,360,63,1,321,78,LTAdatasets/9706/annotate/9706-2021_03_20_183112.jpg,315.5,70.5,0.49296875,0.19583333333333333,0.0171875,0.041666666666666664
9706-2021_03_20_183112.jpg,car,14,286,640,10,360,64,1,300,74,LTAdatasets/9706/annotate/9706-2021_03_20_183112.jpg,293.0,69.0,0.4578125,0.19166666666666668,0.021875,0.027777777777777776
9706-2021_03_20_183112.jpg,car,26,307,640,32,360,141,1,333,173,LTAdatasets/9706/annotate/9706-2021_03_20_183112.jpg,320.0,157.0,0.5,0.4361111111111111,0.040625,0.08888888888888889
9706-2021_03_20_183112.jpg,car,19,179,640,22,360,157,1,198,179,LTAdatasets/9706/annotate/9706-2021_03_20_183112.jpg,188.5,168.0,0.29453125,0.4666666666666667,0.0296875,0.06111111111111111
9706-2021_03_20_183112.jpg,car,14,243,640,13,360,68,1,257,81,LTAdatasets/9706/annotate/9706-2021_03_20_183112.jpg,250.0,74.5,0.390625,0.20694444444444443,0.021875,0.03611111111111111
9706-2021_03_20_183112.jpg,car,12,239,640,12,360,55,1,251,67,LTAdatasets/9706/annotate/9706-2021_03_20_183112.jpg,245.0,61.0,0.3828125,0.16944444444444445,0.01875,0.03333333333333333
9706-2021_03_20_183112.jpg,lorry_truck,14,217,640,15,360,74,2,231,89,LTAdatasets/9706/annotate/9706-2021_03_20_183112.jpg,224.0,81.5,0.35,0.2263888888888889,0.021875,0.041666666666666664
9706-2021_03_20_183112.jpg,lorry_truck,18,202,640,24,360,95,2,220,119,LTAdatasets/9706/annotate/9706-2021_03_20_183112.jpg,211.0,107.0,0.3296875,0.2972222222222222,0.028125,0.06666666666666667
9706-2021_03_20_183112.jpg,lorry_truck,19,170,640,21,360,105,2,189,126,LTAdatasets/9706/annotate/9706-2021_03_20_183112.jpg,179.5,115.5,0.28046875,0.32083333333333336,0.0296875,0.058333333333333334
9706-2021_03_20_183112.jpg,lorry_truck,41,82,640,49,360,190,2,123,239,LTAdatasets/9706/annotate/9706-2021_03_20_183112.jpg,102.5,214.5,0.16015625,0.5958333333333333,0.0640625,0.1361111111111111
9706-2021_03_20_183112.jpg,lorry_truck,58,108,640,77,360,220,2,166,297,LTAdatasets/9706/annotate/9706-2021_03_20_183112.jpg,137.0,258.5,0.2140625,0.7180555555555556,0.090625,0.21388888888888888
9706-2021_03_20_183112.jpg,lorry_truck,89,450,640,100,360,228,2,539,328,LTAdatasets/9706/annotate/9706-2021_03_20_183112.jpg,494.5,278.0,0.77265625,0.7722222222222223,0.1390625,0.2777777777777778
9706-2021_03_20_183112.jpg,lorry_truck,22,362,640,23,360,92,2,384,115,LTAdatasets/9706/annotate/9706-2021_03_20_183112.jpg,373.0,103.5,0.5828125,0.2875,0.034375,0.06388888888888888
9706-2021_03_20_183112.jpg,lorry_truck,43,376,640,39,360,121,2,419,160,LTAdatasets/9706/annotate/9706-2021_03_20_183112.jpg,397.5,140.5,0.62109375,0.3902777777777778,0.0671875,0.10833333333333334
9706-2021_03_20_183112.jpg,lorry_truck,10,208,640,10,360,55,2,218,65,LTAdatasets/9706/annotate/9706-2021_03_20_183112.jpg,213.0,60.0,0.3328125,0.16666666666666666,0.015625,0.027777777777777776
9706-2021_03_20_183112.jpg,bus,11,212,640,21,360,30,5,223,51,LTAdatasets/9706/annotate/9706-2021_03_20_183112.jpg,217.5,40.5,0.33984375,0.1125,0.0171875,0.058333333333333334
9706-2021_03_20_183112.jpg,car,8,228,640,10,360,50,1,236,60,LTAdatasets/9706/annotate/9706-2021_03_20_183112.jpg,232.0,55.0,0.3625,0.1527777777777778,0.0125,0.027777777777777776
9706-2021_03_20_083120.jpg,car,51,337,640,75,360,273,1,388,348,LTAdatasets/9706/annotate/9706-2021_03_20_083120.jpg,362.5,310.5,0.56640625,0.8625,0.0796875,0.20833333333333334
9706-2021_03_20_083120.jpg,car,19,198,640,18,360,117,1,217,135,LTAdatasets/9706/annotate/9706-2021_03_20_083120.jpg,207.5,126.0,0.32421875,0.35,0.0296875,0.05
9706-2021_03_20_083120.jpg,car,15,306,640,14,360,103,1,321,117,LTAdatasets/9706/annotate/9706-2021_03_20_083120.jpg,313.5,110.0,0.48984375,0.3055555555555556,0.0234375,0.03888888888888889
9706-2021_03_20_083120.jpg,van,14,325,640,16,360,87,3,339,103,LTAdatasets/9706/annotate/9706-2021_03_20_083120.jpg,332.0,95.0,0.51875,0.2638888888888889,0.021875,0.044444444444444446
9706-2021_03_20_083120.jpg,van,24,339,640,28,360,123,3,363,151,LTAdatasets/9706/annotate/9706-2021_03_20_083120.jpg,351.0,137.0,0.5484375,0.38055555555555554,0.0375,0.07777777777777778
9706-2021_03_20_083120.jpg,van,20,145,640,27,360,133,3,165,160,LTAdatasets/9706/annotate/9706-2021_03_20_083120.jpg,155.0,146.5,0.2421875,0.40694444444444444,0.03125,0.075
9706-2021_03_20_083120.jpg,lorry_truck,18,205,640,21,360,48,2,223,69,LTAdatasets/9706/annotate/9706-2021_03_20_083120.jpg,214.0,58.5,0.334375,0.1625,0.028125,0.058333333333333334
9706-2021_03_20_083120.jpg,lorry_truck,29,323,640,21,360,64,2,352,85,LTAdatasets/9706/annotate/9706-2021_03_20_083120.jpg,337.5,74.5,0.52734375,0.20694444444444443,0.0453125,0.058333333333333334
9706-2021_03_20_083120.jpg,lorry_truck,45,371,640,31,360,123,2,416,154,LTAdatasets/9706/annotate/9706-2021_03_20_083120.jpg,393.5,138.5,0.61484375,0.38472222222222224,0.0703125,0.08611111111111111
9706-2021_03_20_083120.jpg,lorry_truck,27,172,640,29,360,81,2,199,110,LTAdatasets/9706/annotate/9706-2021_03_20_083120.jpg,185.5,95.5,0.28984375,0.2652777777777778,0.0421875,0.08055555555555556
9706-2021_03_20_083120.jpg,lorry_truck,56,402,640,74,360,257,2,458,331,LTAdatasets/9706/annotate/9706-2021_03_20_083120.jpg,430.0,294.0,0.671875,0.8166666666666667,0.0875,0.20555555555555555
9706-2021_03_20_083120.jpg,lorry_truck,15,317,640,12,360,53,2,332,65,LTAdatasets/9706/annotate/9706-2021_03_20_083120.jpg,324.5,59.0,0.50703125,0.1638888888888889,0.0234375,0.03333333333333333
9706-2021_03_20_083120.jpg,bike,8,241,640,15,360,52,4,249,67,LTAdatasets/9706/annotate/9706-2021_03_20_083120.jpg,245.0,59.5,0.3828125,0.16527777777777777,0.0125,0.041666666666666664
9706-2021_03_20_083120.jpg,car,14,300,640,15,360,52,1,314,67,LTAdatasets/9706/annotate/9706-2021_03_20_083120.jpg,307.0,59.5,0.4796875,0.16527777777777777,0.021875,0.041666666666666664
9706-2021_03_20_083120.jpg,car,11,285,640,17,360,49,1,296,66,LTAdatasets/9706/annotate/9706-2021_03_20_083120.jpg,290.5,57.5,0.45390625,0.1597222222222222,0.0171875,0.04722222222222222
9706-2021_03_20_091623.jpg,bike,7,337,640,16,360,81,4,344,97,LTAdatasets/9706/annotate/9706-2021_03_20_091623.jpg,340.5,89.0,0.53203125,0.24722222222222223,0.0109375,0.044444444444444446
9706-2021_03_20_091623.jpg,car,11,215,640,14,360,79,1,226,93,LTAdatasets/9706/annotate/9706-2021_03_20_091623.jpg,220.5,86.0,0.34453125,0.2388888888888889,0.0171875,0.03888888888888889
9706-2021_03_20_091623.jpg,car,15,223,640,11,360,50,1,238,61,LTAdatasets/9706/annotate/9706-2021_03_20_091623.jpg,230.5,55.5,0.36015625,0.15416666666666667,0.0234375,0.030555555555555555
9706-2021_03_20_091623.jpg,car,11,209,640,7,360,51,1,220,58,LTAdatasets/9706/annotate/9706-2021_03_20_091623.jpg,214.5,54.5,0.33515625,0.15138888888888888,0.0171875,0.019444444444444445
9706-2021_03_20_091623.jpg,car,18,298,640,17,360,104,1,316,121,LTAdatasets/9706/annotate/9706-2021_03_20_091623.jpg,307.0,112.5,0.4796875,0.3125,0.028125,0.04722222222222222
9706-2021_03_20_091623.jpg,car,25,334,640,19,360,124,1,359,143,LTAdatasets/9706/annotate/9706-2021_03_20_091623.jpg,346.5,133.5,0.54140625,0.37083333333333335,0.0390625,0.05277777777777778
9706-2021_03_20_091623.jpg,van,29,382,640,35,360,134,3,411,169,LTAdatasets/9706/annotate/9706-2021_03_20_091623.jpg,396.5,151.5,0.61953125,0.42083333333333334,0.0453125,0.09722222222222222
9706-2021_03_20_091623.jpg,van,36,430,640,43,360,207,3,466,250,LTAdatasets/9706/annotate/9706-2021_03_20_091623.jpg,448.0,228.5,0.7,0.6347222222222222,0.05625,0.11944444444444445
9706-2021_03_20_091623.jpg,lorry_truck,61,412,640,76,360,283,2,473,359,LTAdatasets/9706/annotate/9706-2021_03_20_091623.jpg,442.5,321.0,0.69140625,0.8916666666666667,0.0953125,0.2111111111111111
9706-2021_03_20_091623.jpg,lorry_truck,20,327,640,22,360,61,2,347,83,LTAdatasets/9706/annotate/9706-2021_03_20_091623.jpg,337.0,72.0,0.5265625,0.2,0.03125,0.06111111111111111
9706-2021_03_20_091623.jpg,lorry_truck,21,327,640,22,360,94,2,348,116,LTAdatasets/9706/annotate/9706-2021_03_20_091623.jpg,337.5,105.0,0.52734375,0.2916666666666667,0.0328125,0.06111111111111111
9706-2021_03_20_092143.jpg,lorry_truck,100,479,640,106,360,254,2,579,360,LTAdatasets/9706/annotate/9706-2021_03_20_092143.jpg,529.0,307.0,0.8265625,0.8527777777777777,0.15625,0.29444444444444445
9706-2021_03_20_092143.jpg,lorry_truck,22,351,640,36,360,75,2,373,111,LTAdatasets/9706/annotate/9706-2021_03_20_092143.jpg,362.0,93.0,0.565625,0.25833333333333336,0.034375,0.1
9706-2021_03_20_092143.jpg,lorry_truck,23,327,640,22,360,60,2,350,82,LTAdatasets/9706/annotate/9706-2021_03_20_092143.jpg,338.5,71.0,0.52890625,0.19722222222222222,0.0359375,0.06111111111111111
9706-2021_03_20_092143.jpg,lorry_truck,18,314,640,25,360,64,2,332,89,LTAdatasets/9706/annotate/9706-2021_03_20_092143.jpg,323.0,76.5,0.5046875,0.2125,0.028125,0.06944444444444445
9706-2021_03_20_092143.jpg,lorry_truck,13,205,640,17,360,54,2,218,71,LTAdatasets/9706/annotate/9706-2021_03_20_092143.jpg,211.5,62.5,0.33046875,0.1736111111111111,0.0203125,0.04722222222222222
9706-2021_03_20_092143.jpg,lorry_truck,11,302,640,14,360,37,2,313,51,LTAdatasets/9706/annotate/9706-2021_03_20_092143.jpg,307.5,44.0,0.48046875,0.12222222222222222,0.0171875,0.03888888888888889
9706-2021_03_20_092143.jpg,car,10,285,640,14,360,54,1,295,68,LTAdatasets/9706/annotate/9706-2021_03_20_092143.jpg,290.0,61.0,0.453125,0.16944444444444445,0.015625,0.03888888888888889
9706-2021_03_20_092143.jpg,car,14,331,640,23,360,105,1,345,128,LTAdatasets/9706/annotate/9706-2021_03_20_092143.jpg,338.0,116.5,0.528125,0.3236111111111111,0.021875,0.06388888888888888
9706-2021_03_20_092143.jpg,car,33,200,640,33,360,206,1,233,239,LTAdatasets/9706/annotate/9706-2021_03_20_092143.jpg,216.5,222.5,0.33828125,0.6180555555555556,0.0515625,0.09166666666666666
9706-2021_03_20_092143.jpg,car,29,137,640,38,360,228,1,166,266,LTAdatasets/9706/annotate/9706-2021_03_20_092143.jpg,151.5,247.0,0.23671875,0.6861111111111111,0.0453125,0.10555555555555556
9706-2021_03_20_092143.jpg,car,44,18,640,45,360,315,1,62,360,LTAdatasets/9706/annotate/9706-2021_03_20_092143.jpg,40.0,337.5,0.0625,0.9375,0.06875,0.125
9706-2021_03_20_092143.jpg,car,16,199,640,22,360,115,1,215,137,LTAdatasets/9706/annotate/9706-2021_03_20_092143.jpg,207.0,126.0,0.3234375,0.35,0.025,0.06111111111111111
9706-2021_03_20_092143.jpg,car,12,235,640,15,360,92,1,247,107,LTAdatasets/9706/annotate/9706-2021_03_20_092143.jpg,241.0,99.5,0.3765625,0.2763888888888889,0.01875,0.041666666666666664
9706-2021_03_20_092143.jpg,bike,9,213,640,12,360,80,4,222,92,LTAdatasets/9706/annotate/9706-2021_03_20_092143.jpg,217.5,86.0,0.33984375,0.2388888888888889,0.0140625,0.03333333333333333
9706-2021_03_20_092143.jpg,car,9,241,640,12,360,66,1,250,78,LTAdatasets/9706/annotate/9706-2021_03_20_092143.jpg,245.5,72.0,0.38359375,0.2,0.0140625,0.03333333333333333
9706-2021_03_20_092143.jpg,car,12,218,640,10,360,69,1,230,79,LTAdatasets/9706/annotate/9706-2021_03_20_092143.jpg,224.0,74.0,0.35,0.20555555555555555,0.01875,0.027777777777777776
9706-2021_03_20_092143.jpg,car,9,196,640,13,360,79,1,205,92,LTAdatasets/9706/annotate/9706-2021_03_20_092143.jpg,200.5,85.5,0.31328125,0.2375,0.0140625,0.03611111111111111
9706-2021_03_20_092143.jpg,van,18,162,640,17,360,121,3,180,138,LTAdatasets/9706/annotate/9706-2021_03_20_092143.jpg,171.0,129.5,0.2671875,0.3597222222222222,0.028125,0.04722222222222222
9706-2021_03_20_092143.jpg,car,13,237,640,8,360,51,1,250,59,LTAdatasets/9706/annotate/9706-2021_03_20_092143.jpg,243.5,55.0,0.38046875,0.1527777777777778,0.0203125,0.022222222222222223
9706-2021_03_20_092143.jpg,car,16,284,640,12,360,41,1,300,53,LTAdatasets/9706/annotate/9706-2021_03_20_092143.jpg,292.0,47.0,0.45625,0.13055555555555556,0.025,0.03333333333333333
9706-2021_03_20_092543.jpg,car,33,323,640,44,360,215,1,356,259,LTAdatasets/9706/annotate/9706-2021_03_20_092543.jpg,339.5,237.0,0.53046875,0.6583333333333333,0.0515625,0.12222222222222222
9706-2021_03_20_092543.jpg,car,37,386,640,45,360,171,1,423,216,LTAdatasets/9706/annotate/9706-2021_03_20_092543.jpg,404.5,193.5,0.63203125,0.5375,0.0578125,0.125
9706-2021_03_20_092543.jpg,car,17,308,640,24,360,112,1,325,136,LTAdatasets/9706/annotate/9706-2021_03_20_092543.jpg,316.5,124.0,0.49453125,0.34444444444444444,0.0265625,0.06666666666666667
9706-2021_03_20_092543.jpg,bike,18,343,640,26,360,162,4,361,188,LTAdatasets/9706/annotate/9706-2021_03_20_092543.jpg,352.0,175.0,0.55,0.4861111111111111,0.028125,0.07222222222222222
9706-2021_03_20_092543.jpg,car,16,190,640,17,360,126,1,206,143,LTAdatasets/9706/annotate/9706-2021_03_20_092543.jpg,198.0,134.5,0.309375,0.3736111111111111,0.025,0.04722222222222222
9706-2021_03_20_092543.jpg,van,21,136,640,31,360,141,3,157,172,LTAdatasets/9706/annotate/9706-2021_03_20_092543.jpg,146.5,156.5,0.22890625,0.43472222222222223,0.0328125,0.08611111111111111
9706-2021_03_20_092543.jpg,lorry_truck,26,158,640,38,360,172,2,184,210,LTAdatasets/9706/annotate/9706-2021_03_20_092543.jpg,171.0,191.0,0.2671875,0.5305555555555556,0.040625,0.10555555555555556
9706-2021_03_20_092543.jpg,lorry_truck,29,348,640,30,360,83,2,377,113,LTAdatasets/9706/annotate/9706-2021_03_20_092543.jpg,362.5,98.0,0.56640625,0.2722222222222222,0.0453125,0.08333333333333333
9706-2021_03_20_092543.jpg,van,19,320,640,20,360,82,3,339,102,LTAdatasets/9706/annotate/9706-2021_03_20_092543.jpg,329.5,92.0,0.51484375,0.25555555555555554,0.0296875,0.05555555555555555
9706-2021_03_20_092543.jpg,van,10,206,640,14,360,46,3,216,60,LTAdatasets/9706/annotate/9706-2021_03_20_092543.jpg,211.0,53.0,0.3296875,0.14722222222222223,0.015625,0.03888888888888889
9706-2021_03_20_092543.jpg,van,19,218,640,19,360,122,3,237,141,LTAdatasets/9706/annotate/9706-2021_03_20_092543.jpg,227.5,131.5,0.35546875,0.36527777777777776,0.0296875,0.05277777777777778
9706-2021_03_20_092543.jpg,car,12,197,640,13,360,87,1,209,100,LTAdatasets/9706/annotate/9706-2021_03_20_092543.jpg,203.0,93.5,0.3171875,0.25972222222222224,0.01875,0.03611111111111111
9706-2021_03_20_092543.jpg,car,11,203,640,11,360,70,1,214,81,LTAdatasets/9706/annotate/9706-2021_03_20_092543.jpg,208.5,75.5,0.32578125,0.20972222222222223,0.0171875,0.030555555555555555
9706-2021_03_20_092543.jpg,car,14,220,640,10,360,66,1,234,76,LTAdatasets/9706/annotate/9706-2021_03_20_092543.jpg,227.0,71.0,0.3546875,0.19722222222222222,0.021875,0.027777777777777776
9706-2021_03_20_092543.jpg,car,10,225,640,8,360,55,1,235,63,LTAdatasets/9706/annotate/9706-2021_03_20_092543.jpg,230.0,59.0,0.359375,0.1638888888888889,0.015625,0.022222222222222223
9706-2021_03_20_092543.jpg,car,10,234,640,5,360,42,1,244,47,LTAdatasets/9706/annotate/9706-2021_03_20_092543.jpg,239.0,44.5,0.3734375,0.12361111111111112,0.015625,0.013888888888888888
9706-2021_03_20_094305.jpg,bike,20,361,640,32,360,230,4,381,262,LTAdatasets/9706/annotate/9706-2021_03_20_094305.jpg,371.0,246.0,0.5796875,0.6833333333333333,0.03125,0.08888888888888889
9706-2021_03_20_094305.jpg,bike,9,319,640,17,360,103,4,328,120,LTAdatasets/9706/annotate/9706-2021_03_20_094305.jpg,323.5,111.5,0.50546875,0.30972222222222223,0.0140625,0.04722222222222222
9706-2021_03_20_094305.jpg,bike,9,328,640,12,360,68,4,337,80,LTAdatasets/9706/annotate/9706-2021_03_20_094305.jpg,332.5,74.0,0.51953125,0.20555555555555555,0.0140625,0.03333333333333333
9706-2021_03_20_094305.jpg,lorry_truck,27,390,640,30,360,148,2,417,178,LTAdatasets/9706/annotate/9706-2021_03_20_094305.jpg,403.5,163.0,0.63046875,0.4527777777777778,0.0421875,0.08333333333333333
9706-2021_03_20_094305.jpg,van,22,359,640,25,360,108,3,381,133,LTAdatasets/9706/annotate/9706-2021_03_20_094305.jpg,370.0,120.5,0.578125,0.3347222222222222,0.034375,0.06944444444444445
9706-2021_03_20_094305.jpg,lorry_truck,19,198,640,22,360,108,2,217,130,LTAdatasets/9706/annotate/9706-2021_03_20_094305.jpg,207.5,119.0,0.32421875,0.33055555555555555,0.0296875,0.06111111111111111
9706-2021_03_20_094305.jpg,lorry_truck,24,189,640,23,360,69,2,213,92,LTAdatasets/9706/annotate/9706-2021_03_20_094305.jpg,201.0,80.5,0.3140625,0.22361111111111112,0.0375,0.06388888888888888
9706-2021_03_20_094305.jpg,car,10,290,640,11,360,64,1,300,75,LTAdatasets/9706/annotate/9706-2021_03_20_094305.jpg,295.0,69.5,0.4609375,0.19305555555555556,0.015625,0.030555555555555555
9706-2021_03_20_094305.jpg,car,11,307,640,10,360,62,1,318,72,LTAdatasets/9706/annotate/9706-2021_03_20_094305.jpg,312.5,67.0,0.48828125,0.18611111111111112,0.0171875,0.027777777777777776
9706-2021_03_20_094305.jpg,car,18,150,640,23,360,142,1,168,165,LTAdatasets/9706/annotate/9706-2021_03_20_094305.jpg,159.0,153.5,0.2484375,0.4263888888888889,0.028125,0.06388888888888888
9706-2021_03_20_094305.jpg,car,32,137,640,41,360,224,1,169,265,LTAdatasets/9706/annotate/9706-2021_03_20_094305.jpg,153.0,244.5,0.2390625,0.6791666666666667,0.05,0.11388888888888889
9706-2021_03_20_094305.jpg,car,10,209,640,9,360,43,1,219,52,LTAdatasets/9706/annotate/9706-2021_03_20_094305.jpg,214.0,47.5,0.334375,0.13194444444444445,0.015625,0.025
9706-2021_03_20_073717.jpg,bike,13,356,640,26,360,214,4,369,240,LTAdatasets/9706/annotate/9706-2021_03_20_073717.jpg,362.5,227.0,0.56640625,0.6305555555555555,0.0203125,0.07222222222222222
9706-2021_03_20_073717.jpg,bike,10,352,640,20,360,132,4,362,152,LTAdatasets/9706/annotate/9706-2021_03_20_073717.jpg,357.0,142.0,0.5578125,0.39444444444444443,0.015625,0.05555555555555555
9706-2021_03_20_073717.jpg,lorry_truck,36,405,640,39,360,152,2,441,191,LTAdatasets/9706/annotate/9706-2021_03_20_073717.jpg,423.0,171.5,0.6609375,0.47638888888888886,0.05625,0.10833333333333334
9706-2021_03_20_073717.jpg,lorry_truck,43,384,640,72,360,191,2,427,263,LTAdatasets/9706/annotate/9706-2021_03_20_073717.jpg,405.5,227.0,0.63359375,0.6305555555555555,0.0671875,0.2
9706-2021_03_20_073717.jpg,lorry_truck,21,351,640,18,360,90,2,372,108,LTAdatasets/9706/annotate/9706-2021_03_20_073717.jpg,361.5,99.0,0.56484375,0.275,0.0328125,0.05
9706-2021_03_20_073717.jpg,lorry_truck,13,304,640,17,360,39,2,317,56,LTAdatasets/9706/annotate/9706-2021_03_20_073717.jpg,310.5,47.5,0.48515625,0.13194444444444445,0.0203125,0.04722222222222222
9706-2021_03_20_073717.jpg,lorry_truck,11,287,640,12,360,38,2,298,50,LTAdatasets/9706/annotate/9706-2021_03_20_073717.jpg,292.5,44.0,0.45703125,0.12222222222222222,0.0171875,0.03333333333333333
9706-2021_03_20_073717.jpg,lorry_truck,14,209,640,12,360,35,2,223,47,LTAdatasets/9706/annotate/9706-2021_03_20_073717.jpg,216.0,41.0,0.3375,0.11388888888888889,0.021875,0.03333333333333333
9706-2021_03_20_073717.jpg,car,16,321,640,17,360,85,1,337,102,LTAdatasets/9706/annotate/9706-2021_03_20_073717.jpg,329.0,93.5,0.5140625,0.25972222222222224,0.025,0.04722222222222222
9706-2021_03_20_073717.jpg,car,37,343,640,52,360,254,1,380,306,LTAdatasets/9706/annotate/9706-2021_03_20_073717.jpg,361.5,280.0,0.56484375,0.7777777777777778,0.0578125,0.14444444444444443
9706-2021_03_20_073717.jpg,car,14,292,640,20,360,74,1,306,94,LTAdatasets/9706/annotate/9706-2021_03_20_073717.jpg,299.0,84.0,0.4671875,0.23333333333333334,0.021875,0.05555555555555555
9706-2021_03_20_073717.jpg,car,11,314,640,13,360,66,1,325,79,LTAdatasets/9706/annotate/9706-2021_03_20_073717.jpg,319.5,72.5,0.49921875,0.2013888888888889,0.0171875,0.03611111111111111
9706-2021_03_20_073717.jpg,car,9,302,640,14,360,52,1,311,66,LTAdatasets/9706/annotate/9706-2021_03_20_073717.jpg,306.5,59.0,0.47890625,0.1638888888888889,0.0140625,0.03888888888888889
9706-2021_03_20_073717.jpg,car,11,199,640,12,360,70,1,210,82,LTAdatasets/9706/annotate/9706-2021_03_20_073717.jpg,204.5,76.0,0.31953125,0.2111111111111111,0.0171875,0.03333333333333333
9706-2021_03_20_073717.jpg,bike,8,232,640,11,360,59,4,240,70,LTAdatasets/9706/annotate/9706-2021_03_20_073717.jpg,236.0,64.5,0.36875,0.17916666666666667,0.0125,0.030555555555555555
9706-2021_03_20_073717.jpg,van,12,210,640,10,360,50,3,222,60,LTAdatasets/9706/annotate/9706-2021_03_20_073717.jpg,216.0,55.0,0.3375,0.1527777777777778,0.01875,0.027777777777777776
9706-2021_03_20_073717.jpg,car,8,240,640,12,360,46,1,248,58,LTAdatasets/9706/annotate/9706-2021_03_20_073717.jpg,244.0,52.0,0.38125,0.14444444444444443,0.0125,0.03333333333333333
9706-2021_03_20_084001.jpg,car,36,324,640,48,360,209,1,360,257,LTAdatasets/9706/annotate/9706-2021_03_20_084001.jpg,342.0,233.0,0.534375,0.6472222222222223,0.05625,0.13333333333333333
9706-2021_03_20_084001.jpg,bike,20,343,640,20,360,178,4,363,198,LTAdatasets/9706/annotate/9706-2021_03_20_084001.jpg,353.0,188.0,0.5515625,0.5222222222222223,0.03125,0.05555555555555555
9706-2021_03_20_084001.jpg,bike,12,310,640,17,360,87,4,322,104,LTAdatasets/9706/annotate/9706-2021_03_20_084001.jpg,316.0,95.5,0.49375,0.2652777777777778,0.01875,0.04722222222222222
9706-2021_03_20_084001.jpg,bike,9,291,640,8,360,56,4,300,64,LTAdatasets/9706/annotate/9706-2021_03_20_084001.jpg,295.5,60.0,0.46171875,0.16666666666666666,0.0140625,0.022222222222222223
9706-2021_03_20_084001.jpg,car,14,221,640,10,360,59,1,235,69,LTAdatasets/9706/annotate/9706-2021_03_20_084001.jpg,228.0,64.0,0.35625,0.17777777777777778,0.021875,0.027777777777777776
9706-2021_03_20_084001.jpg,car,16,194,640,12,360,72,1,210,84,LTAdatasets/9706/annotate/9706-2021_03_20_084001.jpg,202.0,78.0,0.315625,0.21666666666666667,0.025,0.03333333333333333
9706-2021_03_20_084001.jpg,car,22,330,640,18,360,115,1,352,133,LTAdatasets/9706/annotate/9706-2021_03_20_084001.jpg,341.0,124.0,0.5328125,0.34444444444444444,0.034375,0.05
9706-2021_03_20_084001.jpg,car,11,324,640,11,360,60,1,335,71,LTAdatasets/9706/annotate/9706-2021_03_20_084001.jpg,329.5,65.5,0.51484375,0.18194444444444444,0.0171875,0.030555555555555555
9706-2021_03_20_084001.jpg,car,12,306,640,15,360,62,1,318,77,LTAdatasets/9706/annotate/9706-2021_03_20_084001.jpg,312.0,69.5,0.4875,0.19305555555555556,0.01875,0.041666666666666664
9706-2021_03_20_084001.jpg,lorry_truck,24,339,640,26,360,67,2,363,93,LTAdatasets/9706/annotate/9706-2021_03_20_084001.jpg,351.0,80.0,0.5484375,0.2222222222222222,0.0375,0.07222222222222222
9706-2021_03_20_084001.jpg,lorry_truck,29,379,640,44,360,114,2,408,158,LTAdatasets/9706/annotate/9706-2021_03_20_084001.jpg,393.5,136.0,0.61484375,0.37777777777777777,0.0453125,0.12222222222222222
9706-2021_03_20_084001.jpg,lorry_truck,20,165,640,38,360,96,2,185,134,LTAdatasets/9706/annotate/9706-2021_03_20_084001.jpg,175.0,115.0,0.2734375,0.3194444444444444,0.03125,0.10555555555555556
9706-2021_03_20_084001.jpg,van,23,163,640,38,360,170,3,186,208,LTAdatasets/9706/annotate/9706-2021_03_20_084001.jpg,174.5,189.0,0.27265625,0.525,0.0359375,0.10555555555555556
9706-2021_03_20_084001.jpg,van,18,316,640,17,360,79,3,334,96,LTAdatasets/9706/annotate/9706-2021_03_20_084001.jpg,325.0,87.5,0.5078125,0.24305555555555555,0.028125,0.04722222222222222
9706-2021_03_20_084001.jpg,lorry_truck,14,311,640,11,360,47,2,325,58,LTAdatasets/9706/annotate/9706-2021_03_20_084001.jpg,318.0,52.5,0.496875,0.14583333333333334,0.021875,0.030555555555555555
9706-2021_03_20_084001.jpg,lorry_truck,13,297,640,15,360,35,2,310,50,LTAdatasets/9706/annotate/9706-2021_03_20_084001.jpg,303.5,42.5,0.47421875,0.11805555555555555,0.0203125,0.041666666666666664
9706-2021_03_20_084001.jpg,car,8,285,640,10,360,40,1,293,50,LTAdatasets/9706/annotate/9706-2021_03_20_084001.jpg,289.0,45.0,0.4515625,0.125,0.0125,0.027777777777777776
9706-2021_03_20_084001.jpg,car,11,224,640,10,360,44,1,235,54,LTAdatasets/9706/annotate/9706-2021_03_20_084001.jpg,229.5,49.0,0.35859375,0.1361111111111111,0.0171875,0.027777777777777776
9706-2021_03_20_073037.jpg,car,29,313,640,26,360,144,1,342,170,LTAdatasets/9706/annotate/9706-2021_03_20_073037.jpg,327.5,157.0,0.51171875,0.4361111111111111,0.0453125,0.07222222222222222
9706-2021_03_20_073037.jpg,car,20,298,640,17,360,91,1,318,108,LTAdatasets/9706/annotate/9706-2021_03_20_073037.jpg,308.0,99.5,0.48125,0.2763888888888889,0.03125,0.04722222222222222
9706-2021_03_20_073037.jpg,car,13,170,640,17,360,115,1,183,132,LTAdatasets/9706/annotate/9706-2021_03_20_073037.jpg,176.5,123.5,0.27578125,0.34305555555555556,0.0203125,0.04722222222222222
9706-2021_03_20_073037.jpg,lorry_truck,15,220,640,19,360,57,2,235,76,LTAdatasets/9706/annotate/9706-2021_03_20_073037.jpg,227.5,66.5,0.35546875,0.18472222222222223,0.0234375,0.05277777777777778
9706-2021_03_20_073037.jpg,lorry_truck,23,365,640,26,360,96,2,388,122,LTAdatasets/9706/annotate/9706-2021_03_20_073037.jpg,376.5,109.0,0.58828125,0.30277777777777776,0.0359375,0.07222222222222222
9706-2021_03_20_073037.jpg,lorry_truck,14,190,640,20,360,81,2,204,101,LTAdatasets/9706/annotate/9706-2021_03_20_073037.jpg,197.0,91.0,0.3078125,0.25277777777777777,0.021875,0.05555555555555555
9706-2021_03_20_073037.jpg,lorry_truck,61,425,640,90,360,211,2,486,301,LTAdatasets/9706/annotate/9706-2021_03_20_073037.jpg,455.5,256.0,0.71171875,0.7111111111111111,0.0953125,0.25
9706-2021_03_20_073037.jpg,lorry_truck,13,312,640,12,360,51,2,325,63,LTAdatasets/9706/annotate/9706-2021_03_20_073037.jpg,318.5,57.0,0.49765625,0.15833333333333333,0.0203125,0.03333333333333333
9706-2021_03_20_073037.jpg,car,8,288,640,10,360,39,1,296,49,LTAdatasets/9706/annotate/9706-2021_03_20_073037.jpg,292.0,44.0,0.45625,0.12222222222222222,0.0125,0.027777777777777776
9706-2021_03_20_073037.jpg,car,11,291,640,14,360,45,1,302,59,LTAdatasets/9706/annotate/9706-2021_03_20_073037.jpg,296.5,52.0,0.46328125,0.14444444444444443,0.0171875,0.03888888888888889
9706-2021_03_20_073037.jpg,car,12,226,640,8,360,41,1,238,49,LTAdatasets/9706/annotate/9706-2021_03_20_073037.jpg,232.0,45.0,0.3625,0.125,0.01875,0.022222222222222223
9706-2021_03_20_085141.jpg,car,32,316,640,54,360,183,1,348,237,LTAdatasets/9706/annotate/9706-2021_03_20_085141.jpg,332.0,210.0,0.51875,0.5833333333333334,0.05,0.15
9706-2021_03_20_085141.jpg,car,17,302,640,19,360,112,1,319,131,LTAdatasets/9706/annotate/9706-2021_03_20_085141.jpg,310.5,121.5,0.48515625,0.3375,0.0265625,0.05277777777777778
9706-2021_03_20_085141.jpg,car,21,234,640,14,360,93,1,255,107,LTAdatasets/9706/annotate/9706-2021_03_20_085141.jpg,244.5,100.0,0.38203125,0.2777777777777778,0.0328125,0.03888888888888889
9706-2021_03_20_085141.jpg,car,17,188,640,12,360,83,1,205,95,LTAdatasets/9706/annotate/9706-2021_03_20_085141.jpg,196.5,89.0,0.30703125,0.24722222222222223,0.0265625,0.03333333333333333
9706-2021_03_20_085141.jpg,car,11,209,640,9,360,64,1,220,73,LTAdatasets/9706/annotate/9706-2021_03_20_085141.jpg,214.5,68.5,0.33515625,0.19027777777777777,0.0171875,0.025
9706-2021_03_20_085141.jpg,van,13,314,640,16,360,69,3,327,85,LTAdatasets/9706/annotate/9706-2021_03_20_085141.jpg,320.5,77.0,0.50078125,0.21388888888888888,0.0203125,0.044444444444444446
9706-2021_03_20_085141.jpg,van,11,304,640,10,360,59,3,315,69,LTAdatasets/9706/annotate/9706-2021_03_20_085141.jpg,309.5,64.0,0.48359375,0.17777777777777778,0.0171875,0.027777777777777776
9706-2021_03_20_085141.jpg,van,37,126,640,47,360,228,3,163,275,LTAdatasets/9706/annotate/9706-2021_03_20_085141.jpg,144.5,251.5,0.22578125,0.6986111111111111,0.0578125,0.13055555555555556
9706-2021_03_20_085141.jpg,lorry_truck,19,314,640,18,360,46,2,333,64,LTAdatasets/9706/annotate/9706-2021_03_20_085141.jpg,323.5,55.0,0.50546875,0.1527777777777778,0.0296875,0.05
9706-2021_03_20_085141.jpg,lorry_truck,39,369,640,42,360,114,2,408,156,LTAdatasets/9706/annotate/9706-2021_03_20_085141.jpg,388.5,135.0,0.60703125,0.375,0.0609375,0.11666666666666667
9706-2021_03_20_085141.jpg,lorry_truck,9,293,640,9,360,47,2,302,56,LTAdatasets/9706/annotate/9706-2021_03_20_085141.jpg,297.5,51.5,0.46484375,0.14305555555555555,0.0140625,0.025
9706-2021_03_20_085141.jpg,lorry_truck,6,290,640,10,360,30,2,296,40,LTAdatasets/9706/annotate/9706-2021_03_20_085141.jpg,293.0,35.0,0.4578125,0.09722222222222222,0.009375,0.027777777777777776
9706-2021_03_20_085141.jpg,lorry_truck,69,510,640,52,360,308,2,579,360,LTAdatasets/9706/annotate/9706-2021_03_20_085141.jpg,544.5,334.0,0.85078125,0.9277777777777778,0.1078125,0.14444444444444443
9706-2021_03_20_085141.jpg,bike,9,239,640,14,360,51,4,248,65,LTAdatasets/9706/annotate/9706-2021_03_20_085141.jpg,243.5,58.0,0.38046875,0.16111111111111112,0.0140625,0.03888888888888889
9706-2021_03_20_085141.jpg,car,9,224,640,10,360,44,1,233,54,LTAdatasets/9706/annotate/9706-2021_03_20_085141.jpg,228.5,49.0,0.35703125,0.1361111111111111,0.0140625,0.027777777777777776
9706-2021_03_20_085141.jpg,lorry_truck,13,208,640,7,360,47,2,221,54,LTAdatasets/9706/annotate/9706-2021_03_20_085141.jpg,214.5,50.5,0.33515625,0.14027777777777778,0.0203125,0.019444444444444445
9706-2021_03_20_192515.jpg,lorry_truck,45,430,640,62,360,201,2,475,263,LTAdatasets/9706/annotate/9706-2021_03_20_192515.jpg,452.5,232.0,0.70703125,0.6444444444444445,0.0703125,0.17222222222222222
9706-2021_03_20_192515.jpg,car,30,319,640,44,360,175,1,349,219,LTAdatasets/9706/annotate/9706-2021_03_20_192515.jpg,334.0,197.0,0.521875,0.5472222222222223,0.046875,0.12222222222222222
9706-2021_03_20_192515.jpg,car,28,360,640,39,360,175,1,388,214,LTAdatasets/9706/annotate/9706-2021_03_20_192515.jpg,374.0,194.5,0.584375,0.5402777777777777,0.04375,0.10833333333333334
9706-2021_03_20_192515.jpg,car,15,290,640,14,360,65,1,305,79,LTAdatasets/9706/annotate/9706-2021_03_20_192515.jpg,297.5,72.0,0.46484375,0.2,0.0234375,0.03888888888888889
9706-2021_03_20_192515.jpg,van,26,376,640,34,360,123,3,402,157,LTAdatasets/9706/annotate/9706-2021_03_20_192515.jpg,389.0,140.0,0.6078125,0.3888888888888889,0.040625,0.09444444444444444
9706-2021_03_20_192515.jpg,van,13,306,640,11,360,42,3,319,53,LTAdatasets/9706/annotate/9706-2021_03_20_192515.jpg,312.5,47.5,0.48828125,0.13194444444444445,0.0203125,0.030555555555555555
9706-2021_03_20_192515.jpg,van,15,217,640,13,360,77,3,232,90,LTAdatasets/9706/annotate/9706-2021_03_20_192515.jpg,224.5,83.5,0.35078125,0.23194444444444445,0.0234375,0.03611111111111111
9706-2021_03_20_192515.jpg,car,12,242,640,12,360,75,1,254,87,LTAdatasets/9706/annotate/9706-2021_03_20_192515.jpg,248.0,81.0,0.3875,0.225,0.01875,0.03333333333333333
9706-2021_03_20_192515.jpg,bike,15,204,640,17,360,104,4,219,121,LTAdatasets/9706/annotate/9706-2021_03_20_192515.jpg,211.5,112.5,0.33046875,0.3125,0.0234375,0.04722222222222222
9706-2021_03_20_192515.jpg,bike,19,169,640,29,360,216,4,188,245,LTAdatasets/9706/annotate/9706-2021_03_20_192515.jpg,178.5,230.5,0.27890625,0.6402777777777777,0.0296875,0.08055555555555556
9706-2021_03_20_192515.jpg,car,12,227,640,10,360,59,1,239,69,LTAdatasets/9706/annotate/9706-2021_03_20_192515.jpg,233.0,64.0,0.3640625,0.17777777777777778,0.01875,0.027777777777777776
9706-2021_03_20_192515.jpg,car,9,236,640,6,360,43,1,245,49,LTAdatasets/9706/annotate/9706-2021_03_20_192515.jpg,240.5,46.0,0.37578125,0.12777777777777777,0.0140625,0.016666666666666666
9706-2021_03_20_192515.jpg,car,11,296,640,9,360,50,1,307,59,LTAdatasets/9706/annotate/9706-2021_03_20_192515.jpg,301.5,54.5,0.47109375,0.15138888888888888,0.0171875,0.025
9706-2021_03_20_192515.jpg,car,14,283,640,7,360,43,1,297,50,LTAdatasets/9706/annotate/9706-2021_03_20_192515.jpg,290.0,46.5,0.453125,0.12916666666666668,0.021875,0.019444444444444445
9706-2021_03_20_192515.jpg,bike,12,211,640,9,360,39,4,223,48,LTAdatasets/9706/annotate/9706-2021_03_20_192515.jpg,217.0,43.5,0.3390625,0.12083333333333333,0.01875,0.025
9706-2021_03_20_200937.jpg,lorry_truck,27,344,640,37,360,132,2,371,169,LTAdatasets/9706/annotate/9706-2021_03_20_200937.jpg,357.5,150.5,0.55859375,0.41805555555555557,0.0421875,0.10277777777777777
9706-2021_03_20_200937.jpg,car,18,333,640,23,360,100,1,351,123,LTAdatasets/9706/annotate/9706-2021_03_20_200937.jpg,342.0,111.5,0.534375,0.30972222222222223,0.028125,0.06388888888888888
9706-2021_03_20_200937.jpg,bike,14,311,640,23,360,127,4,325,150,LTAdatasets/9706/annotate/9706-2021_03_20_200937.jpg,318.0,138.5,0.496875,0.38472222222222224,0.021875,0.06388888888888888
9706-2021_03_20_200937.jpg,car,25,185,640,21,360,144,1,210,165,LTAdatasets/9706/annotate/9706-2021_03_20_200937.jpg,197.5,154.5,0.30859375,0.42916666666666664,0.0390625,0.058333333333333334
9706-2021_03_20_200937.jpg,car,19,231,640,21,360,121,1,250,142,LTAdatasets/9706/annotate/9706-2021_03_20_200937.jpg,240.5,131.5,0.37578125,0.36527777777777776,0.0296875,0.058333333333333334
9706-2021_03_20_200937.jpg,car,12,242,640,16,360,66,1,254,82,LTAdatasets/9706/annotate/9706-2021_03_20_200937.jpg,248.0,74.0,0.3875,0.20555555555555555,0.01875,0.044444444444444446
9706-2021_03_20_200937.jpg,bus,51,85,640,69,360,184,5,136,253,LTAdatasets/9706/annotate/9706-2021_03_20_200937.jpg,110.5,218.5,0.17265625,0.6069444444444444,0.0796875,0.19166666666666668
9706-2021_03_20_200937.jpg,car,14,206,640,8,360,63,1,220,71,LTAdatasets/9706/annotate/9706-2021_03_20_200937.jpg,213.0,67.0,0.3328125,0.18611111111111112,0.021875,0.022222222222222223
9706-2021_03_20_200937.jpg,car,8,231,640,10,360,51,1,239,61,LTAdatasets/9706/annotate/9706-2021_03_20_200937.jpg,235.0,56.0,0.3671875,0.15555555555555556,0.0125,0.027777777777777776
9706-2021_03_20_200937.jpg,car,8,213,640,6,360,52,1,221,58,LTAdatasets/9706/annotate/9706-2021_03_20_200937.jpg,217.0,55.0,0.3390625,0.1527777777777778,0.0125,0.016666666666666666
9706-2021_03_20_193935.jpg,car,41,343,640,77,360,281,1,384,358,LTAdatasets/9706/annotate/9706-2021_03_20_193935.jpg,363.5,319.5,0.56796875,0.8875,0.0640625,0.21388888888888888
9706-2021_03_20_193935.jpg,lorry_truck,35,339,640,32,360,131,2,374,163,LTAdatasets/9706/annotate/9706-2021_03_20_193935.jpg,356.5,147.0,0.55703125,0.4083333333333333,0.0546875,0.08888888888888889
9706-2021_03_20_193935.jpg,car,21,326,640,15,360,95,1,347,110,LTAdatasets/9706/annotate/9706-2021_03_20_193935.jpg,336.5,102.5,0.52578125,0.2847222222222222,0.0328125,0.041666666666666664
9706-2021_03_20_193935.jpg,car,22,292,640,15,360,86,1,314,101,LTAdatasets/9706/annotate/9706-2021_03_20_193935.jpg,303.0,93.5,0.4734375,0.25972222222222224,0.034375,0.041666666666666664
9706-2021_03_20_193935.jpg,car,16,304,640,9,360,64,1,320,73,LTAdatasets/9706/annotate/9706-2021_03_20_193935.jpg,312.0,68.5,0.4875,0.19027777777777777,0.025,0.025
9706-2021_03_20_193935.jpg,car,10,212,640,15,360,88,1,222,103,LTAdatasets/9706/annotate/9706-2021_03_20_193935.jpg,217.0,95.5,0.3390625,0.2652777777777778,0.015625,0.041666666666666664
9706-2021_03_20_193935.jpg,car,17,221,640,9,360,60,1,238,69,LTAdatasets/9706/annotate/9706-2021_03_20_193935.jpg,229.5,64.5,0.35859375,0.17916666666666667,0.0265625,0.025
9706-2021_03_20_193935.jpg,car,10,224,640,11,360,38,1,234,49,LTAdatasets/9706/annotate/9706-2021_03_20_193935.jpg,229.0,43.5,0.3578125,0.12083333333333333,0.015625,0.030555555555555555
9706-2021_03_20_094904.jpg,lorry_truck,51,71,640,56,360,194,2,122,250,LTAdatasets/9706/annotate/9706-2021_03_20_094904.jpg,96.5,222.0,0.15078125,0.6166666666666667,0.0796875,0.15555555555555556
9706-2021_03_20_094904.jpg,car,26,165,640,31,360,176,1,191,207,LTAdatasets/9706/annotate/9706-2021_03_20_094904.jpg,178.0,191.5,0.278125,0.5319444444444444,0.040625,0.08611111111111111
9706-2021_03_20_094904.jpg,lorry_truck,30,351,640,34,360,83,2,381,117,LTAdatasets/9706/annotate/9706-2021_03_20_094904.jpg,366.0,100.0,0.571875,0.2777777777777778,0.046875,0.09444444444444444
9706-2021_03_20_094904.jpg,lorry_truck,20,299,640,24,360,48,2,319,72,LTAdatasets/9706/annotate/9706-2021_03_20_094904.jpg,309.0,60.0,0.4828125,0.16666666666666666,0.03125,0.06666666666666667
9706-2021_03_20_094904.jpg,lorry_truck,16,190,640,16,360,81,2,206,97,LTAdatasets/9706/annotate/9706-2021_03_20_094904.jpg,198.0,89.0,0.309375,0.24722222222222223,0.025,0.044444444444444446
9706-2021_03_20_094904.jpg,car,15,231,640,17,360,102,1,246,119,LTAdatasets/9706/annotate/9706-2021_03_20_094904.jpg,238.5,110.5,0.37265625,0.30694444444444446,0.0234375,0.04722222222222222
9706-2021_03_20_094904.jpg,car,15,228,640,15,360,50,1,243,65,LTAdatasets/9706/annotate/9706-2021_03_20_094904.jpg,235.5,57.5,0.36796875,0.1597222222222222,0.0234375,0.041666666666666664
9706-2021_03_20_094904.jpg,car,9,211,640,10,360,45,1,220,55,LTAdatasets/9706/annotate/9706-2021_03_20_094904.jpg,215.5,50.0,0.33671875,0.1388888888888889,0.0140625,0.027777777777777776
9706-2021_03_20_094904.jpg,lorry_truck,16,278,640,12,360,27,2,294,39,LTAdatasets/9706/annotate/9706-2021_03_20_094904.jpg,286.0,33.0,0.446875,0.09166666666666666,0.025,0.03333333333333333
9706-2021_03_20_094904.jpg,car,9,221,640,6,360,37,1,230,43,LTAdatasets/9706/annotate/9706-2021_03_20_094904.jpg,225.5,40.0,0.35234375,0.1111111111111111,0.0140625,0.016666666666666666
9706-2021_03_20_192214.jpg,car,45,173,640,39,360,321,1,218,360,LTAdatasets/9706/annotate/9706-2021_03_20_192214.jpg,195.5,340.5,0.30546875,0.9458333333333333,0.0703125,0.10833333333333334
9706-2021_03_20_192214.jpg,car,18,298,640,19,360,86,1,316,105,LTAdatasets/9706/annotate/9706-2021_03_20_192214.jpg,307.0,95.5,0.4796875,0.2652777777777778,0.028125,0.05277777777777778
9706-2021_03_20_192214.jpg,car,14,291,640,10,360,66,1,305,76,LTAdatasets/9706/annotate/9706-2021_03_20_192214.jpg,298.0,71.0,0.465625,0.19722222222222222,0.021875,0.027777777777777776
9706-2021_03_20_192214.jpg,car,14,296,640,8,360,55,1,310,63,LTAdatasets/9706/annotate/9706-2021_03_20_192214.jpg,303.0,59.0,0.4734375,0.1638888888888889,0.021875,0.022222222222222223
9706-2021_03_20_192214.jpg,lorry_truck,19,215,640,14,360,70,2,234,84,LTAdatasets/9706/annotate/9706-2021_03_20_192214.jpg,224.5,77.0,0.35078125,0.21388888888888888,0.0296875,0.03888888888888889
9706-2021_03_20_192214.jpg,van,12,315,640,13,360,70,3,327,83,LTAdatasets/9706/annotate/9706-2021_03_20_192214.jpg,321.0,76.5,0.5015625,0.2125,0.01875,0.03611111111111111
9706-2021_03_20_192214.jpg,bike,10,234,640,19,360,92,4,244,111,LTAdatasets/9706/annotate/9706-2021_03_20_192214.jpg,239.0,101.5,0.3734375,0.28194444444444444,0.015625,0.05277777777777778
9706-2021_03_20_192214.jpg,car,11,239,640,8,360,48,1,250,56,LTAdatasets/9706/annotate/9706-2021_03_20_192214.jpg,244.5,52.0,0.38203125,0.14444444444444443,0.0171875,0.022222222222222223
9706-2021_03_20_192214.jpg,car,15,278,640,8,360,42,1,293,50,LTAdatasets/9706/annotate/9706-2021_03_20_192214.jpg,285.5,46.0,0.44609375,0.12777777777777777,0.0234375,0.022222222222222223
9706-2021_03_20_192214.jpg,lorry_truck,37,92,640,38,360,322,2,129,360,LTAdatasets/9706/annotate/9706-2021_03_20_192214.jpg,110.5,341.0,0.17265625,0.9472222222222222,0.0578125,0.10555555555555556
9706-2021_03_20_090402.jpg,lorry_truck,33,395,640,44,360,145,2,428,189,LTAdatasets/9706/annotate/9706-2021_03_20_090402.jpg,411.5,167.0,0.64296875,0.4638888888888889,0.0515625,0.12222222222222222
9706-2021_03_20_090402.jpg,lorry_truck,36,359,640,43,360,178,2,395,221,LTAdatasets/9706/annotate/9706-2021_03_20_090402.jpg,377.0,199.5,0.5890625,0.5541666666666667,0.05625,0.11944444444444445
9706-2021_03_20_090402.jpg,van,47,94,640,48,360,268,3,141,316,LTAdatasets/9706/annotate/9706-2021_03_20_090402.jpg,117.5,292.0,0.18359375,0.8111111111111111,0.0734375,0.13333333333333333
9706-2021_03_20_090402.jpg,van,19,323,640,23,360,87,3,342,110,LTAdatasets/9706/annotate/9706-2021_03_20_090402.jpg,332.5,98.5,0.51953125,0.27361111111111114,0.0296875,0.06388888888888888
9706-2021_03_20_090402.jpg,van,15,208,640,16,360,90,3,223,106,LTAdatasets/9706/annotate/9706-2021_03_20_090402.jpg,215.5,98.0,0.33671875,0.2722222222222222,0.0234375,0.044444444444444446
9706-2021_03_20_090402.jpg,car,13,295,640,21,360,77,1,308,98,LTAdatasets/9706/annotate/9706-2021_03_20_090402.jpg,301.5,87.5,0.47109375,0.24305555555555555,0.0203125,0.058333333333333334
9706-2021_03_20_090402.jpg,car,22,161,640,18,360,124,1,183,142,LTAdatasets/9706/annotate/9706-2021_03_20_090402.jpg,172.0,133.0,0.26875,0.36944444444444446,0.034375,0.05
9706-2021_03_20_090402.jpg,car,10,242,640,12,360,60,1,252,72,LTAdatasets/9706/annotate/9706-2021_03_20_090402.jpg,247.0,66.0,0.3859375,0.18333333333333332,0.015625,0.03333333333333333
9706-2021_03_20_090402.jpg,car,10,226,640,9,360,52,1,236,61,LTAdatasets/9706/annotate/9706-2021_03_20_090402.jpg,231.0,56.5,0.3609375,0.15694444444444444,0.015625,0.025
9706-2021_03_20_090402.jpg,lorry_truck,17,190,640,17,360,74,2,207,91,LTAdatasets/9706/annotate/9706-2021_03_20_090402.jpg,198.5,82.5,0.31015625,0.22916666666666666,0.0265625,0.04722222222222222
9706-2021_03_20_090402.jpg,lorry_truck,9,209,640,12,360,52,2,218,64,LTAdatasets/9706/annotate/9706-2021_03_20_090402.jpg,213.5,58.0,0.33359375,0.16111111111111112,0.0140625,0.03333333333333333
9706-2021_03_20_090402.jpg,lorry_truck,12,306,640,14,360,41,2,318,55,LTAdatasets/9706/annotate/9706-2021_03_20_090402.jpg,312.0,48.0,0.4875,0.13333333333333333,0.01875,0.03888888888888889
9706-2021_03_20_090402.jpg,lorry_truck,14,287,640,11,360,30,2,301,41,LTAdatasets/9706/annotate/9706-2021_03_20_090402.jpg,294.0,35.5,0.459375,0.09861111111111111,0.021875,0.030555555555555555
9706-2021_03_20_184613.jpg,bike,17,394,640,31,360,202,4,411,233,LTAdatasets/9706/annotate/9706-2021_03_20_184613.jpg,402.5,217.5,0.62890625,0.6041666666666666,0.0265625,0.08611111111111111
9706-2021_03_20_184613.jpg,bike,15,423,640,25,360,214,4,438,239,LTAdatasets/9706/annotate/9706-2021_03_20_184613.jpg,430.5,226.5,0.67265625,0.6291666666666667,0.0234375,0.06944444444444445
9706-2021_03_20_184613.jpg,bike,17,312,640,23,360,115,4,329,138,LTAdatasets/9706/annotate/9706-2021_03_20_184613.jpg,320.5,126.5,0.50078125,0.35138888888888886,0.0265625,0.06388888888888888
9706-2021_03_20_184613.jpg,bike,11,203,640,13,360,103,4,214,116,LTAdatasets/9706/annotate/9706-2021_03_20_184613.jpg,208.5,109.5,0.32578125,0.30416666666666664,0.0171875,0.03611111111111111
9706-2021_03_20_184613.jpg,lorry_truck,26,176,640,31,360,151,2,202,182,LTAdatasets/9706/annotate/9706-2021_03_20_184613.jpg,189.0,166.5,0.2953125,0.4625,0.040625,0.08611111111111111
9706-2021_03_20_184613.jpg,lorry_truck,83,508,640,63,360,297,2,591,360,LTAdatasets/9706/annotate/9706-2021_03_20_184613.jpg,549.5,328.5,0.85859375,0.9125,0.1296875,0.175
9706-2021_03_20_184613.jpg,lorry_truck,20,386,640,29,360,127,2,406,156,LTAdatasets/9706/annotate/9706-2021_03_20_184613.jpg,396.0,141.5,0.61875,0.39305555555555555,0.03125,0.08055555555555556
9706-2021_03_20_184613.jpg,lorry_truck,10,222,640,16,360,69,2,232,85,LTAdatasets/9706/annotate/9706-2021_03_20_184613.jpg,227.0,77.0,0.3546875,0.21388888888888888,0.015625,0.044444444444444446
9706-2021_03_20_184613.jpg,lorry_truck,17,199,640,18,360,73,2,216,91,LTAdatasets/9706/annotate/9706-2021_03_20_184613.jpg,207.5,82.0,0.32421875,0.22777777777777777,0.0265625,0.05
9706-2021_03_20_184613.jpg,car,12,306,640,14,360,65,1,318,79,LTAdatasets/9706/annotate/9706-2021_03_20_184613.jpg,312.0,72.0,0.4875,0.2,0.01875,0.03888888888888889
9706-2021_03_20_184613.jpg,car,35,117,640,58,360,268,1,152,326,LTAdatasets/9706/annotate/9706-2021_03_20_184613.jpg,134.5,297.0,0.21015625,0.825,0.0546875,0.16111111111111112
9706-2021_03_20_184613.jpg,car,33,324,640,43,360,205,1,357,248,LTAdatasets/9706/annotate/9706-2021_03_20_184613.jpg,340.5,226.5,0.53203125,0.6291666666666667,0.0515625,0.11944444444444445
9706-2021_03_20_184613.jpg,car,13,288,640,10,360,42,1,301,52,LTAdatasets/9706/annotate/9706-2021_03_20_184613.jpg,294.5,47.0,0.46015625,0.13055555555555556,0.0203125,0.027777777777777776
9706-2021_03_20_184613.jpg,bus,9,238,640,10,360,55,5,247,65,LTAdatasets/9706/annotate/9706-2021_03_20_184613.jpg,242.5,60.0,0.37890625,0.16666666666666666,0.0140625,0.027777777777777776
9706-2021_03_20_184613.jpg,car,11,210,640,10,360,51,1,221,61,LTAdatasets/9706/annotate/9706-2021_03_20_184613.jpg,215.5,56.0,0.33671875,0.15555555555555556,0.0171875,0.027777777777777776
9706-2021_03_20_184613.jpg,van,36,103,640,38,360,186,3,139,224,LTAdatasets/9706/annotate/9706-2021_03_20_184613.jpg,121.0,205.0,0.1890625,0.5694444444444444,0.05625,0.10555555555555556
9706-2021_03_20_184613.jpg,van,22,171,640,18,360,107,3,193,125,LTAdatasets/9706/annotate/9706-2021_03_20_184613.jpg,182.0,116.0,0.284375,0.32222222222222224,0.034375,0.05
9706-2021_03_20_184613.jpg,lorry_truck,7,226,640,11,360,52,2,233,63,LTAdatasets/9706/annotate/9706-2021_03_20_184613.jpg,229.5,57.5,0.35859375,0.1597222222222222,0.0109375,0.030555555555555555
9706-2021_03_20_082440.jpg,lorry_truck,73,384,640,85,360,132,2,457,217,LTAdatasets/9706/annotate/9706-2021_03_20_082440.jpg,420.5,174.5,0.65703125,0.4847222222222222,0.1140625,0.2361111111111111
9706-2021_03_20_082440.jpg,car,23,341,640,32,360,119,1,364,151,LTAdatasets/9706/annotate/9706-2021_03_20_082440.jpg,352.5,135.0,0.55078125,0.375,0.0359375,0.08888888888888889
9706-2021_03_20_082440.jpg,car,35,316,640,38,360,181,1,351,219,LTAdatasets/9706/annotate/9706-2021_03_20_082440.jpg,333.5,200.0,0.52109375,0.5555555555555556,0.0546875,0.10555555555555556
9706-2021_03_20_082440.jpg,car,28,200,640,29,360,219,1,228,248,LTAdatasets/9706/annotate/9706-2021_03_20_082440.jpg,214.0,233.5,0.334375,0.6486111111111111,0.04375,0.08055555555555556
9706-2021_03_20_082440.jpg,car,22,295,640,16,360,89,1,317,105,LTAdatasets/9706/annotate/9706-2021_03_20_082440.jpg,306.0,97.0,0.478125,0.26944444444444443,0.034375,0.044444444444444446
9706-2021_03_20_082440.jpg,bike,13,313,640,14,360,84,4,326,98,LTAdatasets/9706/annotate/9706-2021_03_20_082440.jpg,319.5,91.0,0.49921875,0.25277777777777777,0.0203125,0.03888888888888889
9706-2021_03_20_082440.jpg,lorry_truck,40,97,640,56,360,183,2,137,239,LTAdatasets/9706/annotate/9706-2021_03_20_082440.jpg,117.0,211.0,0.1828125,0.5861111111111111,0.0625,0.15555555555555556
9706-2021_03_20_082440.jpg,car,24,192,640,23,360,115,1,216,138,LTAdatasets/9706/annotate/9706-2021_03_20_082440.jpg,204.0,126.5,0.31875,0.35138888888888886,0.0375,0.06388888888888888
9706-2021_03_20_082440.jpg,bike,9,225,640,15,360,101,4,234,116,LTAdatasets/9706/annotate/9706-2021_03_20_082440.jpg,229.5,108.5,0.35859375,0.3013888888888889,0.0140625,0.041666666666666664
9706-2021_03_20_082440.jpg,car,15,238,640,14,360,79,1,253,93,LTAdatasets/9706/annotate/9706-2021_03_20_082440.jpg,245.5,86.0,0.38359375,0.2388888888888889,0.0234375,0.03888888888888889
9706-2021_03_20_082440.jpg,lorry_truck,11,214,640,14,360,83,2,225,97,LTAdatasets/9706/annotate/9706-2021_03_20_082440.jpg,219.5,90.0,0.34296875,0.25,0.0171875,0.03888888888888889
9706-2021_03_20_082440.jpg,car,10,294,640,11,360,72,1,304,83,LTAdatasets/9706/annotate/9706-2021_03_20_082440.jpg,299.0,77.5,0.4671875,0.2152777777777778,0.015625,0.030555555555555555
9706-2021_03_20_082440.jpg,car,12,240,640,9,360,64,1,252,73,LTAdatasets/9706/annotate/9706-2021_03_20_082440.jpg,246.0,68.5,0.384375,0.19027777777777777,0.01875,0.025
9706-2021_03_20_082440.jpg,car,6,215,640,6,360,59,1,221,65,LTAdatasets/9706/annotate/9706-2021_03_20_082440.jpg,218.0,62.0,0.340625,0.17222222222222222,0.009375,0.016666666666666666
9706-2021_03_20_082440.jpg,van,12,286,640,12,360,49,3,298,61,LTAdatasets/9706/annotate/9706-2021_03_20_082440.jpg,292.0,55.0,0.45625,0.1527777777777778,0.01875,0.03333333333333333
9706-2021_03_20_082440.jpg,van,14,292,640,15,360,44,3,306,59,LTAdatasets/9706/annotate/9706-2021_03_20_082440.jpg,299.0,51.5,0.4671875,0.14305555555555555,0.021875,0.041666666666666664
9706-2021_03_20_082440.jpg,van,11,224,640,10,360,54,3,235,64,LTAdatasets/9706/annotate/9706-2021_03_20_082440.jpg,229.5,59.0,0.35859375,0.1638888888888889,0.0171875,0.027777777777777776
9706-2021_03_20_082440.jpg,lorry_truck,13,207,640,11,360,49,2,220,60,LTAdatasets/9706/annotate/9706-2021_03_20_082440.jpg,213.5,54.5,0.33359375,0.15138888888888888,0.0203125,0.030555555555555555
9706-2021_03_20_081319.jpg,bike,20,353,640,35,360,252,4,373,287,LTAdatasets/9706/annotate/9706-2021_03_20_081319.jpg,363.0,269.5,0.5671875,0.7486111111111111,0.03125,0.09722222222222222
9706-2021_03_20_081319.jpg,van,48,419,640,83,360,264,3,467,347,LTAdatasets/9706/annotate/9706-2021_03_20_081319.jpg,443.0,305.5,0.6921875,0.8486111111111111,0.075,0.23055555555555557
9706-2021_03_20_081319.jpg,lorry_truck,13,204,640,21,360,51,2,217,72,LTAdatasets/9706/annotate/9706-2021_03_20_081319.jpg,210.5,61.5,0.32890625,0.17083333333333334,0.0203125,0.058333333333333334
9706-2021_03_20_081319.jpg,lorry_truck,11,222,640,20,360,68,2,233,88,LTAdatasets/9706/annotate/9706-2021_03_20_081319.jpg,227.5,78.0,0.35546875,0.21666666666666667,0.0171875,0.05555555555555555
9706-2021_03_20_081319.jpg,lorry_truck,11,304,640,14,360,38,2,315,52,LTAdatasets/9706/annotate/9706-2021_03_20_081319.jpg,309.5,45.0,0.48359375,0.125,0.0171875,0.03888888888888889
9706-2021_03_20_081319.jpg,bike,9,297,640,10,360,78,4,306,88,LTAdatasets/9706/annotate/9706-2021_03_20_081319.jpg,301.5,83.0,0.47109375,0.23055555555555557,0.0140625,0.027777777777777776
9706-2021_03_20_081319.jpg,bike,19,317,640,16,360,82,4,336,98,LTAdatasets/9706/annotate/9706-2021_03_20_081319.jpg,326.5,90.0,0.51015625,0.25,0.0296875,0.044444444444444446
9706-2021_03_20_081319.jpg,bike,14,189,640,22,360,133,4,203,155,LTAdatasets/9706/annotate/9706-2021_03_20_081319.jpg,196.0,144.0,0.30625,0.4,0.021875,0.06111111111111111
9706-2021_03_20_081319.jpg,bike,20,145,640,22,360,141,4,165,163,LTAdatasets/9706/annotate/9706-2021_03_20_081319.jpg,155.0,152.0,0.2421875,0.4222222222222222,0.03125,0.06111111111111111
9706-2021_03_20_081319.jpg,bike,21,150,640,37,360,201,4,171,238,LTAdatasets/9706/annotate/9706-2021_03_20_081319.jpg,160.5,219.5,0.25078125,0.6097222222222223,0.0328125,0.10277777777777777
9706-2021_03_20_081319.jpg,bike,12,286,640,8,360,59,4,298,67,LTAdatasets/9706/annotate/9706-2021_03_20_081319.jpg,292.0,63.0,0.45625,0.175,0.01875,0.022222222222222223
9706-2021_03_20_081319.jpg,van,16,209,640,16,360,87,3,225,103,LTAdatasets/9706/annotate/9706-2021_03_20_081319.jpg,217.0,95.0,0.3390625,0.2638888888888889,0.025,0.044444444444444446
9706-2021_03_20_081319.jpg,car,10,291,640,11,360,48,1,301,59,LTAdatasets/9706/annotate/9706-2021_03_20_081319.jpg,296.0,53.5,0.4625,0.1486111111111111,0.015625,0.030555555555555555
9706-2021_03_20_081319.jpg,lorry_truck,14,208,640,8,360,44,2,222,52,LTAdatasets/9706/annotate/9706-2021_03_20_081319.jpg,215.0,48.0,0.3359375,0.13333333333333333,0.021875,0.022222222222222223
9706-2021_03_20_085501.jpg,lorry_truck,38,439,640,48,360,212,2,477,260,LTAdatasets/9706/annotate/9706-2021_03_20_085501.jpg,458.0,236.0,0.715625,0.6555555555555556,0.059375,0.13333333333333333
9706-2021_03_20_085501.jpg,lorry_truck,39,131,640,45,360,118,2,170,163,LTAdatasets/9706/annotate/9706-2021_03_20_085501.jpg,150.5,140.5,0.23515625,0.3902777777777778,0.0609375,0.125
9706-2021_03_20_085501.jpg,lorry_truck,14,334,640,34,360,60,2,348,94,LTAdatasets/9706/annotate/9706-2021_03_20_085501.jpg,341.0,77.0,0.5328125,0.21388888888888888,0.021875,0.09444444444444444
9706-2021_03_20_085501.jpg,lorry_truck,14,197,640,19,360,66,2,211,85,LTAdatasets/9706/annotate/9706-2021_03_20_085501.jpg,204.0,75.5,0.31875,0.20972222222222223,0.021875,0.05277777777777778
9706-2021_03_20_085501.jpg,lorry_truck,63,2,640,48,360,311,2,65,359,LTAdatasets/9706/annotate/9706-2021_03_20_085501.jpg,33.5,335.0,0.05234375,0.9305555555555556,0.0984375,0.13333333333333333
9706-2021_03_20_085501.jpg,van,19,186,640,24,360,144,3,205,168,LTAdatasets/9706/annotate/9706-2021_03_20_085501.jpg,195.5,156.0,0.30546875,0.43333333333333335,0.0296875,0.06666666666666667
9706-2021_03_20_085501.jpg,van,9,221,640,12,360,62,3,230,74,LTAdatasets/9706/annotate/9706-2021_03_20_085501.jpg,225.5,68.0,0.35234375,0.18888888888888888,0.0140625,0.03333333333333333
9706-2021_03_20_085501.jpg,van,9,227,640,9,360,54,3,236,63,LTAdatasets/9706/annotate/9706-2021_03_20_085501.jpg,231.5,58.5,0.36171875,0.1625,0.0140625,0.025
9706-2021_03_20_085501.jpg,car,15,232,640,15,360,112,1,247,127,LTAdatasets/9706/annotate/9706-2021_03_20_085501.jpg,239.5,119.5,0.37421875,0.33194444444444443,0.0234375,0.041666666666666664
9706-2021_03_20_085501.jpg,car,17,348,640,26,360,136,1,365,162,LTAdatasets/9706/annotate/9706-2021_03_20_085501.jpg,356.5,149.0,0.55703125,0.41388888888888886,0.0265625,0.07222222222222222
9706-2021_03_20_085501.jpg,car,17,305,640,18,360,130,1,322,148,LTAdatasets/9706/annotate/9706-2021_03_20_085501.jpg,313.5,139.0,0.48984375,0.3861111111111111,0.0265625,0.05
9706-2021_03_20_085501.jpg,bike,10,309,640,15,360,102,4,319,117,LTAdatasets/9706/annotate/9706-2021_03_20_085501.jpg,314.0,109.5,0.490625,0.30416666666666664,0.015625,0.041666666666666664
9706-2021_03_20_085501.jpg,bike,8,312,640,11,360,51,4,320,62,LTAdatasets/9706/annotate/9706-2021_03_20_085501.jpg,316.0,56.5,0.49375,0.15694444444444444,0.0125,0.030555555555555555
9706-2021_03_20_085501.jpg,lorry_truck,17,209,640,15,360,87,2,226,102,LTAdatasets/9706/annotate/9706-2021_03_20_085501.jpg,217.5,94.5,0.33984375,0.2625,0.0265625,0.041666666666666664
9706-2021_03_20_085501.jpg,car,17,301,640,12,360,58,1,318,70,LTAdatasets/9706/annotate/9706-2021_03_20_085501.jpg,309.5,64.0,0.48359375,0.17777777777777778,0.0265625,0.03333333333333333
9706-2021_03_20_085501.jpg,car,12,296,640,10,360,49,1,308,59,LTAdatasets/9706/annotate/9706-2021_03_20_085501.jpg,302.0,54.0,0.471875,0.15,0.01875,0.027777777777777776
9706-2021_03_20_085501.jpg,car,5,244,640,8,360,52,1,249,60,LTAdatasets/9706/annotate/9706-2021_03_20_085501.jpg,246.5,56.0,0.38515625,0.15555555555555556,0.0078125,0.022222222222222223
9706-2021_03_20_085501.jpg,car,9,212,640,10,360,47,1,221,57,LTAdatasets/9706/annotate/9706-2021_03_20_085501.jpg,216.5,52.0,0.33828125,0.14444444444444443,0.0140625,0.027777777777777776
9706-2021_03_20_190113.jpg,car,36,317,640,46,360,193,1,353,239,LTAdatasets/9706/annotate/9706-2021_03_20_190113.jpg,335.0,216.0,0.5234375,0.6,0.05625,0.12777777777777777
9706-2021_03_20_190113.jpg,lorry_truck,32,401,640,46,360,155,2,433,201,LTAdatasets/9706/annotate/9706-2021_03_20_190113.jpg,417.0,178.0,0.6515625,0.49444444444444446,0.05,0.12777777777777777
9706-2021_03_20_190113.jpg,lorry_truck,36,169,640,35,360,135,2,205,170,LTAdatasets/9706/annotate/9706-2021_03_20_190113.jpg,187.0,152.5,0.2921875,0.4236111111111111,0.05625,0.09722222222222222
9706-2021_03_20_190113.jpg,lorry_truck,26,176,640,30,360,87,2,202,117,LTAdatasets/9706/annotate/9706-2021_03_20_190113.jpg,189.0,102.0,0.2953125,0.2833333333333333,0.040625,0.08333333333333333
9706-2021_03_20_190113.jpg,lorry_truck,29,126,640,33,360,152,2,155,185,LTAdatasets/9706/annotate/9706-2021_03_20_190113.jpg,140.5,168.5,0.21953125,0.46805555555555556,0.0453125,0.09166666666666666
9706-2021_03_20_190113.jpg,van,24,333,640,17,360,111,3,357,128,LTAdatasets/9706/annotate/9706-2021_03_20_190113.jpg,345.0,119.5,0.5390625,0.33194444444444443,0.0375,0.04722222222222222
9706-2021_03_20_190113.jpg,lorry_truck,17,316,640,18,360,76,2,333,94,LTAdatasets/9706/annotate/9706-2021_03_20_190113.jpg,324.5,85.0,0.50703125,0.2361111111111111,0.0265625,0.05
9706-2021_03_20_190113.jpg,car,15,290,640,9,360,61,1,305,70,LTAdatasets/9706/annotate/9706-2021_03_20_190113.jpg,297.5,65.5,0.46484375,0.18194444444444444,0.0234375,0.025
9706-2021_03_20_190113.jpg,car,19,289,640,12,360,73,1,308,85,LTAdatasets/9706/annotate/9706-2021_03_20_190113.jpg,298.5,79.0,0.46640625,0.21944444444444444,0.0296875,0.03333333333333333
9706-2021_03_20_190113.jpg,car,14,313,640,15,360,54,1,327,69,LTAdatasets/9706/annotate/9706-2021_03_20_190113.jpg,320.0,61.5,0.5,0.17083333333333334,0.021875,0.041666666666666664
9706-2021_03_20_190113.jpg,car,10,239,640,10,360,64,1,249,74,LTAdatasets/9706/annotate/9706-2021_03_20_190113.jpg,244.0,69.0,0.38125,0.19166666666666668,0.015625,0.027777777777777776
9706-2021_03_20_190113.jpg,car,14,234,640,10,360,47,1,248,57,LTAdatasets/9706/annotate/9706-2021_03_20_190113.jpg,241.0,52.0,0.3765625,0.14444444444444443,0.021875,0.027777777777777776
9706-2021_03_20_190113.jpg,bike,14,305,640,12,360,89,4,319,101,LTAdatasets/9706/annotate/9706-2021_03_20_190113.jpg,312.0,95.0,0.4875,0.2638888888888889,0.021875,0.03333333333333333
9706-2021_03_20_190113.jpg,lorry_truck,18,303,640,17,360,39,2,321,56,LTAdatasets/9706/annotate/9706-2021_03_20_190113.jpg,312.0,47.5,0.4875,0.13194444444444445,0.028125,0.04722222222222222
9706-2021_03_20_190113.jpg,car,8,285,640,10,360,38,1,293,48,LTAdatasets/9706/annotate/9706-2021_03_20_190113.jpg,289.0,43.0,0.4515625,0.11944444444444445,0.0125,0.027777777777777776
9706-2021_03_20_190113.jpg,bike,26,402,640,34,360,326,4,428,360,LTAdatasets/9706/annotate/9706-2021_03_20_190113.jpg,415.0,343.0,0.6484375,0.9527777777777777,0.040625,0.09444444444444444
9706-2021_03_20_201317.jpg,bike,25,441,640,58,360,290,4,466,348,LTAdatasets/9706/annotate/9706-2021_03_20_201317.jpg,453.5,319.0,0.70859375,0.8861111111111111,0.0390625,0.16111111111111112
9706-2021_03_20_201317.jpg,bus,26,324,640,31,360,51,5,350,82,LTAdatasets/9706/annotate/9706-2021_03_20_201317.jpg,337.0,66.5,0.5265625,0.18472222222222223,0.040625,0.08611111111111111
9706-2021_03_20_201317.jpg,car,57,447,640,45,360,241,1,504,286,LTAdatasets/9706/annotate/9706-2021_03_20_201317.jpg,475.5,263.5,0.74296875,0.7319444444444444,0.0890625,0.125
9706-2021_03_20_201317.jpg,car,34,145,640,39,360,214,1,179,253,LTAdatasets/9706/annotate/9706-2021_03_20_201317.jpg,162.0,233.5,0.253125,0.6486111111111111,0.053125,0.10833333333333334
9706-2021_03_20_201317.jpg,car,20,206,640,16,360,61,1,226,77,LTAdatasets/9706/annotate/9706-2021_03_20_201317.jpg,216.0,69.0,0.3375,0.19166666666666668,0.03125,0.044444444444444446
9706-2021_03_20_201317.jpg,car,11,243,640,11,360,54,1,254,65,LTAdatasets/9706/annotate/9706-2021_03_20_201317.jpg,248.5,59.5,0.38828125,0.16527777777777777,0.0171875,0.030555555555555555
9706-2021_03_20_201317.jpg,car,6,229,640,7,360,45,1,235,52,LTAdatasets/9706/annotate/9706-2021_03_20_201317.jpg,232.0,48.5,0.3625,0.13472222222222222,0.009375,0.019444444444444445
9706-2021_03_20_201317.jpg,car,11,286,640,11,360,43,1,297,54,LTAdatasets/9706/annotate/9706-2021_03_20_201317.jpg,291.5,48.5,0.45546875,0.13472222222222222,0.0171875,0.030555555555555555
9706-2021_03_20_201317.jpg,lorry_truck,68,44,640,86,360,217,2,112,303,LTAdatasets/9706/annotate/9706-2021_03_20_201317.jpg,78.0,260.0,0.121875,0.7222222222222222,0.10625,0.2388888888888889
9706-2021_03_20_090702.jpg,van,23,376,640,33,360,123,3,399,156,LTAdatasets/9706/annotate/9706-2021_03_20_090702.jpg,387.5,139.5,0.60546875,0.3875,0.0359375,0.09166666666666666
9706-2021_03_20_090702.jpg,lorry_truck,20,333,640,23,360,100,2,353,123,LTAdatasets/9706/annotate/9706-2021_03_20_090702.jpg,343.0,111.5,0.5359375,0.30972222222222223,0.03125,0.06388888888888888
9706-2021_03_20_090702.jpg,lorry_truck,49,29,640,65,360,284,2,78,349,LTAdatasets/9706/annotate/9706-2021_03_20_090702.jpg,53.5,316.5,0.08359375,0.8791666666666667,0.0765625,0.18055555555555555
9706-2021_03_20_090702.jpg,lorry_truck,9,202,640,19,360,65,2,211,84,LTAdatasets/9706/annotate/9706-2021_03_20_090702.jpg,206.5,74.5,0.32265625,0.20694444444444443,0.0140625,0.05277777777777778
9706-2021_03_20_090702.jpg,car,21,309,640,25,360,145,1,330,170,LTAdatasets/9706/annotate/9706-2021_03_20_090702.jpg,319.5,157.5,0.49921875,0.4375,0.0328125,0.06944444444444445
9706-2021_03_20_090702.jpg,car,28,351,640,40,360,144,1,379,184,LTAdatasets/9706/annotate/9706-2021_03_20_090702.jpg,365.0,164.0,0.5703125,0.45555555555555555,0.04375,0.1111111111111111
9706-2021_03_20_090702.jpg,bike,15,325,640,16,360,129,4,340,145,LTAdatasets/9706/annotate/9706-2021_03_20_090702.jpg,332.5,137.0,0.51953125,0.38055555555555554,0.0234375,0.044444444444444446
9706-2021_03_20_090702.jpg,van,12,298,640,10,360,52,3,310,62,LTAdatasets/9706/annotate/9706-2021_03_20_090702.jpg,304.0,57.0,0.475,0.15833333333333333,0.01875,0.027777777777777776
9706-2021_03_20_090702.jpg,car,14,313,640,8,360,51,1,327,59,LTAdatasets/9706/annotate/9706-2021_03_20_090702.jpg,320.0,55.0,0.5,0.1527777777777778,0.021875,0.022222222222222223
9706-2021_03_20_090702.jpg,lorry_truck,10,299,640,12,360,36,2,309,48,LTAdatasets/9706/annotate/9706-2021_03_20_090702.jpg,304.0,42.0,0.475,0.11666666666666667,0.015625,0.03333333333333333
9706-2021_03_20_090702.jpg,car,13,283,640,13,360,35,1,296,48,LTAdatasets/9706/annotate/9706-2021_03_20_090702.jpg,289.5,41.5,0.45234375,0.11527777777777778,0.0203125,0.03611111111111111
9706-2021_03_20_091903.jpg,car,57,339,640,49,360,311,1,396,360,LTAdatasets/9706/annotate/9706-2021_03_20_091903.jpg,367.5,335.5,0.57421875,0.9319444444444445,0.0890625,0.1361111111111111
9706-2021_03_20_091903.jpg,car,17,304,640,23,360,107,1,321,130,LTAdatasets/9706/annotate/9706-2021_03_20_091903.jpg,312.5,118.5,0.48828125,0.32916666666666666,0.0265625,0.06388888888888888
9706-2021_03_20_091903.jpg,car,17,293,640,17,360,70,1,310,87,LTAdatasets/9706/annotate/9706-2021_03_20_091903.jpg,301.5,78.5,0.47109375,0.21805555555555556,0.0265625,0.04722222222222222
9706-2021_03_20_091903.jpg,bike,9,317,640,11,360,80,4,326,91,LTAdatasets/9706/annotate/9706-2021_03_20_091903.jpg,321.5,85.5,0.50234375,0.2375,0.0140625,0.030555555555555555
9706-2021_03_20_091903.jpg,lorry_truck,30,378,640,30,360,126,2,408,156,LTAdatasets/9706/annotate/9706-2021_03_20_091903.jpg,393.0,141.0,0.6140625,0.39166666666666666,0.046875,0.08333333333333333
9706-2021_03_20_091903.jpg,lorry_truck,39,132,640,53,360,202,2,171,255,LTAdatasets/9706/annotate/9706-2021_03_20_091903.jpg,151.5,228.5,0.23671875,0.6347222222222222,0.0609375,0.14722222222222223
9706-2021_03_20_091903.jpg,lorry_truck,47,108,640,58,360,142,2,155,200,LTAdatasets/9706/annotate/9706-2021_03_20_091903.jpg,131.5,171.0,0.20546875,0.475,0.0734375,0.16111111111111112
9706-2021_03_20_091903.jpg,lorry_truck,79,479,640,118,360,242,2,558,360,LTAdatasets/9706/annotate/9706-2021_03_20_091903.jpg,518.5,301.0,0.81015625,0.8361111111111111,0.1234375,0.3277777777777778
9706-2021_03_20_091903.jpg,van,19,344,640,24,360,77,3,363,101,LTAdatasets/9706/annotate/9706-2021_03_20_091903.jpg,353.5,89.0,0.55234375,0.24722222222222223,0.0296875,0.06666666666666667
9706-2021_03_20_091903.jpg,car,15,324,640,12,360,63,1,339,75,LTAdatasets/9706/annotate/9706-2021_03_20_091903.jpg,331.5,69.0,0.51796875,0.19166666666666668,0.0234375,0.03333333333333333
9706-2021_03_20_091903.jpg,van,12,203,640,11,360,62,3,215,73,LTAdatasets/9706/annotate/9706-2021_03_20_091903.jpg,209.0,67.5,0.3265625,0.1875,0.01875,0.030555555555555555
9706-2021_03_20_091903.jpg,car,8,241,640,9,360,48,1,249,57,LTAdatasets/9706/annotate/9706-2021_03_20_091903.jpg,245.0,52.5,0.3828125,0.14583333333333334,0.0125,0.025
9706-2021_03_20_091903.jpg,lorry_truck,10,222,640,13,360,49,2,232,62,LTAdatasets/9706/annotate/9706-2021_03_20_091903.jpg,227.0,55.5,0.3546875,0.15416666666666667,0.015625,0.03611111111111111
9706-2021_03_20_191014.jpg,car,31,369,640,41,360,163,1,400,204,LTAdatasets/9706/annotate/9706-2021_03_20_191014.jpg,384.5,183.5,0.60078125,0.5097222222222222,0.0484375,0.11388888888888889
9706-2021_03_20_191014.jpg,van,17,316,640,21,360,80,3,333,101,LTAdatasets/9706/annotate/9706-2021_03_20_191014.jpg,324.5,90.5,0.50703125,0.2513888888888889,0.0265625,0.058333333333333334
9706-2021_03_20_191014.jpg,bike,5,229,640,11,360,71,4,234,82,LTAdatasets/9706/annotate/9706-2021_03_20_191014.jpg,231.5,76.5,0.36171875,0.2125,0.0078125,0.030555555555555555
9706-2021_03_20_191014.jpg,bike,8,223,640,13,360,63,4,231,76,LTAdatasets/9706/annotate/9706-2021_03_20_191014.jpg,227.0,69.5,0.3546875,0.19305555555555556,0.0125,0.03611111111111111
9706-2021_03_20_191014.jpg,car,13,240,640,11,360,60,1,253,71,LTAdatasets/9706/annotate/9706-2021_03_20_191014.jpg,246.5,65.5,0.38515625,0.18194444444444444,0.0203125,0.030555555555555555
9706-2021_03_20_191014.jpg,car,10,194,640,16,360,77,1,204,93,LTAdatasets/9706/annotate/9706-2021_03_20_191014.jpg,199.0,85.0,0.3109375,0.2361111111111111,0.015625,0.044444444444444446
9706-2021_03_20_191014.jpg,car,14,296,640,17,360,87,1,310,104,LTAdatasets/9706/annotate/9706-2021_03_20_191014.jpg,303.0,95.5,0.4734375,0.2652777777777778,0.021875,0.04722222222222222
9706-2021_03_20_191014.jpg,lorry_truck,14,309,640,11,360,48,2,323,59,LTAdatasets/9706/annotate/9706-2021_03_20_191014.jpg,316.0,53.5,0.49375,0.1486111111111111,0.021875,0.030555555555555555
9706-2021_03_20_191014.jpg,lorry_truck,11,209,640,12,360,45,2,220,57,LTAdatasets/9706/annotate/9706-2021_03_20_191014.jpg,214.5,51.0,0.33515625,0.14166666666666666,0.0171875,0.03333333333333333
9706-2021_03_20_191014.jpg,lorry_truck,8,211,640,9,360,60,2,219,69,LTAdatasets/9706/annotate/9706-2021_03_20_191014.jpg,215.0,64.5,0.3359375,0.17916666666666667,0.0125,0.025
9706-2021_03_20_191014.jpg,lorry_truck,7,227,640,13,360,51,2,234,64,LTAdatasets/9706/annotate/9706-2021_03_20_191014.jpg,230.5,57.5,0.36015625,0.1597222222222222,0.0109375,0.03611111111111111
9706-2021_03_20_083640.jpg,lorry_truck,63,495,640,75,360,285,2,558,360,LTAdatasets/9706/annotate/9706-2021_03_20_083640.jpg,526.5,322.5,0.82265625,0.8958333333333334,0.0984375,0.20833333333333334
9706-2021_03_20_083640.jpg,car,43,370,640,44,360,194,1,413,238,LTAdatasets/9706/annotate/9706-2021_03_20_083640.jpg,391.5,216.0,0.61171875,0.6,0.0671875,0.12222222222222222
9706-2021_03_20_083640.jpg,lorry_truck,15,321,640,26,360,69,2,336,95,LTAdatasets/9706/annotate/9706-2021_03_20_083640.jpg,328.5,82.0,0.51328125,0.22777777777777777,0.0234375,0.07222222222222222
9706-2021_03_20_083640.jpg,lorry_truck,12,322,640,18,360,56,2,334,74,LTAdatasets/9706/annotate/9706-2021_03_20_083640.jpg,328.0,65.0,0.5125,0.18055555555555555,0.01875,0.05
9706-2021_03_20_083640.jpg,car,26,156,640,35,360,187,1,182,222,LTAdatasets/9706/annotate/9706-2021_03_20_083640.jpg,169.0,204.5,0.2640625,0.5680555555555555,0.040625,0.09722222222222222
9706-2021_03_20_083640.jpg,car,19,148,640,19,360,140,1,167,159,LTAdatasets/9706/annotate/9706-2021_03_20_083640.jpg,157.5,149.5,0.24609375,0.4152777777777778,0.0296875,0.05277777777777778
9706-2021_03_20_083640.jpg,car,15,237,640,12,360,68,1,252,80,LTAdatasets/9706/annotate/9706-2021_03_20_083640.jpg,244.5,74.0,0.38203125,0.20555555555555555,0.0234375,0.03333333333333333
9706-2021_03_20_083640.jpg,car,8,238,640,6,360,52,1,246,58,LTAdatasets/9706/annotate/9706-2021_03_20_083640.jpg,242.0,55.0,0.378125,0.1527777777777778,0.0125,0.016666666666666666
9706-2021_03_20_083640.jpg,car,8,301,640,9,360,42,1,309,51,LTAdatasets/9706/annotate/9706-2021_03_20_083640.jpg,305.0,46.5,0.4765625,0.12916666666666668,0.0125,0.025
9706-2021_03_20_083640.jpg,van,14,220,640,17,360,65,3,234,82,LTAdatasets/9706/annotate/9706-2021_03_20_083640.jpg,227.0,73.5,0.3546875,0.20416666666666666,0.021875,0.04722222222222222
9706-2021_03_20_083640.jpg,lorry_truck,24,172,640,26,360,90,2,196,116,LTAdatasets/9706/annotate/9706-2021_03_20_083640.jpg,184.0,103.0,0.2875,0.2861111111111111,0.0375,0.07222222222222222
9706-2021_03_20_083640.jpg,lorry_truck,18,204,640,14,360,52,2,222,66,LTAdatasets/9706/annotate/9706-2021_03_20_083640.jpg,213.0,59.0,0.3328125,0.1638888888888889,0.028125,0.03888888888888889
9706-2021_03_20_094605.jpg,van,29,58,640,53,360,259,3,87,312,LTAdatasets/9706/annotate/9706-2021_03_20_094605.jpg,72.5,285.5,0.11328125,0.7930555555555555,0.0453125,0.14722222222222223
9706-2021_03_20_094605.jpg,car,27,203,640,27,360,206,1,230,233,LTAdatasets/9706/annotate/9706-2021_03_20_094605.jpg,216.5,219.5,0.33828125,0.6097222222222223,0.0421875,0.075
9706-2021_03_20_094605.jpg,car,14,196,640,15,360,118,1,210,133,LTAdatasets/9706/annotate/9706-2021_03_20_094605.jpg,203.0,125.5,0.3171875,0.3486111111111111,0.021875,0.041666666666666664
9706-2021_03_20_094605.jpg,car,12,237,640,13,360,92,1,249,105,LTAdatasets/9706/annotate/9706-2021_03_20_094605.jpg,243.0,98.5,0.3796875,0.27361111111111114,0.01875,0.03611111111111111
9706-2021_03_20_094605.jpg,car,26,361,640,22,360,128,1,387,150,LTAdatasets/9706/annotate/9706-2021_03_20_094605.jpg,374.0,139.0,0.584375,0.3861111111111111,0.040625,0.06111111111111111
9706-2021_03_20_094605.jpg,lorry_truck,14,307,640,15,360,65,2,321,80,LTAdatasets/9706/annotate/9706-2021_03_20_094605.jpg,314.0,72.5,0.490625,0.2013888888888889,0.021875,0.041666666666666664
9706-2021_03_20_094605.jpg,lorry_truck,30,343,640,29,360,81,2,373,110,LTAdatasets/9706/annotate/9706-2021_03_20_094605.jpg,358.0,95.5,0.559375,0.2652777777777778,0.046875,0.08055555555555556
9706-2021_03_20_094605.jpg,lorry_truck,36,379,640,45,360,193,2,415,238,LTAdatasets/9706/annotate/9706-2021_03_20_094605.jpg,397.0,215.5,0.6203125,0.5986111111111111,0.05625,0.125
9706-2021_03_20_094605.jpg,lorry_truck,33,143,640,46,360,188,2,176,234,LTAdatasets/9706/annotate/9706-2021_03_20_094605.jpg,159.5,211.0,0.24921875,0.5861111111111111,0.0515625,0.12777777777777777
9706-2021_03_20_094605.jpg,lorry_truck,29,120,640,36,360,162,2,149,198,LTAdatasets/9706/annotate/9706-2021_03_20_094605.jpg,134.5,180.0,0.21015625,0.5,0.0453125,0.1
9706-2021_03_20_094605.jpg,lorry_truck,17,194,640,33,360,62,2,211,95,LTAdatasets/9706/annotate/9706-2021_03_20_094605.jpg,202.5,78.5,0.31640625,0.21805555555555556,0.0265625,0.09166666666666666
9706-2021_03_20_094605.jpg,car,12,222,640,10,360,64,1,234,74,LTAdatasets/9706/annotate/9706-2021_03_20_094605.jpg,228.0,69.0,0.35625,0.19166666666666668,0.01875,0.027777777777777776
9706-2021_03_20_094605.jpg,car,13,288,640,9,360,44,1,301,53,LTAdatasets/9706/annotate/9706-2021_03_20_094605.jpg,294.5,48.5,0.46015625,0.13472222222222222,0.0203125,0.025
9706-2021_03_20_094605.jpg,car,6,228,640,9,360,39,1,234,48,LTAdatasets/9706/annotate/9706-2021_03_20_094605.jpg,231.0,43.5,0.3609375,0.12083333333333333,0.009375,0.025
9706-2021_03_20_185153.jpg,bike,20,166,640,25,360,185,4,186,210,LTAdatasets/9706/annotate/9706-2021_03_20_185153.jpg,176.0,197.5,0.275,0.5486111111111112,0.03125,0.06944444444444445
9706-2021_03_20_185153.jpg,bike,8,317,640,15,360,101,4,325,116,LTAdatasets/9706/annotate/9706-2021_03_20_185153.jpg,321.0,108.5,0.5015625,0.3013888888888889,0.0125,0.041666666666666664
9706-2021_03_20_185153.jpg,bike,10,204,640,18,360,109,4,214,127,LTAdatasets/9706/annotate/9706-2021_03_20_185153.jpg,209.0,118.0,0.3265625,0.3277777777777778,0.015625,0.05
9706-2021_03_20_185153.jpg,lorry_truck,25,358,640,31,360,146,2,383,177,LTAdatasets/9706/annotate/9706-2021_03_20_185153.jpg,370.5,161.5,0.57890625,0.4486111111111111,0.0390625,0.08611111111111111
9706-2021_03_20_185153.jpg,lorry_truck,40,56,640,74,360,241,2,96,315,LTAdatasets/9706/annotate/9706-2021_03_20_185153.jpg,76.0,278.0,0.11875,0.7722222222222223,0.0625,0.20555555555555555
9706-2021_03_20_185153.jpg,lorry_truck,8,220,640,21,360,74,2,228,95,LTAdatasets/9706/annotate/9706-2021_03_20_185153.jpg,224.0,84.5,0.35,0.23472222222222222,0.0125,0.058333333333333334
9706-2021_03_20_185153.jpg,car,8,309,640,10,360,61,1,317,71,LTAdatasets/9706/annotate/9706-2021_03_20_185153.jpg,313.0,66.0,0.4890625,0.18333333333333332,0.0125,0.027777777777777776
9706-2021_03_20_185153.jpg,car,11,238,640,9,360,70,1,249,79,LTAdatasets/9706/annotate/9706-2021_03_20_185153.jpg,243.5,74.5,0.38046875,0.20694444444444443,0.0171875,0.025
9706-2021_03_20_185153.jpg,car,11,226,640,8,360,56,1,237,64,LTAdatasets/9706/annotate/9706-2021_03_20_185153.jpg,231.5,60.0,0.36171875,0.16666666666666666,0.0171875,0.022222222222222223
9706-2021_03_20_185153.jpg,car,11,209,640,9,360,57,1,220,66,LTAdatasets/9706/annotate/9706-2021_03_20_185153.jpg,214.5,61.5,0.33515625,0.17083333333333334,0.0171875,0.025
9706-2021_03_20_185153.jpg,car,6,226,640,6,360,39,1,232,45,LTAdatasets/9706/annotate/9706-2021_03_20_185153.jpg,229.0,42.0,0.3578125,0.11666666666666667,0.009375,0.016666666666666666
9706-2021_03_20_203358.jpg,van,41,390,640,60,360,219,3,431,279,LTAdatasets/9706/annotate/9706-2021_03_20_203358.jpg,410.5,249.0,0.64140625,0.6916666666666667,0.0640625,0.16666666666666666
9706-2021_03_20_203358.jpg,van,22,341,640,29,360,118,3,363,147,LTAdatasets/9706/annotate/9706-2021_03_20_203358.jpg,352.0,132.5,0.55,0.3680555555555556,0.034375,0.08055555555555556
9706-2021_03_20_203358.jpg,lorry_truck,16,321,640,19,360,81,2,337,100,LTAdatasets/9706/annotate/9706-2021_03_20_203358.jpg,329.0,90.5,0.5140625,0.2513888888888889,0.025,0.05277777777777778
9706-2021_03_20_203358.jpg,lorry_truck,19,326,640,14,360,65,2,345,79,LTAdatasets/9706/annotate/9706-2021_03_20_203358.jpg,335.5,72.0,0.52421875,0.2,0.0296875,0.03888888888888889
9706-2021_03_20_203358.jpg,lorry_truck,35,359,640,37,360,99,2,394,136,LTAdatasets/9706/annotate/9706-2021_03_20_203358.jpg,376.5,117.5,0.58828125,0.3263888888888889,0.0546875,0.10277777777777777
9706-2021_03_20_203358.jpg,car,11,238,640,11,360,73,1,249,84,LTAdatasets/9706/annotate/9706-2021_03_20_203358.jpg,243.5,78.5,0.38046875,0.21805555555555556,0.0171875,0.030555555555555555
9706-2021_03_20_203358.jpg,car,10,211,640,9,360,50,1,221,59,LTAdatasets/9706/annotate/9706-2021_03_20_203358.jpg,216.0,54.5,0.3375,0.15138888888888888,0.015625,0.025
9706-2021_03_20_080719.jpg,lorry_truck,41,388,640,69,360,199,2,429,268,LTAdatasets/9706/annotate/9706-2021_03_20_080719.jpg,408.5,233.5,0.63828125,0.6486111111111111,0.0640625,0.19166666666666668
9706-2021_03_20_080719.jpg,lorry_truck,42,380,640,57,360,112,2,422,169,LTAdatasets/9706/annotate/9706-2021_03_20_080719.jpg,401.0,140.5,0.6265625,0.3902777777777778,0.065625,0.15833333333333333
9706-2021_03_20_080719.jpg,lorry_truck,11,327,640,17,360,87,2,338,104,LTAdatasets/9706/annotate/9706-2021_03_20_080719.jpg,332.5,95.5,0.51953125,0.2652777777777778,0.0171875,0.04722222222222222
9706-2021_03_20_080719.jpg,lorry_truck,16,323,640,19,360,51,2,339,70,LTAdatasets/9706/annotate/9706-2021_03_20_080719.jpg,331.0,60.5,0.5171875,0.16805555555555557,0.025,0.05277777777777778
9706-2021_03_20_080719.jpg,lorry_truck,18,192,640,20,360,65,2,210,85,LTAdatasets/9706/annotate/9706-2021_03_20_080719.jpg,201.0,75.0,0.3140625,0.20833333333333334,0.028125,0.05555555555555555
9706-2021_03_20_080719.jpg,car,24,108,640,30,360,189,1,132,219,LTAdatasets/9706/annotate/9706-2021_03_20_080719.jpg,120.0,204.0,0.1875,0.5666666666666667,0.0375,0.08333333333333333
9706-2021_03_20_080719.jpg,car,29,116,640,48,360,257,1,145,305,LTAdatasets/9706/annotate/9706-2021_03_20_080719.jpg,130.5,281.0,0.20390625,0.7805555555555556,0.0453125,0.13333333333333333
9706-2021_03_20_080719.jpg,van,19,171,640,21,360,106,3,190,127,LTAdatasets/9706/annotate/9706-2021_03_20_080719.jpg,180.5,116.5,0.28203125,0.3236111111111111,0.0296875,0.058333333333333334
9706-2021_03_20_080719.jpg,van,18,196,640,21,360,115,3,214,136,LTAdatasets/9706/annotate/9706-2021_03_20_080719.jpg,205.0,125.5,0.3203125,0.3486111111111111,0.028125,0.058333333333333334
9706-2021_03_20_080719.jpg,bike,9,291,640,12,360,76,4,300,88,LTAdatasets/9706/annotate/9706-2021_03_20_080719.jpg,295.5,82.0,0.46171875,0.22777777777777777,0.0140625,0.03333333333333333
9706-2021_03_20_080719.jpg,bike,13,284,640,9,360,59,4,297,68,LTAdatasets/9706/annotate/9706-2021_03_20_080719.jpg,290.5,63.5,0.45390625,0.1763888888888889,0.0203125,0.025
9706-2021_03_20_080719.jpg,car,12,240,640,15,360,78,1,252,93,LTAdatasets/9706/annotate/9706-2021_03_20_080719.jpg,246.0,85.5,0.384375,0.2375,0.01875,0.041666666666666664
9706-2021_03_20_080719.jpg,car,10,219,640,16,360,72,1,229,88,LTAdatasets/9706/annotate/9706-2021_03_20_080719.jpg,224.0,80.0,0.35,0.2222222222222222,0.015625,0.044444444444444446
9706-2021_03_20_080719.jpg,car,8,316,640,14,360,76,1,324,90,LTAdatasets/9706/annotate/9706-2021_03_20_080719.jpg,320.0,83.0,0.5,0.23055555555555557,0.0125,0.03888888888888889
9706-2021_03_20_080719.jpg,car,9,297,640,13,360,48,1,306,61,LTAdatasets/9706/annotate/9706-2021_03_20_080719.jpg,301.5,54.5,0.47109375,0.15138888888888888,0.0140625,0.03611111111111111
9706-2021_03_20_080719.jpg,lorry_truck,14,205,640,7,360,59,2,219,66,LTAdatasets/9706/annotate/9706-2021_03_20_080719.jpg,212.0,62.5,0.33125,0.1736111111111111,0.021875,0.019444444444444445
9706-2021_03_20_080719.jpg,car,16,238,640,7,360,45,1,254,52,LTAdatasets/9706/annotate/9706-2021_03_20_080719.jpg,246.0,48.5,0.384375,0.13472222222222222,0.025,0.019444444444444445
9706-2021_03_20_080719.jpg,car,15,223,640,12,360,46,1,238,58,LTAdatasets/9706/annotate/9706-2021_03_20_080719.jpg,230.5,52.0,0.36015625,0.14444444444444443,0.0234375,0.03333333333333333
9706-2021_03_20_183952.jpg,lorry_truck,39,37,640,73,360,287,2,76,360,LTAdatasets/9706/annotate/9706-2021_03_20_183952.jpg,56.5,323.5,0.08828125,0.8986111111111111,0.0609375,0.20277777777777778
9706-2021_03_20_183952.jpg,van,21,324,640,18,360,90,3,345,108,LTAdatasets/9706/annotate/9706-2021_03_20_183952.jpg,334.5,99.0,0.52265625,0.275,0.0328125,0.05
9706-2021_03_20_183952.jpg,car,11,294,640,15,360,76,1,305,91,LTAdatasets/9706/annotate/9706-2021_03_20_183952.jpg,299.5,83.5,0.46796875,0.23194444444444445,0.0171875,0.041666666666666664
9706-2021_03_20_183952.jpg,car,13,315,640,11,360,72,1,328,83,LTAdatasets/9706/annotate/9706-2021_03_20_183952.jpg,321.5,77.5,0.50234375,0.2152777777777778,0.0203125,0.030555555555555555
9706-2021_03_20_183952.jpg,car,10,223,640,9,360,82,1,233,91,LTAdatasets/9706/annotate/9706-2021_03_20_183952.jpg,228.0,86.5,0.35625,0.24027777777777778,0.015625,0.025
9706-2021_03_20_183952.jpg,car,16,237,640,12,360,59,1,253,71,LTAdatasets/9706/annotate/9706-2021_03_20_183952.jpg,245.0,65.0,0.3828125,0.18055555555555555,0.025,0.03333333333333333
9706-2021_03_20_183952.jpg,car,13,304,640,8,360,58,1,317,66,LTAdatasets/9706/annotate/9706-2021_03_20_183952.jpg,310.5,62.0,0.48515625,0.17222222222222222,0.0203125,0.022222222222222223
9706-2021_03_20_183952.jpg,car,11,284,640,12,360,56,1,295,68,LTAdatasets/9706/annotate/9706-2021_03_20_183952.jpg,289.5,62.0,0.45234375,0.17222222222222222,0.0171875,0.03333333333333333
9706-2021_03_20_183952.jpg,van,12,210,640,11,360,57,3,222,68,LTAdatasets/9706/annotate/9706-2021_03_20_183952.jpg,216.0,62.5,0.3375,0.1736111111111111,0.01875,0.030555555555555555
9706-2021_03_20_182752.jpg,car,21,364,640,21,360,115,1,385,136,LTAdatasets/9706/annotate/9706-2021_03_20_182752.jpg,374.5,125.5,0.58515625,0.3486111111111111,0.0328125,0.058333333333333334
9706-2021_03_20_182752.jpg,car,12,298,640,16,360,82,1,310,98,LTAdatasets/9706/annotate/9706-2021_03_20_182752.jpg,304.0,90.0,0.475,0.25,0.01875,0.044444444444444446
9706-2021_03_20_182752.jpg,car,13,198,640,8,360,79,1,211,87,LTAdatasets/9706/annotate/9706-2021_03_20_182752.jpg,204.5,83.0,0.31953125,0.23055555555555557,0.0203125,0.022222222222222223
9706-2021_03_20_182752.jpg,car,8,223,640,9,360,69,1,231,78,LTAdatasets/9706/annotate/9706-2021_03_20_182752.jpg,227.0,73.5,0.3546875,0.20416666666666666,0.0125,0.025
9706-2021_03_20_182752.jpg,lorry_truck,17,316,640,16,360,47,2,333,63,LTAdatasets/9706/annotate/9706-2021_03_20_182752.jpg,324.5,55.0,0.50703125,0.1527777777777778,0.0265625,0.044444444444444446
9706-2021_03_20_182752.jpg,van,16,191,640,23,360,125,3,207,148,LTAdatasets/9706/annotate/9706-2021_03_20_182752.jpg,199.0,136.5,0.3109375,0.37916666666666665,0.025,0.06388888888888888
9706-2021_03_20_182752.jpg,van,9,224,640,10,360,54,3,233,64,LTAdatasets/9706/annotate/9706-2021_03_20_182752.jpg,228.5,59.0,0.35703125,0.1638888888888889,0.0140625,0.027777777777777776
9706-2021_03_20_182752.jpg,car,8,305,640,10,360,44,1,313,54,LTAdatasets/9706/annotate/9706-2021_03_20_182752.jpg,309.0,49.0,0.4828125,0.1361111111111111,0.0125,0.027777777777777776
9706-2021_03_20_191914.jpg,car,43,331,640,65,360,216,1,374,281,LTAdatasets/9706/annotate/9706-2021_03_20_191914.jpg,352.5,248.5,0.55078125,0.6902777777777778,0.0671875,0.18055555555555555
9706-2021_03_20_191914.jpg,car,34,124,640,46,360,228,1,158,274,LTAdatasets/9706/annotate/9706-2021_03_20_191914.jpg,141.0,251.0,0.2203125,0.6972222222222222,0.053125,0.12777777777777777
9706-2021_03_20_191914.jpg,car,23,306,640,27,360,118,1,329,145,LTAdatasets/9706/annotate/9706-2021_03_20_191914.jpg,317.5,131.5,0.49609375,0.36527777777777776,0.0359375,0.075
9706-2021_03_20_191914.jpg,car,16,313,640,15,360,70,1,329,85,LTAdatasets/9706/annotate/9706-2021_03_20_191914.jpg,321.0,77.5,0.5015625,0.2152777777777778,0.025,0.041666666666666664
9706-2021_03_20_191914.jpg,car,15,289,640,17,360,65,1,304,82,LTAdatasets/9706/annotate/9706-2021_03_20_191914.jpg,296.5,73.5,0.46328125,0.20416666666666666,0.0234375,0.04722222222222222
9706-2021_03_20_191914.jpg,lorry_truck,61,344,640,74,360,95,2,405,169,LTAdatasets/9706/annotate/9706-2021_03_20_191914.jpg,374.5,132.0,0.58515625,0.36666666666666664,0.0953125,0.20555555555555555
9706-2021_03_20_191914.jpg,lorry_truck,15,200,640,26,360,59,2,215,85,LTAdatasets/9706/annotate/9706-2021_03_20_191914.jpg,207.5,72.0,0.32421875,0.2,0.0234375,0.07222222222222222
9706-2021_03_20_191914.jpg,lorry_truck,28,341,640,14,360,80,2,369,94,LTAdatasets/9706/annotate/9706-2021_03_20_191914.jpg,355.0,87.0,0.5546875,0.24166666666666667,0.04375,0.03888888888888889
9706-2021_03_20_191914.jpg,bike,10,237,640,16,360,46,4,247,62,LTAdatasets/9706/annotate/9706-2021_03_20_191914.jpg,242.0,54.0,0.378125,0.15,0.015625,0.044444444444444446
9706-2021_03_20_100105.jpg,car,38,379,640,38,360,199,1,417,237,LTAdatasets/9706/annotate/9706-2021_03_20_100105.jpg,398.0,218.0,0.621875,0.6055555555555555,0.059375,0.10555555555555556
9706-2021_03_20_100105.jpg,car,34,315,640,35,360,162,1,349,197,LTAdatasets/9706/annotate/9706-2021_03_20_100105.jpg,332.0,179.5,0.51875,0.4986111111111111,0.053125,0.09722222222222222
9706-2021_03_20_100105.jpg,car,19,365,640,26,360,110,1,384,136,LTAdatasets/9706/annotate/9706-2021_03_20_100105.jpg,374.5,123.0,0.58515625,0.3416666666666667,0.0296875,0.07222222222222222
9706-2021_03_20_100105.jpg,car,17,330,640,22,360,104,1,347,126,LTAdatasets/9706/annotate/9706-2021_03_20_100105.jpg,338.5,115.0,0.52890625,0.3194444444444444,0.0265625,0.06111111111111111
9706-2021_03_20_100105.jpg,lorry_truck,57,57,640,66,360,214,2,114,280,LTAdatasets/9706/annotate/9706-2021_03_20_100105.jpg,85.5,247.0,0.13359375,0.6861111111111111,0.0890625,0.18333333333333332
9706-2021_03_20_100105.jpg,lorry_truck,16,204,640,20,360,102,2,220,122,LTAdatasets/9706/annotate/9706-2021_03_20_100105.jpg,212.0,112.0,0.33125,0.3111111111111111,0.025,0.05555555555555555
9706-2021_03_20_100105.jpg,lorry_truck,16,216,640,16,360,70,2,232,86,LTAdatasets/9706/annotate/9706-2021_03_20_100105.jpg,224.0,78.0,0.35,0.21666666666666667,0.025,0.044444444444444446
9706-2021_03_20_100105.jpg,lorry_truck,6,204,640,12,360,65,2,210,77,LTAdatasets/9706/annotate/9706-2021_03_20_100105.jpg,207.0,71.0,0.3234375,0.19722222222222222,0.009375,0.03333333333333333
9706-2021_03_20_100105.jpg,lorry_truck,14,311,640,11,360,65,2,325,76,LTAdatasets/9706/annotate/9706-2021_03_20_100105.jpg,318.0,70.5,0.496875,0.19583333333333333,0.021875,0.030555555555555555
9706-2021_03_20_100105.jpg,lorry_truck,12,298,640,8,360,58,2,310,66,LTAdatasets/9706/annotate/9706-2021_03_20_100105.jpg,304.0,62.0,0.475,0.17222222222222222,0.01875,0.022222222222222223
9706-2021_03_20_100105.jpg,lorry_truck,12,224,640,8,360,57,2,236,65,LTAdatasets/9706/annotate/9706-2021_03_20_100105.jpg,230.0,61.0,0.359375,0.16944444444444445,0.01875,0.022222222222222223
9706-2021_03_20_100105.jpg,bike,20,298,640,18,360,33,4,318,51,LTAdatasets/9706/annotate/9706-2021_03_20_100105.jpg,308.0,42.0,0.48125,0.11666666666666667,0.03125,0.05
9706-2021_03_20_181851.jpg,lorry_truck,32,176,640,59,360,230,2,208,289,LTAdatasets/9706/annotate/9706-2021_03_20_181851.jpg,192.0,259.5,0.3,0.7208333333333333,0.05,0.1638888888888889
9706-2021_03_20_181851.jpg,lorry_truck,76,413,640,87,360,180,2,489,267,LTAdatasets/9706/annotate/9706-2021_03_20_181851.jpg,451.0,223.5,0.7046875,0.6208333333333333,0.11875,0.24166666666666667
9706-2021_03_20_181851.jpg,lorry_truck,26,362,640,31,360,104,2,388,135,LTAdatasets/9706/annotate/9706-2021_03_20_181851.jpg,375.0,119.5,0.5859375,0.33194444444444443,0.040625,0.08611111111111111
9706-2021_03_20_181851.jpg,bike,12,325,640,12,360,94,4,337,106,LTAdatasets/9706/annotate/9706-2021_03_20_181851.jpg,331.0,100.0,0.5171875,0.2777777777777778,0.01875,0.03333333333333333
9706-2021_03_20_181851.jpg,car,38,328,640,56,360,221,1,366,277,LTAdatasets/9706/annotate/9706-2021_03_20_181851.jpg,347.0,249.0,0.5421875,0.6916666666666667,0.059375,0.15555555555555556
9706-2021_03_20_181851.jpg,car,22,309,640,20,360,134,1,331,154,LTAdatasets/9706/annotate/9706-2021_03_20_181851.jpg,320.0,144.0,0.5,0.4,0.034375,0.05555555555555555
9706-2021_03_20_181851.jpg,car,18,310,640,19,360,103,1,328,122,LTAdatasets/9706/annotate/9706-2021_03_20_181851.jpg,319.0,112.5,0.4984375,0.3125,0.028125,0.05277777777777778
9706-2021_03_20_181851.jpg,car,26,139,640,47,360,224,1,165,271,LTAdatasets/9706/annotate/9706-2021_03_20_181851.jpg,152.0,247.5,0.2375,0.6875,0.040625,0.13055555555555556
9706-2021_03_20_181851.jpg,car,43,31,640,58,360,302,1,74,360,LTAdatasets/9706/annotate/9706-2021_03_20_181851.jpg,52.5,331.0,0.08203125,0.9194444444444444,0.0671875,0.16111111111111112
9706-2021_03_20_181851.jpg,car,24,143,640,33,360,146,1,167,179,LTAdatasets/9706/annotate/9706-2021_03_20_181851.jpg,155.0,162.5,0.2421875,0.4513888888888889,0.0375,0.09166666666666666
9706-2021_03_20_181851.jpg,lorry_truck,12,196,640,23,360,73,2,208,96,LTAdatasets/9706/annotate/9706-2021_03_20_181851.jpg,202.0,84.5,0.315625,0.23472222222222222,0.01875,0.06388888888888888
9706-2021_03_20_181851.jpg,car,11,291,640,17,360,62,1,302,79,LTAdatasets/9706/annotate/9706-2021_03_20_181851.jpg,296.5,70.5,0.46328125,0.19583333333333333,0.0171875,0.04722222222222222
9706-2021_03_20_181851.jpg,car,9,300,640,10,360,50,1,309,60,LTAdatasets/9706/annotate/9706-2021_03_20_181851.jpg,304.5,55.0,0.47578125,0.1527777777777778,0.0140625,0.027777777777777776
9706-2021_03_20_181851.jpg,van,12,206,640,10,360,61,3,218,71,LTAdatasets/9706/annotate/9706-2021_03_20_181851.jpg,212.0,66.0,0.33125,0.18333333333333332,0.01875,0.027777777777777776
9706-2021_03_20_181851.jpg,lorry_truck,9,223,640,16,360,57,2,232,73,LTAdatasets/9706/annotate/9706-2021_03_20_181851.jpg,227.5,65.0,0.35546875,0.18055555555555555,0.0140625,0.044444444444444446
9706-2021_03_20_093424.jpg,bike,22,419,640,41,360,249,4,441,290,LTAdatasets/9706/annotate/9706-2021_03_20_093424.jpg,430.0,269.5,0.671875,0.7486111111111111,0.034375,0.11388888888888889
9706-2021_03_20_093424.jpg,lorry_truck,81,463,640,108,360,238,2,544,346,LTAdatasets/9706/annotate/9706-2021_03_20_093424.jpg,503.5,292.0,0.78671875,0.8111111111111111,0.1265625,0.3
9706-2021_03_20_093424.jpg,car,52,342,640,74,360,286,1,394,360,LTAdatasets/9706/annotate/9706-2021_03_20_093424.jpg,368.0,323.0,0.575,0.8972222222222223,0.08125,0.20555555555555555
9706-2021_03_20_093424.jpg,car,26,379,640,29,360,131,1,405,160,LTAdatasets/9706/annotate/9706-2021_03_20_093424.jpg,392.0,145.5,0.6125,0.4041666666666667,0.040625,0.08055555555555556
9706-2021_03_20_093424.jpg,car,17,306,640,20,360,120,1,323,140,LTAdatasets/9706/annotate/9706-2021_03_20_093424.jpg,314.5,130.0,0.49140625,0.3611111111111111,0.0265625,0.05555555555555555
9706-2021_03_20_093424.jpg,lorry_truck,32,327,640,29,360,99,2,359,128,LTAdatasets/9706/annotate/9706-2021_03_20_093424.jpg,343.0,113.5,0.5359375,0.31527777777777777,0.05,0.08055555555555556
9706-2021_03_20_093424.jpg,lorry_truck,30,333,640,31,360,62,2,363,93,LTAdatasets/9706/annotate/9706-2021_03_20_093424.jpg,348.0,77.5,0.54375,0.2152777777777778,0.046875,0.08611111111111111
9706-2021_03_20_093424.jpg,car,19,180,640,20,360,90,1,199,110,LTAdatasets/9706/annotate/9706-2021_03_20_093424.jpg,189.5,100.0,0.29609375,0.2777777777777778,0.0296875,0.05555555555555555
9706-2021_03_20_093424.jpg,car,12,287,640,11,360,62,1,299,73,LTAdatasets/9706/annotate/9706-2021_03_20_093424.jpg,293.0,67.5,0.4578125,0.1875,0.01875,0.030555555555555555
9706-2021_03_20_093424.jpg,lorry_truck,19,299,640,12,360,59,2,318,71,LTAdatasets/9706/annotate/9706-2021_03_20_093424.jpg,308.5,65.0,0.48203125,0.18055555555555555,0.0296875,0.03333333333333333
9706-2021_03_20_093424.jpg,lorry_truck,16,201,640,11,360,70,2,217,81,LTAdatasets/9706/annotate/9706-2021_03_20_093424.jpg,209.0,75.5,0.3265625,0.20972222222222223,0.025,0.030555555555555555
9706-2021_03_20_193635.jpg,bike,12,441,640,32,360,190,4,453,222,LTAdatasets/9706/annotate/9706-2021_03_20_193635.jpg,447.0,206.0,0.6984375,0.5722222222222222,0.01875,0.08888888888888889
9706-2021_03_20_193635.jpg,car,44,380,640,57,360,228,1,424,285,LTAdatasets/9706/annotate/9706-2021_03_20_193635.jpg,402.0,256.5,0.628125,0.7125,0.06875,0.15833333333333333
9706-2021_03_20_193635.jpg,car,31,317,640,24,360,153,1,348,177,LTAdatasets/9706/annotate/9706-2021_03_20_193635.jpg,332.5,165.0,0.51953125,0.4583333333333333,0.0484375,0.06666666666666667
9706-2021_03_20_193635.jpg,lorry_truck,14,353,640,21,360,129,2,367,150,LTAdatasets/9706/annotate/9706-2021_03_20_193635.jpg,360.0,139.5,0.5625,0.3875,0.021875,0.058333333333333334
9706-2021_03_20_193635.jpg,car,34,164,640,63,360,259,1,198,322,LTAdatasets/9706/annotate/9706-2021_03_20_193635.jpg,181.0,290.5,0.2828125,0.8069444444444445,0.053125,0.175
9706-2021_03_20_193635.jpg,car,18,237,640,14,360,89,1,255,103,LTAdatasets/9706/annotate/9706-2021_03_20_193635.jpg,246.0,96.0,0.384375,0.26666666666666666,0.028125,0.03888888888888889
9706-2021_03_20_193635.jpg,car,13,195,640,11,360,86,1,208,97,LTAdatasets/9706/annotate/9706-2021_03_20_193635.jpg,201.5,91.5,0.31484375,0.25416666666666665,0.0203125,0.030555555555555555
9706-2021_03_20_193635.jpg,car,16,295,640,16,360,86,1,311,102,LTAdatasets/9706/annotate/9706-2021_03_20_193635.jpg,303.0,94.0,0.4734375,0.2611111111111111,0.025,0.044444444444444446
9706-2021_03_20_193635.jpg,car,11,290,640,6,360,68,1,301,74,LTAdatasets/9706/annotate/9706-2021_03_20_193635.jpg,295.5,71.0,0.46171875,0.19722222222222222,0.0171875,0.016666666666666666
9706-2021_03_20_193635.jpg,lorry_truck,21,351,640,30,360,76,2,372,106,LTAdatasets/9706/annotate/9706-2021_03_20_193635.jpg,361.5,91.0,0.56484375,0.25277777777777777,0.0328125,0.08333333333333333
9706-2021_03_20_193635.jpg,car,14,222,640,11,360,68,1,236,79,LTAdatasets/9706/annotate/9706-2021_03_20_193635.jpg,229.0,73.5,0.3578125,0.20416666666666666,0.021875,0.030555555555555555
9706-2021_03_20_193635.jpg,car,15,318,640,12,360,57,1,333,69,LTAdatasets/9706/annotate/9706-2021_03_20_193635.jpg,325.5,63.0,0.50859375,0.175,0.0234375,0.03333333333333333
9706-2021_03_20_193635.jpg,car,9,241,640,9,360,56,1,250,65,LTAdatasets/9706/annotate/9706-2021_03_20_193635.jpg,245.5,60.5,0.38359375,0.16805555555555557,0.0140625,0.025
9706-2021_03_20_202758.jpg,bike,25,391,640,33,360,222,4,416,255,LTAdatasets/9706/annotate/9706-2021_03_20_202758.jpg,403.5,238.5,0.63046875,0.6625,0.0390625,0.09166666666666666
9706-2021_03_20_202758.jpg,bike,14,297,640,20,360,76,4,311,96,LTAdatasets/9706/annotate/9706-2021_03_20_202758.jpg,304.0,86.0,0.475,0.2388888888888889,0.021875,0.05555555555555555
9706-2021_03_20_202758.jpg,car,25,312,640,24,360,141,1,337,165,LTAdatasets/9706/annotate/9706-2021_03_20_202758.jpg,324.5,153.0,0.50703125,0.425,0.0390625,0.06666666666666667
9706-2021_03_20_202758.jpg,car,24,108,640,38,360,185,1,132,223,LTAdatasets/9706/annotate/9706-2021_03_20_202758.jpg,120.0,204.0,0.1875,0.5666666666666667,0.0375,0.10555555555555556
9706-2021_03_20_202758.jpg,car,33,135,640,44,360,239,1,168,283,LTAdatasets/9706/annotate/9706-2021_03_20_202758.jpg,151.5,261.0,0.23671875,0.725,0.0515625,0.12222222222222222
9706-2021_03_20_202758.jpg,lorry_truck,53,421,640,100,360,156,2,474,256,LTAdatasets/9706/annotate/9706-2021_03_20_202758.jpg,447.5,206.0,0.69921875,0.5722222222222222,0.0828125,0.2777777777777778
9706-2021_03_20_202758.jpg,van,13,217,640,16,360,68,3,230,84,LTAdatasets/9706/annotate/9706-2021_03_20_202758.jpg,223.5,76.0,0.34921875,0.2111111111111111,0.0203125,0.044444444444444446
9706-2021_03_20_202758.jpg,lorry_truck,8,211,640,12,360,51,2,219,63,LTAdatasets/9706/annotate/9706-2021_03_20_202758.jpg,215.0,57.0,0.3359375,0.15833333333333333,0.0125,0.03333333333333333
9706-2021_03_20_091302.jpg,lorry_truck,77,475,640,95,360,265,2,552,360,LTAdatasets/9706/annotate/9706-2021_03_20_091302.jpg,513.5,312.5,0.80234375,0.8680555555555556,0.1203125,0.2638888888888889
9706-2021_03_20_091302.jpg,lorry_truck,46,415,640,65,360,174,2,461,239,LTAdatasets/9706/annotate/9706-2021_03_20_091302.jpg,438.0,206.5,0.684375,0.5736111111111111,0.071875,0.18055555555555555
9706-2021_03_20_091302.jpg,car,24,361,640,26,360,163,1,385,189,LTAdatasets/9706/annotate/9706-2021_03_20_091302.jpg,373.0,176.0,0.5828125,0.4888888888888889,0.0375,0.07222222222222222
9706-2021_03_20_091302.jpg,car,23,182,640,27,360,145,1,205,172,LTAdatasets/9706/annotate/9706-2021_03_20_091302.jpg,193.5,158.5,0.30234375,0.44027777777777777,0.0359375,0.075
9706-2021_03_20_091302.jpg,car,15,319,640,16,360,76,1,334,92,LTAdatasets/9706/annotate/9706-2021_03_20_091302.jpg,326.5,84.0,0.51015625,0.23333333333333334,0.0234375,0.044444444444444446
9706-2021_03_20_091302.jpg,car,13,293,640,8,360,79,1,306,87,LTAdatasets/9706/annotate/9706-2021_03_20_091302.jpg,299.5,83.0,0.46796875,0.23055555555555557,0.0203125,0.022222222222222223
9706-2021_03_20_193115.jpg,car,39,393,640,54,360,228,1,432,282,LTAdatasets/9706/annotate/9706-2021_03_20_193115.jpg,412.5,255.0,0.64453125,0.7083333333333334,0.0609375,0.15
9706-2021_03_20_193115.jpg,lorry_truck,68,18,640,94,360,249,2,86,343,LTAdatasets/9706/annotate/9706-2021_03_20_193115.jpg,52.0,296.0,0.08125,0.8222222222222222,0.10625,0.2611111111111111
9706-2021_03_20_193115.jpg,car,26,335,640,29,360,116,1,361,145,LTAdatasets/9706/annotate/9706-2021_03_20_193115.jpg,348.0,130.5,0.54375,0.3625,0.040625,0.08055555555555556
9706-2021_03_20_193115.jpg,car,15,298,640,20,360,96,1,313,116,LTAdatasets/9706/annotate/9706-2021_03_20_193115.jpg,305.5,106.0,0.47734375,0.29444444444444445,0.0234375,0.05555555555555555
9706-2021_03_20_193115.jpg,car,10,238,640,11,360,86,1,248,97,LTAdatasets/9706/annotate/9706-2021_03_20_193115.jpg,243.0,91.5,0.3796875,0.25416666666666665,0.015625,0.030555555555555555
9706-2021_03_20_193115.jpg,car,16,215,640,11,360,91,1,231,102,LTAdatasets/9706/annotate/9706-2021_03_20_193115.jpg,223.0,96.5,0.3484375,0.26805555555555555,0.025,0.030555555555555555
9706-2021_03_20_193115.jpg,car,11,291,640,14,360,66,1,302,80,LTAdatasets/9706/annotate/9706-2021_03_20_193115.jpg,296.5,73.0,0.46328125,0.20277777777777778,0.0171875,0.03888888888888889
9706-2021_03_20_193115.jpg,car,11,312,640,14,360,65,1,323,79,LTAdatasets/9706/annotate/9706-2021_03_20_193115.jpg,317.5,72.0,0.49609375,0.2,0.0171875,0.03888888888888889
9706-2021_03_20_193115.jpg,car,11,244,640,9,360,56,1,255,65,LTAdatasets/9706/annotate/9706-2021_03_20_193115.jpg,249.5,60.5,0.38984375,0.16805555555555557,0.0171875,0.025
9706-2021_03_20_193115.jpg,lorry_truck,8,208,640,15,360,54,2,216,69,LTAdatasets/9706/annotate/9706-2021_03_20_193115.jpg,212.0,61.5,0.33125,0.17083333333333334,0.0125,0.041666666666666664
9706-2021_03_20_193115.jpg,lorry_truck,7,228,640,17,360,50,2,235,67,LTAdatasets/9706/annotate/9706-2021_03_20_193115.jpg,231.5,58.5,0.36171875,0.1625,0.0109375,0.04722222222222222
9706-2021_03_20_193115.jpg,car,43,170,640,40,360,320,1,213,360,LTAdatasets/9706/annotate/9706-2021_03_20_193115.jpg,191.5,340.0,0.29921875,0.9444444444444444,0.0671875,0.1111111111111111
9706-2021_03_20_073937.jpg,car,45,349,640,49,360,311,1,394,360,LTAdatasets/9706/annotate/9706-2021_03_20_073937.jpg,371.5,335.5,0.58046875,0.9319444444444445,0.0703125,0.1361111111111111
9706-2021_03_20_073937.jpg,lorry_truck,47,362,640,58,360,156,2,409,214,LTAdatasets/9706/annotate/9706-2021_03_20_073937.jpg,385.5,185.0,0.60234375,0.5138888888888888,0.0734375,0.16111111111111112
9706-2021_03_20_073937.jpg,lorry_truck,41,17,640,51,360,309,2,58,360,LTAdatasets/9706/annotate/9706-2021_03_20_073937.jpg,37.5,334.5,0.05859375,0.9291666666666667,0.0640625,0.14166666666666666
9706-2021_03_20_073937.jpg,car,18,189,640,24,360,130,1,207,154,LTAdatasets/9706/annotate/9706-2021_03_20_073937.jpg,198.0,142.0,0.309375,0.39444444444444443,0.028125,0.06666666666666667
9706-2021_03_20_073937.jpg,car,24,313,640,20,360,127,1,337,147,LTAdatasets/9706/annotate/9706-2021_03_20_073937.jpg,325.0,137.0,0.5078125,0.38055555555555554,0.0375,0.05555555555555555
9706-2021_03_20_073937.jpg,car,16,290,640,16,360,71,1,306,87,LTAdatasets/9706/annotate/9706-2021_03_20_073937.jpg,298.0,79.0,0.465625,0.21944444444444444,0.025,0.044444444444444446
9706-2021_03_20_073937.jpg,bike,11,310,640,9,360,90,4,321,99,LTAdatasets/9706/annotate/9706-2021_03_20_073937.jpg,315.5,94.5,0.49296875,0.2625,0.0171875,0.025
9706-2021_03_20_073937.jpg,bike,12,317,640,14,360,103,4,329,117,LTAdatasets/9706/annotate/9706-2021_03_20_073937.jpg,323.0,110.0,0.5046875,0.3055555555555556,0.01875,0.03888888888888889
9706-2021_03_20_073937.jpg,lorry_truck,19,345,640,25,360,70,2,364,95,LTAdatasets/9706/annotate/9706-2021_03_20_073937.jpg,354.5,82.5,0.55390625,0.22916666666666666,0.0296875,0.06944444444444445
9706-2021_03_20_073937.jpg,lorry_truck,16,309,640,11,360,68,2,325,79,LTAdatasets/9706/annotate/9706-2021_03_20_073937.jpg,317.0,73.5,0.4953125,0.20416666666666666,0.025,0.030555555555555555
9706-2021_03_20_073937.jpg,bike,12,201,640,12,360,67,4,213,79,LTAdatasets/9706/annotate/9706-2021_03_20_073937.jpg,207.0,73.0,0.3234375,0.20277777777777778,0.01875,0.03333333333333333
9706-2021_03_20_183712.jpg,bike,14,321,640,32,360,138,4,335,170,LTAdatasets/9706/annotate/9706-2021_03_20_183712.jpg,328.0,154.0,0.5125,0.42777777777777776,0.021875,0.08888888888888889
9706-2021_03_20_183712.jpg,bike,12,221,640,13,360,119,4,233,132,LTAdatasets/9706/annotate/9706-2021_03_20_183712.jpg,227.0,125.5,0.3546875,0.3486111111111111,0.01875,0.03611111111111111
9706-2021_03_20_183712.jpg,lorry_truck,22,325,640,16,360,95,2,347,111,LTAdatasets/9706/annotate/9706-2021_03_20_183712.jpg,336.0,103.0,0.525,0.2861111111111111,0.034375,0.044444444444444446
9706-2021_03_20_183712.jpg,car,35,66,640,42,360,250,1,101,292,LTAdatasets/9706/annotate/9706-2021_03_20_183712.jpg,83.5,271.0,0.13046875,0.7527777777777778,0.0546875,0.11666666666666667
9706-2021_03_20_183712.jpg,lorry_truck,43,86,640,52,360,308,2,129,360,LTAdatasets/9706/annotate/9706-2021_03_20_183712.jpg,107.5,334.0,0.16796875,0.9277777777777778,0.0671875,0.14444444444444443
9706-2021_03_20_183712.jpg,car,11,195,640,17,360,85,1,206,102,LTAdatasets/9706/annotate/9706-2021_03_20_183712.jpg,200.5,93.5,0.31328125,0.25972222222222224,0.0171875,0.04722222222222222
9706-2021_03_20_183712.jpg,car,16,236,640,8,360,69,1,252,77,LTAdatasets/9706/annotate/9706-2021_03_20_183712.jpg,244.0,73.0,0.38125,0.20277777777777778,0.025,0.022222222222222223
9706-2021_03_20_183712.jpg,car,11,304,640,9,360,61,1,315,70,LTAdatasets/9706/annotate/9706-2021_03_20_183712.jpg,309.5,65.5,0.48359375,0.18194444444444444,0.0171875,0.025
9706-2021_03_20_183712.jpg,lorry_truck,17,200,640,18,360,58,2,217,76,LTAdatasets/9706/annotate/9706-2021_03_20_183712.jpg,208.5,67.0,0.32578125,0.18611111111111112,0.0265625,0.05
9706-2021_03_20_182451.jpg,lorry_truck,57,43,640,107,360,230,2,100,337,LTAdatasets/9706/annotate/9706-2021_03_20_182451.jpg,71.5,283.5,0.11171875,0.7875,0.0890625,0.2972222222222222
9706-2021_03_20_182451.jpg,car,28,160,640,30,360,193,1,188,223,LTAdatasets/9706/annotate/9706-2021_03_20_182451.jpg,174.0,208.0,0.271875,0.5777777777777777,0.04375,0.08333333333333333
9706-2021_03_20_182451.jpg,car,35,364,640,41,360,168,1,399,209,LTAdatasets/9706/annotate/9706-2021_03_20_182451.jpg,381.5,188.5,0.59609375,0.5236111111111111,0.0546875,0.11388888888888889
9706-2021_03_20_182451.jpg,car,29,322,640,34,360,178,1,351,212,LTAdatasets/9706/annotate/9706-2021_03_20_182451.jpg,336.5,195.0,0.52578125,0.5416666666666666,0.0453125,0.09444444444444444
9706-2021_03_20_182451.jpg,car,13,236,640,19,360,86,1,249,105,LTAdatasets/9706/annotate/9706-2021_03_20_182451.jpg,242.5,95.5,0.37890625,0.2652777777777778,0.0203125,0.05277777777777778
9706-2021_03_20_182451.jpg,car,9,286,640,15,360,60,1,295,75,LTAdatasets/9706/annotate/9706-2021_03_20_182451.jpg,290.5,67.5,0.45390625,0.1875,0.0140625,0.041666666666666664
9706-2021_03_20_182451.jpg,lorry_truck,23,327,640,20,360,64,2,350,84,LTAdatasets/9706/annotate/9706-2021_03_20_182451.jpg,338.5,74.0,0.52890625,0.20555555555555555,0.0359375,0.05555555555555555
9706-2021_03_20_182451.jpg,bike,10,182,640,16,360,105,4,192,121,LTAdatasets/9706/annotate/9706-2021_03_20_182451.jpg,187.0,113.0,0.2921875,0.3138888888888889,0.015625,0.044444444444444446
9706-2021_03_20_182451.jpg,car,13,224,640,11,360,56,1,237,67,LTAdatasets/9706/annotate/9706-2021_03_20_182451.jpg,230.5,61.5,0.36015625,0.17083333333333334,0.0203125,0.030555555555555555
9706-2021_03_20_182451.jpg,lorry_truck,13,205,640,19,360,51,2,218,70,LTAdatasets/9706/annotate/9706-2021_03_20_182451.jpg,211.5,60.5,0.33046875,0.16805555555555557,0.0203125,0.05277777777777778
9706-2021_03_20_093103.jpg,lorry_truck,55,384,640,63,360,223,2,439,286,LTAdatasets/9706/annotate/9706-2021_03_20_093103.jpg,411.5,254.5,0.64296875,0.7069444444444445,0.0859375,0.175
9706-2021_03_20_093103.jpg,lorry_truck,86,461,640,138,360,221,2,547,359,LTAdatasets/9706/annotate/9706-2021_03_20_093103.jpg,504.0,290.0,0.7875,0.8055555555555556,0.134375,0.38333333333333336
9706-2021_03_20_093103.jpg,van,22,329,640,20,360,104,3,351,124,LTAdatasets/9706/annotate/9706-2021_03_20_093103.jpg,340.0,114.0,0.53125,0.31666666666666665,0.034375,0.05555555555555555
9706-2021_03_20_093103.jpg,van,11,295,640,12,360,44,3,306,56,LTAdatasets/9706/annotate/9706-2021_03_20_093103.jpg,300.5,50.0,0.46953125,0.1388888888888889,0.0171875,0.03333333333333333
9706-2021_03_20_093103.jpg,car,19,295,640,19,360,85,1,314,104,LTAdatasets/9706/annotate/9706-2021_03_20_093103.jpg,304.5,94.5,0.47578125,0.2625,0.0296875,0.05277777777777778
9706-2021_03_20_093103.jpg,car,26,310,640,24,360,141,1,336,165,LTAdatasets/9706/annotate/9706-2021_03_20_093103.jpg,323.0,153.0,0.5046875,0.425,0.040625,0.06666666666666667
9706-2021_03_20_093103.jpg,lorry_truck,26,339,640,24,360,72,2,365,96,LTAdatasets/9706/annotate/9706-2021_03_20_093103.jpg,352.0,84.0,0.55,0.23333333333333334,0.040625,0.06666666666666667
9706-2021_03_20_093103.jpg,lorry_truck,16,310,640,16,360,45,2,326,61,LTAdatasets/9706/annotate/9706-2021_03_20_093103.jpg,318.0,53.0,0.496875,0.14722222222222223,0.025,0.044444444444444446
9706-2021_03_20_093103.jpg,van,11,304,640,13,360,58,3,315,71,LTAdatasets/9706/annotate/9706-2021_03_20_093103.jpg,309.5,64.5,0.48359375,0.17916666666666667,0.0171875,0.03611111111111111
9706-2021_03_20_093103.jpg,car,14,285,640,14,360,59,1,299,73,LTAdatasets/9706/annotate/9706-2021_03_20_093103.jpg,292.0,66.0,0.45625,0.18333333333333332,0.021875,0.03888888888888889
9706-2021_03_20_093103.jpg,car,9,283,640,9,360,48,1,292,57,LTAdatasets/9706/annotate/9706-2021_03_20_093103.jpg,287.5,52.5,0.44921875,0.14583333333333334,0.0140625,0.025
9706-2021_03_20_093103.jpg,car,10,222,640,10,360,69,1,232,79,LTAdatasets/9706/annotate/9706-2021_03_20_093103.jpg,227.0,74.0,0.3546875,0.20555555555555555,0.015625,0.027777777777777776
9706-2021_03_20_093103.jpg,lorry_truck,22,190,640,29,360,71,2,212,100,LTAdatasets/9706/annotate/9706-2021_03_20_093103.jpg,201.0,85.5,0.3140625,0.2375,0.034375,0.08055555555555556
9706-2021_03_20_093103.jpg,bike,14,129,640,27,360,240,4,143,267,LTAdatasets/9706/annotate/9706-2021_03_20_093103.jpg,136.0,253.5,0.2125,0.7041666666666667,0.021875,0.075
9706-2021_03_20_093103.jpg,car,16,234,640,14,360,95,1,250,109,LTAdatasets/9706/annotate/9706-2021_03_20_093103.jpg,242.0,102.0,0.378125,0.2833333333333333,0.025,0.03888888888888889
9706-2021_03_20_093103.jpg,lorry_truck,19,198,640,14,360,57,2,217,71,LTAdatasets/9706/annotate/9706-2021_03_20_093103.jpg,207.5,64.0,0.32421875,0.17777777777777778,0.0296875,0.03888888888888889
9706-2021_03_20_074618.jpg,car,41,98,640,63,360,286,1,139,349,LTAdatasets/9706/annotate/9706-2021_03_20_074618.jpg,118.5,317.5,0.18515625,0.8819444444444444,0.0640625,0.175
9706-2021_03_20_074618.jpg,car,17,311,640,24,360,109,1,328,133,LTAdatasets/9706/annotate/9706-2021_03_20_074618.jpg,319.5,121.0,0.49921875,0.33611111111111114,0.0265625,0.06666666666666667
9706-2021_03_20_074618.jpg,car,12,299,640,14,360,76,1,311,90,LTAdatasets/9706/annotate/9706-2021_03_20_074618.jpg,305.0,83.0,0.4765625,0.23055555555555557,0.01875,0.03888888888888889
9706-2021_03_20_074618.jpg,car,16,238,640,15,360,96,1,254,111,LTAdatasets/9706/annotate/9706-2021_03_20_074618.jpg,246.0,103.5,0.384375,0.2875,0.025,0.041666666666666664
9706-2021_03_20_074618.jpg,car,10,240,640,9,360,62,1,250,71,LTAdatasets/9706/annotate/9706-2021_03_20_074618.jpg,245.0,66.5,0.3828125,0.18472222222222223,0.015625,0.025
9706-2021_03_20_074618.jpg,car,9,294,640,6,360,69,1,303,75,LTAdatasets/9706/annotate/9706-2021_03_20_074618.jpg,298.5,72.0,0.46640625,0.2,0.0140625,0.016666666666666666
9706-2021_03_20_074618.jpg,car,11,298,640,11,360,59,1,309,70,LTAdatasets/9706/annotate/9706-2021_03_20_074618.jpg,303.5,64.5,0.47421875,0.17916666666666667,0.0171875,0.030555555555555555
9706-2021_03_20_074618.jpg,car,7,237,640,9,360,42,1,244,51,LTAdatasets/9706/annotate/9706-2021_03_20_074618.jpg,240.5,46.5,0.37578125,0.12916666666666668,0.0109375,0.025
9706-2021_03_20_074618.jpg,lorry_truck,20,192,640,34,360,108,2,212,142,LTAdatasets/9706/annotate/9706-2021_03_20_074618.jpg,202.0,125.0,0.315625,0.3472222222222222,0.03125,0.09444444444444444
9706-2021_03_20_074618.jpg,lorry_truck,16,311,640,12,360,46,2,327,58,LTAdatasets/9706/annotate/9706-2021_03_20_074618.jpg,319.0,52.0,0.4984375,0.14444444444444443,0.025,0.03333333333333333
9706-2021_03_20_074618.jpg,lorry_truck,18,291,640,14,360,44,2,309,58,LTAdatasets/9706/annotate/9706-2021_03_20_074618.jpg,300.0,51.0,0.46875,0.14166666666666666,0.028125,0.03888888888888889
9706-2021_03_20_074618.jpg,bus,52,98,640,96,360,130,5,150,226,LTAdatasets/9706/annotate/9706-2021_03_20_074618.jpg,124.0,178.0,0.19375,0.49444444444444446,0.08125,0.26666666666666666
9706-2021_03_20_180110.jpg,van,20,331,640,23,360,104,3,351,127,LTAdatasets/9706/annotate/9706-2021_03_20_180110.jpg,341.0,115.5,0.5328125,0.32083333333333336,0.03125,0.06388888888888888
9706-2021_03_20_180110.jpg,car,21,293,640,15,360,86,1,314,101,LTAdatasets/9706/annotate/9706-2021_03_20_180110.jpg,303.5,93.5,0.47421875,0.25972222222222224,0.0328125,0.041666666666666664
9706-2021_03_20_180110.jpg,car,11,309,640,15,360,66,1,320,81,LTAdatasets/9706/annotate/9706-2021_03_20_180110.jpg,314.5,73.5,0.49140625,0.20416666666666666,0.0171875,0.041666666666666664
9706-2021_03_20_180110.jpg,car,8,315,640,9,360,53,1,323,62,LTAdatasets/9706/annotate/9706-2021_03_20_180110.jpg,319.0,57.5,0.4984375,0.1597222222222222,0.0125,0.025
9706-2021_03_20_180110.jpg,car,12,180,640,15,360,101,1,192,116,LTAdatasets/9706/annotate/9706-2021_03_20_180110.jpg,186.0,108.5,0.290625,0.3013888888888889,0.01875,0.041666666666666664
9706-2021_03_20_180110.jpg,car,12,217,640,12,360,81,1,229,93,LTAdatasets/9706/annotate/9706-2021_03_20_180110.jpg,223.0,87.0,0.3484375,0.24166666666666667,0.01875,0.03333333333333333
9706-2021_03_20_180110.jpg,car,10,241,640,11,360,86,1,251,97,LTAdatasets/9706/annotate/9706-2021_03_20_180110.jpg,246.0,91.5,0.384375,0.25416666666666665,0.015625,0.030555555555555555
9706-2021_03_20_180110.jpg,lorry_truck,11,198,640,18,360,71,2,209,89,LTAdatasets/9706/annotate/9706-2021_03_20_180110.jpg,203.5,80.0,0.31796875,0.2222222222222222,0.0171875,0.05
9706-2021_03_20_180110.jpg,lorry_truck,24,114,640,39,360,181,2,138,220,LTAdatasets/9706/annotate/9706-2021_03_20_180110.jpg,126.0,200.5,0.196875,0.5569444444444445,0.0375,0.10833333333333334
9706-2021_03_20_180110.jpg,bike,6,242,640,11,360,53,4,248,64,LTAdatasets/9706/annotate/9706-2021_03_20_180110.jpg,245.0,58.5,0.3828125,0.1625,0.009375,0.030555555555555555
9706-2021_03_20_180110.jpg,car,10,228,640,12,360,51,1,238,63,LTAdatasets/9706/annotate/9706-2021_03_20_180110.jpg,233.0,57.0,0.3640625,0.15833333333333333,0.015625,0.03333333333333333
9706-2021_03_20_084601.jpg,lorry_truck,57,418,640,87,360,165,2,475,252,LTAdatasets/9706/annotate/9706-2021_03_20_084601.jpg,446.5,208.5,0.69765625,0.5791666666666667,0.0890625,0.24166666666666667
9706-2021_03_20_084601.jpg,lorry_truck,18,345,640,27,360,75,2,363,102,LTAdatasets/9706/annotate/9706-2021_03_20_084601.jpg,354.0,88.5,0.553125,0.24583333333333332,0.028125,0.075
9706-2021_03_20_084601.jpg,lorry_truck,9,304,640,27,360,49,2,313,76,LTAdatasets/9706/annotate/9706-2021_03_20_084601.jpg,308.5,62.5,0.48203125,0.1736111111111111,0.0140625,0.075
9706-2021_03_20_084601.jpg,lorry_truck,16,318,640,23,360,47,2,334,70,LTAdatasets/9706/annotate/9706-2021_03_20_084601.jpg,326.0,58.5,0.509375,0.1625,0.025,0.06388888888888888
9706-2021_03_20_084601.jpg,bike,11,303,640,14,360,79,4,314,93,LTAdatasets/9706/annotate/9706-2021_03_20_084601.jpg,308.5,86.0,0.48203125,0.2388888888888889,0.0171875,0.03888888888888889
9706-2021_03_20_084601.jpg,car,13,235,640,20,360,74,1,248,94,LTAdatasets/9706/annotate/9706-2021_03_20_084601.jpg,241.5,84.0,0.37734375,0.23333333333333334,0.0203125,0.05555555555555555
9706-2021_03_20_084601.jpg,lorry_truck,9,198,640,15,360,72,2,207,87,LTAdatasets/9706/annotate/9706-2021_03_20_084601.jpg,202.5,79.5,0.31640625,0.22083333333333333,0.0140625,0.041666666666666664
9706-2021_03_20_084601.jpg,lorry_truck,11,209,640,11,360,54,2,220,65,LTAdatasets/9706/annotate/9706-2021_03_20_084601.jpg,214.5,59.5,0.33515625,0.16527777777777777,0.0171875,0.030555555555555555
9706-2021_03_20_084601.jpg,car,9,239,640,8,360,45,1,248,53,LTAdatasets/9706/annotate/9706-2021_03_20_084601.jpg,243.5,49.0,0.38046875,0.1361111111111111,0.0140625,0.022222222222222223
9706-2021_03_20_084601.jpg,car,14,297,640,7,360,39,1,311,46,LTAdatasets/9706/annotate/9706-2021_03_20_084601.jpg,304.0,42.5,0.475,0.11805555555555555,0.021875,0.019444444444444445
9706-2021_03_20_185453.jpg,car,36,324,640,47,360,183,1,360,230,LTAdatasets/9706/annotate/9706-2021_03_20_185453.jpg,342.0,206.5,0.534375,0.5736111111111111,0.05625,0.13055555555555556
9706-2021_03_20_185453.jpg,car,22,306,640,30,360,145,1,328,175,LTAdatasets/9706/annotate/9706-2021_03_20_185453.jpg,317.0,160.0,0.4953125,0.4444444444444444,0.034375,0.08333333333333333
9706-2021_03_20_185453.jpg,car,19,317,640,15,360,80,1,336,95,LTAdatasets/9706/annotate/9706-2021_03_20_185453.jpg,326.5,87.5,0.51015625,0.24305555555555555,0.0296875,0.041666666666666664
9706-2021_03_20_185453.jpg,lorry_truck,18,202,640,20,360,96,2,220,116,LTAdatasets/9706/annotate/9706-2021_03_20_185453.jpg,211.0,106.0,0.3296875,0.29444444444444445,0.028125,0.05555555555555555
9706-2021_03_20_185453.jpg,lorry_truck,76,459,640,97,360,222,2,535,319,LTAdatasets/9706/annotate/9706-2021_03_20_185453.jpg,497.0,270.5,0.7765625,0.7513888888888889,0.11875,0.26944444444444443
9706-2021_03_20_185453.jpg,lorry_truck,17,326,640,20,360,58,2,343,78,LTAdatasets/9706/annotate/9706-2021_03_20_185453.jpg,334.5,68.0,0.52265625,0.18888888888888888,0.0265625,0.05555555555555555
9706-2021_03_20_185453.jpg,car,21,170,640,32,360,151,1,191,183,LTAdatasets/9706/annotate/9706-2021_03_20_185453.jpg,180.5,167.0,0.28203125,0.4638888888888889,0.0328125,0.08888888888888889
9706-2021_03_20_185453.jpg,car,16,233,640,13,360,76,1,249,89,LTAdatasets/9706/annotate/9706-2021_03_20_185453.jpg,241.0,82.5,0.3765625,0.22916666666666666,0.025,0.03611111111111111
9706-2021_03_20_185453.jpg,car,11,222,640,8,360,65,1,233,73,LTAdatasets/9706/annotate/9706-2021_03_20_185453.jpg,227.5,69.0,0.35546875,0.19166666666666668,0.0171875,0.022222222222222223
9706-2021_03_20_185453.jpg,car,8,243,640,12,360,58,1,251,70,LTAdatasets/9706/annotate/9706-2021_03_20_185453.jpg,247.0,64.0,0.3859375,0.17777777777777778,0.0125,0.03333333333333333
9706-2021_03_20_185453.jpg,car,11,292,640,7,360,50,1,303,57,LTAdatasets/9706/annotate/9706-2021_03_20_185453.jpg,297.5,53.5,0.46484375,0.1486111111111111,0.0171875,0.019444444444444445
9706-2021_03_20_185453.jpg,car,9,222,640,10,360,47,1,231,57,LTAdatasets/9706/annotate/9706-2021_03_20_185453.jpg,226.5,52.0,0.35390625,0.14444444444444443,0.0140625,0.027777777777777776
9706-2021_03_20_185453.jpg,car,10,238,640,7,360,52,1,248,59,LTAdatasets/9706/annotate/9706-2021_03_20_185453.jpg,243.0,55.5,0.3796875,0.15416666666666667,0.015625,0.019444444444444445
9706-2021_03_20_185453.jpg,bus,16,297,640,22,360,30,5,313,52,LTAdatasets/9706/annotate/9706-2021_03_20_185453.jpg,305.0,41.0,0.4765625,0.11388888888888889,0.025,0.06111111111111111
9706-2021_03_20_181551.jpg,lorry_truck,67,35,640,99,360,228,2,102,327,LTAdatasets/9706/annotate/9706-2021_03_20_181551.jpg,68.5,277.5,0.10703125,0.7708333333333334,0.1046875,0.275
9706-2021_03_20_181551.jpg,lorry_truck,31,400,640,39,360,153,2,431,192,LTAdatasets/9706/annotate/9706-2021_03_20_181551.jpg,415.5,172.5,0.64921875,0.4791666666666667,0.0484375,0.10833333333333334
9706-2021_03_20_181551.jpg,car,29,361,640,33,360,171,1,390,204,LTAdatasets/9706/annotate/9706-2021_03_20_181551.jpg,375.5,187.5,0.58671875,0.5208333333333334,0.0453125,0.09166666666666666
9706-2021_03_20_181551.jpg,car,32,326,640,36,360,202,1,358,238,LTAdatasets/9706/annotate/9706-2021_03_20_181551.jpg,342.0,220.0,0.534375,0.6111111111111112,0.05,0.1
9706-2021_03_20_181551.jpg,car,20,332,640,16,360,108,1,352,124,LTAdatasets/9706/annotate/9706-2021_03_20_181551.jpg,342.0,116.0,0.534375,0.32222222222222224,0.03125,0.044444444444444446
9706-2021_03_20_181551.jpg,car,15,295,640,21,360,81,1,310,102,LTAdatasets/9706/annotate/9706-2021_03_20_181551.jpg,302.5,91.5,0.47265625,0.25416666666666665,0.0234375,0.058333333333333334
9706-2021_03_20_181551.jpg,car,19,174,640,24,360,161,1,193,185,LTAdatasets/9706/annotate/9706-2021_03_20_181551.jpg,183.5,173.0,0.28671875,0.48055555555555557,0.0296875,0.06666666666666667
9706-2021_03_20_181551.jpg,lorry_truck,16,178,640,22,360,95,2,194,117,LTAdatasets/9706/annotate/9706-2021_03_20_181551.jpg,186.0,106.0,0.290625,0.29444444444444445,0.025,0.06111111111111111
9706-2021_03_20_181551.jpg,lorry_truck,11,210,640,10,360,41,2,221,51,LTAdatasets/9706/annotate/9706-2021_03_20_181551.jpg,215.5,46.0,0.33671875,0.12777777777777777,0.0171875,0.027777777777777776
9706-2021_03_20_181551.jpg,lorry_truck,11,203,640,19,360,59,2,214,78,LTAdatasets/9706/annotate/9706-2021_03_20_181551.jpg,208.5,68.5,0.32578125,0.19027777777777777,0.0171875,0.05277777777777778
9706-2021_03_20_181551.jpg,bike,9,216,640,13,360,77,4,225,90,LTAdatasets/9706/annotate/9706-2021_03_20_181551.jpg,220.5,83.5,0.34453125,0.23194444444444445,0.0140625,0.03611111111111111
9706-2021_03_20_181551.jpg,bike,7,298,640,17,360,68,4,305,85,LTAdatasets/9706/annotate/9706-2021_03_20_181551.jpg,301.5,76.5,0.47109375,0.2125,0.0109375,0.04722222222222222
9706-2021_03_20_181551.jpg,car,12,309,640,13,360,62,1,321,75,LTAdatasets/9706/annotate/9706-2021_03_20_181551.jpg,315.0,68.5,0.4921875,0.19027777777777777,0.01875,0.03611111111111111
9706-2021_03_20_181551.jpg,car,11,223,640,9,360,57,1,234,66,LTAdatasets/9706/annotate/9706-2021_03_20_181551.jpg,228.5,61.5,0.35703125,0.17083333333333334,0.0171875,0.025
9706-2021_03_20_181551.jpg,car,8,291,640,9,360,46,1,299,55,LTAdatasets/9706/annotate/9706-2021_03_20_181551.jpg,295.0,50.5,0.4609375,0.14027777777777778,0.0125,0.025
9706-2021_03_20_181551.jpg,bike,9,237,640,8,360,43,4,246,51,LTAdatasets/9706/annotate/9706-2021_03_20_181551.jpg,241.5,47.0,0.37734375,0.13055555555555556,0.0140625,0.022222222222222223
9706-2021_03_20_181551.jpg,car,56,444,640,36,360,324,1,500,360,LTAdatasets/9706/annotate/9706-2021_03_20_181551.jpg,472.0,342.0,0.7375,0.95,0.0875,0.1
9706-2021_03_20_181551.jpg,car,51,97,640,32,360,327,1,148,359,LTAdatasets/9706/annotate/9706-2021_03_20_181551.jpg,122.5,343.0,0.19140625,0.9527777777777777,0.0796875,0.08888888888888889
9706-2021_03_20_184913.jpg,car,31,329,640,55,360,216,1,360,271,LTAdatasets/9706/annotate/9706-2021_03_20_184913.jpg,344.5,243.5,0.53828125,0.6763888888888889,0.0484375,0.1527777777777778
9706-2021_03_20_184913.jpg,car,16,326,640,22,360,85,1,342,107,LTAdatasets/9706/annotate/9706-2021_03_20_184913.jpg,334.0,96.0,0.521875,0.26666666666666666,0.025,0.06111111111111111
9706-2021_03_20_184913.jpg,car,14,295,640,15,360,79,1,309,94,LTAdatasets/9706/annotate/9706-2021_03_20_184913.jpg,302.0,86.5,0.471875,0.24027777777777778,0.021875,0.041666666666666664
9706-2021_03_20_184913.jpg,car,15,298,640,9,360,56,1,313,65,LTAdatasets/9706/annotate/9706-2021_03_20_184913.jpg,305.5,60.5,0.47734375,0.16805555555555557,0.0234375,0.025
9706-2021_03_20_184913.jpg,van,11,314,640,11,360,48,3,325,59,LTAdatasets/9706/annotate/9706-2021_03_20_184913.jpg,319.5,53.5,0.49921875,0.1486111111111111,0.0171875,0.030555555555555555
9706-2021_03_20_184913.jpg,car,12,243,640,11,360,57,1,255,68,LTAdatasets/9706/annotate/9706-2021_03_20_184913.jpg,249.0,62.5,0.3890625,0.1736111111111111,0.01875,0.030555555555555555
9706-2021_03_20_184913.jpg,lorry_truck,11,221,640,15,360,55,2,232,70,LTAdatasets/9706/annotate/9706-2021_03_20_184913.jpg,226.5,62.5,0.35390625,0.1736111111111111,0.0171875,0.041666666666666664
9706-2021_03_20_184913.jpg,car,9,288,640,7,360,44,1,297,51,LTAdatasets/9706/annotate/9706-2021_03_20_184913.jpg,292.5,47.5,0.45703125,0.13194444444444445,0.0140625,0.019444444444444445
9706-2021_03_20_184913.jpg,car,8,228,640,6,360,41,1,236,47,LTAdatasets/9706/annotate/9706-2021_03_20_184913.jpg,232.0,44.0,0.3625,0.12222222222222222,0.0125,0.016666666666666666
9706-2021_03_20_200416.jpg,car,34,80,640,48,360,239,1,114,287,LTAdatasets/9706/annotate/9706-2021_03_20_200416.jpg,97.0,263.0,0.1515625,0.7305555555555555,0.053125,0.13333333333333333
9706-2021_03_20_200416.jpg,car,19,303,640,25,360,103,1,322,128,LTAdatasets/9706/annotate/9706-2021_03_20_200416.jpg,312.5,115.5,0.48828125,0.32083333333333336,0.0296875,0.06944444444444445
9706-2021_03_20_200416.jpg,car,14,296,640,14,360,78,1,310,92,LTAdatasets/9706/annotate/9706-2021_03_20_200416.jpg,303.0,85.0,0.4734375,0.2361111111111111,0.021875,0.03888888888888889
9706-2021_03_20_200416.jpg,car,15,321,640,16,360,72,1,336,88,LTAdatasets/9706/annotate/9706-2021_03_20_200416.jpg,328.5,80.0,0.51328125,0.2222222222222222,0.0234375,0.044444444444444446
9706-2021_03_20_200416.jpg,car,15,194,640,17,360,80,1,209,97,LTAdatasets/9706/annotate/9706-2021_03_20_200416.jpg,201.5,88.5,0.31484375,0.24583333333333332,0.0234375,0.04722222222222222
9706-2021_03_20_200416.jpg,bike,5,219,640,10,360,38,4,224,48,LTAdatasets/9706/annotate/9706-2021_03_20_200416.jpg,221.5,43.0,0.34609375,0.11944444444444445,0.0078125,0.027777777777777776
9706-2021_03_20_200416.jpg,lorry_truck,30,352,640,23,360,93,2,382,116,LTAdatasets/9706/annotate/9706-2021_03_20_200416.jpg,367.0,104.5,0.5734375,0.2902777777777778,0.046875,0.06388888888888888
9706-2021_03_20_200416.jpg,lorry_truck,49,424,640,72,360,180,2,473,252,LTAdatasets/9706/annotate/9706-2021_03_20_200416.jpg,448.5,216.0,0.70078125,0.6,0.0765625,0.2
9706-2021_03_20_200416.jpg,lorry_truck,11,209,640,12,360,57,2,220,69,LTAdatasets/9706/annotate/9706-2021_03_20_200416.jpg,214.5,63.0,0.33515625,0.175,0.0171875,0.03333333333333333
9706-2021_03_20_200416.jpg,car,9,302,640,11,360,55,1,311,66,LTAdatasets/9706/annotate/9706-2021_03_20_200416.jpg,306.5,60.5,0.47890625,0.16805555555555557,0.0140625,0.030555555555555555
9706-2021_03_20_095205.jpg,car,23,341,640,61,360,231,1,364,292,LTAdatasets/9706/annotate/9706-2021_03_20_095205.jpg,352.5,261.5,0.55078125,0.7263888888888889,0.0359375,0.16944444444444445
9706-2021_03_20_095205.jpg,car,26,193,640,39,360,212,1,219,251,LTAdatasets/9706/annotate/9706-2021_03_20_095205.jpg,206.0,231.5,0.321875,0.6430555555555556,0.040625,0.10833333333333334
9706-2021_03_20_095205.jpg,van,38,368,640,45,360,173,3,406,218,LTAdatasets/9706/annotate/9706-2021_03_20_095205.jpg,387.0,195.5,0.6046875,0.5430555555555555,0.059375,0.125
9706-2021_03_20_095205.jpg,car,28,307,640,29,360,141,1,335,170,LTAdatasets/9706/annotate/9706-2021_03_20_095205.jpg,321.0,155.5,0.5015625,0.43194444444444446,0.04375,0.08055555555555556
9706-2021_03_20_095205.jpg,car,19,294,640,19,360,94,1,313,113,LTAdatasets/9706/annotate/9706-2021_03_20_095205.jpg,303.5,103.5,0.47421875,0.2875,0.0296875,0.05277777777777778
9706-2021_03_20_095205.jpg,van,19,184,640,19,360,92,3,203,111,LTAdatasets/9706/annotate/9706-2021_03_20_095205.jpg,193.5,101.5,0.30234375,0.28194444444444444,0.0296875,0.05277777777777778
9706-2021_03_20_095205.jpg,van,15,215,640,23,360,68,3,230,91,LTAdatasets/9706/annotate/9706-2021_03_20_095205.jpg,222.5,79.5,0.34765625,0.22083333333333333,0.0234375,0.06388888888888888
9706-2021_03_20_095205.jpg,lorry_truck,12,322,640,15,360,52,2,334,67,LTAdatasets/9706/annotate/9706-2021_03_20_095205.jpg,328.0,59.5,0.5125,0.16527777777777777,0.01875,0.041666666666666664
9706-2021_03_20_095205.jpg,van,12,305,640,17,360,61,3,317,78,LTAdatasets/9706/annotate/9706-2021_03_20_095205.jpg,311.0,69.5,0.4859375,0.19305555555555556,0.01875,0.04722222222222222
9706-2021_03_20_095205.jpg,car,9,287,640,10,360,61,1,296,71,LTAdatasets/9706/annotate/9706-2021_03_20_095205.jpg,291.5,66.0,0.45546875,0.18333333333333332,0.0140625,0.027777777777777776
9706-2021_03_20_095205.jpg,car,12,294,640,8,360,48,1,306,56,LTAdatasets/9706/annotate/9706-2021_03_20_095205.jpg,300.0,52.0,0.46875,0.14444444444444443,0.01875,0.022222222222222223
9706-2021_03_20_095205.jpg,car,10,237,640,6,360,46,1,247,52,LTAdatasets/9706/annotate/9706-2021_03_20_095205.jpg,242.0,49.0,0.378125,0.1361111111111111,0.015625,0.016666666666666666
9706-2021_03_20_095205.jpg,lorry_truck,11,205,640,13,360,52,2,216,65,LTAdatasets/9706/annotate/9706-2021_03_20_095205.jpg,210.5,58.5,0.32890625,0.1625,0.0171875,0.03611111111111111
9706-2021_03_20_095205.jpg,car,9,223,640,8,360,38,1,232,46,LTAdatasets/9706/annotate/9706-2021_03_20_095205.jpg,227.5,42.0,0.35546875,0.11666666666666667,0.0140625,0.022222222222222223
9706-2021_03_20_095205.jpg,car,9,281,640,10,360,36,1,290,46,LTAdatasets/9706/annotate/9706-2021_03_20_095205.jpg,285.5,41.0,0.44609375,0.11388888888888889,0.0140625,0.027777777777777776
9706-2021_03_20_191234.jpg,car,35,326,640,43,360,204,1,361,247,LTAdatasets/9706/annotate/9706-2021_03_20_191234.jpg,343.5,225.5,0.53671875,0.6263888888888889,0.0546875,0.11944444444444445
9706-2021_03_20_191234.jpg,car,23,350,640,28,360,140,1,373,168,LTAdatasets/9706/annotate/9706-2021_03_20_191234.jpg,361.5,154.0,0.56484375,0.42777777777777776,0.0359375,0.07777777777777778
9706-2021_03_20_191234.jpg,car,24,180,640,20,360,145,1,204,165,LTAdatasets/9706/annotate/9706-2021_03_20_191234.jpg,192.0,155.0,0.3,0.4305555555555556,0.0375,0.05555555555555555
9706-2021_03_20_191234.jpg,car,36,107,640,59,360,278,1,143,337,LTAdatasets/9706/annotate/9706-2021_03_20_191234.jpg,125.0,307.5,0.1953125,0.8541666666666666,0.05625,0.1638888888888889
9706-2021_03_20_191234.jpg,lorry_truck,79,470,640,106,360,247,2,549,353,LTAdatasets/9706/annotate/9706-2021_03_20_191234.jpg,509.5,300.0,0.79609375,0.8333333333333334,0.1234375,0.29444444444444445
9706-2021_03_20_191234.jpg,lorry_truck,42,371,640,72,360,173,2,413,245,LTAdatasets/9706/annotate/9706-2021_03_20_191234.jpg,392.0,209.0,0.6125,0.5805555555555556,0.065625,0.2
9706-2021_03_20_191234.jpg,lorry_truck,17,327,640,23,360,87,2,344,110,LTAdatasets/9706/annotate/9706-2021_03_20_191234.jpg,335.5,98.5,0.52421875,0.27361111111111114,0.0265625,0.06388888888888888
9706-2021_03_20_191234.jpg,lorry_truck,18,342,640,12,360,82,2,360,94,LTAdatasets/9706/annotate/9706-2021_03_20_191234.jpg,351.0,88.0,0.5484375,0.24444444444444444,0.028125,0.03333333333333333
9706-2021_03_20_191234.jpg,lorry_truck,23,174,640,29,360,88,2,197,117,LTAdatasets/9706/annotate/9706-2021_03_20_191234.jpg,185.5,102.5,0.28984375,0.2847222222222222,0.0359375,0.08055555555555556
9706-2021_03_20_191234.jpg,van,12,220,640,16,360,74,3,232,90,LTAdatasets/9706/annotate/9706-2021_03_20_191234.jpg,226.0,82.0,0.353125,0.22777777777777777,0.01875,0.044444444444444446
9706-2021_03_20_191234.jpg,car,11,296,640,18,360,71,1,307,89,LTAdatasets/9706/annotate/9706-2021_03_20_191234.jpg,301.5,80.0,0.47109375,0.2222222222222222,0.0171875,0.05
9706-2021_03_20_191234.jpg,car,22,303,640,23,360,108,1,325,131,LTAdatasets/9706/annotate/9706-2021_03_20_191234.jpg,314.0,119.5,0.490625,0.33194444444444443,0.034375,0.06388888888888888
9706-2021_03_20_191234.jpg,car,16,311,640,16,360,68,1,327,84,LTAdatasets/9706/annotate/9706-2021_03_20_191234.jpg,319.0,76.0,0.4984375,0.2111111111111111,0.025,0.044444444444444446
9706-2021_03_20_191234.jpg,car,7,286,640,10,360,60,1,293,70,LTAdatasets/9706/annotate/9706-2021_03_20_191234.jpg,289.5,65.0,0.45234375,0.18055555555555555,0.0109375,0.027777777777777776
9706-2021_03_20_191234.jpg,car,11,299,640,9,360,54,1,310,63,LTAdatasets/9706/annotate/9706-2021_03_20_191234.jpg,304.5,58.5,0.47578125,0.1625,0.0171875,0.025
9706-2021_03_20_191234.jpg,car,11,237,640,9,360,52,1,248,61,LTAdatasets/9706/annotate/9706-2021_03_20_191234.jpg,242.5,56.5,0.37890625,0.15694444444444444,0.0171875,0.025
9706-2021_03_20_191234.jpg,bike,8,146,640,18,360,138,4,154,156,LTAdatasets/9706/annotate/9706-2021_03_20_191234.jpg,150.0,147.0,0.234375,0.4083333333333333,0.0125,0.05
9706-2021_03_20_191234.jpg,car,11,235,640,8,360,38,1,246,46,LTAdatasets/9706/annotate/9706-2021_03_20_191234.jpg,240.5,42.0,0.37578125,0.11666666666666667,0.0171875,0.022222222222222223
9706-2021_03_20_191234.jpg,car,15,291,640,9,360,46,1,306,55,LTAdatasets/9706/annotate/9706-2021_03_20_191234.jpg,298.5,50.5,0.46640625,0.14027777777777778,0.0234375,0.025
9706-2021_03_20_191234.jpg,bike,9,223,640,10,360,52,4,232,62,LTAdatasets/9706/annotate/9706-2021_03_20_191234.jpg,227.5,57.0,0.35546875,0.15833333333333333,0.0140625,0.027777777777777776
9706-2021_03_20_074918.jpg,bike,17,124,640,21,360,163,4,141,184,LTAdatasets/9706/annotate/9706-2021_03_20_074918.jpg,132.5,173.5,0.20703125,0.48194444444444445,0.0265625,0.058333333333333334
9706-2021_03_20_074918.jpg,bike,10,319,640,12,360,79,4,329,91,LTAdatasets/9706/annotate/9706-2021_03_20_074918.jpg,324.0,85.0,0.50625,0.2361111111111111,0.015625,0.03333333333333333
9706-2021_03_20_074918.jpg,car,34,334,640,50,360,205,1,368,255,LTAdatasets/9706/annotate/9706-2021_03_20_074918.jpg,351.0,230.0,0.5484375,0.6388888888888888,0.053125,0.1388888888888889
9706-2021_03_20_074918.jpg,lorry_truck,34,352,640,33,360,146,2,386,179,LTAdatasets/9706/annotate/9706-2021_03_20_074918.jpg,369.0,162.5,0.5765625,0.4513888888888889,0.053125,0.09166666666666666
9706-2021_03_20_074918.jpg,car,14,329,640,15,360,95,1,343,110,LTAdatasets/9706/annotate/9706-2021_03_20_074918.jpg,336.0,102.5,0.525,0.2847222222222222,0.021875,0.041666666666666664
9706-2021_03_20_074918.jpg,lorry_truck,12,199,640,25,360,106,2,211,131,LTAdatasets/9706/annotate/9706-2021_03_20_074918.jpg,205.0,118.5,0.3203125,0.32916666666666666,0.01875,0.06944444444444445
9706-2021_03_20_074918.jpg,lorry_truck,18,216,640,22,360,68,2,234,90,LTAdatasets/9706/annotate/9706-2021_03_20_074918.jpg,225.0,79.0,0.3515625,0.21944444444444444,0.028125,0.06111111111111111
9706-2021_03_20_074918.jpg,lorry_truck,25,335,640,20,360,75,2,360,95,LTAdatasets/9706/annotate/9706-2021_03_20_074918.jpg,347.5,85.0,0.54296875,0.2361111111111111,0.0390625,0.05555555555555555
9706-2021_03_20_074918.jpg,lorry_truck,16,309,640,12,360,48,2,325,60,LTAdatasets/9706/annotate/9706-2021_03_20_074918.jpg,317.0,54.0,0.4953125,0.15,0.025,0.03333333333333333
9706-2021_03_20_074918.jpg,van,12,294,640,11,360,47,3,306,58,LTAdatasets/9706/annotate/9706-2021_03_20_074918.jpg,300.0,52.5,0.46875,0.14583333333333334,0.01875,0.030555555555555555
9706-2021_03_20_074918.jpg,car,16,238,640,11,360,81,1,254,92,LTAdatasets/9706/annotate/9706-2021_03_20_074918.jpg,246.0,86.5,0.384375,0.24027777777777778,0.025,0.030555555555555555
9706-2021_03_20_074918.jpg,lorry_truck,9,224,640,10,360,48,2,233,58,LTAdatasets/9706/annotate/9706-2021_03_20_074918.jpg,228.5,53.0,0.35703125,0.14722222222222223,0.0140625,0.027777777777777776
2704-2021_03_20_091903.jpg,lorry_truck,21,261,640,18,360,101,2,282,119,LTAdatasets/2704/annotate/2704-2021_03_20_091903.jpg,271.5,110.0,0.42421875,0.3055555555555556,0.0328125,0.05
2704-2021_03_20_091903.jpg,van,23,2,640,29,360,215,3,25,244,LTAdatasets/2704/annotate/2704-2021_03_20_091903.jpg,13.5,229.5,0.02109375,0.6375,0.0359375,0.08055555555555556
2704-2021_03_20_091903.jpg,bike,16,38,640,22,360,241,4,54,263,LTAdatasets/2704/annotate/2704-2021_03_20_091903.jpg,46.0,252.0,0.071875,0.7,0.025,0.06111111111111111
2704-2021_03_20_202758.jpg,car,16,63,640,15,360,179,1,79,194,LTAdatasets/2704/annotate/2704-2021_03_20_202758.jpg,71.0,186.5,0.1109375,0.5180555555555556,0.025,0.041666666666666664
2704-2021_03_20_082740.jpg,lorry_truck,12,266,640,18,360,108,2,278,126,LTAdatasets/2704/annotate/2704-2021_03_20_082740.jpg,272.0,117.0,0.425,0.325,0.01875,0.05
2704-2021_03_20_080119.jpg,lorry_truck,25,36,640,27,360,191,2,61,218,LTAdatasets/2704/annotate/2704-2021_03_20_080119.jpg,48.5,204.5,0.07578125,0.5680555555555555,0.0390625,0.075
2704-2021_03_20_200416.jpg,bike,10,68,640,18,360,184,4,78,202,LTAdatasets/2704/annotate/2704-2021_03_20_200416.jpg,73.0,193.0,0.1140625,0.5361111111111111,0.015625,0.05
2704-2021_03_20_181851.jpg,bus,29,611,640,30,360,162,5,640,192,LTAdatasets/2704/annotate/2704-2021_03_20_181851.jpg,625.5,177.0,0.97734375,0.49166666666666664,0.0453125,0.08333333333333333
2704-2021_03_20_183412.jpg,car,17,309,640,18,360,147,1,326,165,LTAdatasets/2704/annotate/2704-2021_03_20_183412.jpg,317.5,156.0,0.49609375,0.43333333333333335,0.0265625,0.05
2704-2021_03_20_183412.jpg,lorry_truck,15,266,640,28,360,94,2,281,122,LTAdatasets/2704/annotate/2704-2021_03_20_183412.jpg,273.5,108.0,0.42734375,0.3,0.0234375,0.07777777777777778
2704-2021_03_20_184913.jpg,lorry_truck,72,281,640,96,360,196,2,353,292,LTAdatasets/2704/annotate/2704-2021_03_20_184913.jpg,317.0,244.0,0.4953125,0.6777777777777778,0.1125,0.26666666666666666
2704-2021_03_20_184913.jpg,lorry_truck,22,33,640,26,360,202,2,55,228,LTAdatasets/2704/annotate/2704-2021_03_20_184913.jpg,44.0,215.0,0.06875,0.5972222222222222,0.034375,0.07222222222222222
2704-2021_03_20_095205.jpg,van,28,556,640,36,360,191,3,584,227,LTAdatasets/2704/annotate/2704-2021_03_20_095205.jpg,570.0,209.0,0.890625,0.5805555555555556,0.04375,0.1
2704-2021_03_20_182451.jpg,bike,8,288,640,14,360,117,4,296,131,LTAdatasets/2704/annotate/2704-2021_03_20_182451.jpg,292.0,124.0,0.45625,0.34444444444444444,0.0125,0.03888888888888889
2704-2021_03_20_180110.jpg,car,63,366,640,53,360,307,1,429,360,LTAdatasets/2704/annotate/2704-2021_03_20_180110.jpg,397.5,333.5,0.62109375,0.9263888888888889,0.0984375,0.14722222222222223
2704-2021_03_20_180110.jpg,car,29,272,640,28,360,171,1,301,199,LTAdatasets/2704/annotate/2704-2021_03_20_180110.jpg,286.5,185.0,0.44765625,0.5138888888888888,0.0453125,0.07777777777777778
2704-2021_03_20_180110.jpg,lorry_truck,38,12,640,48,360,200,2,50,248,LTAdatasets/2704/annotate/2704-2021_03_20_180110.jpg,31.0,224.0,0.0484375,0.6222222222222222,0.059375,0.13333333333333333
2704-2021_03_20_190413.jpg,car,39,294,640,46,360,226,1,333,272,LTAdatasets/2704/annotate/2704-2021_03_20_190413.jpg,313.5,249.0,0.48984375,0.6916666666666667,0.0609375,0.12777777777777777
2704-2021_03_20_190413.jpg,bike,12,5,640,23,360,213,4,17,236,LTAdatasets/2704/annotate/2704-2021_03_20_190413.jpg,11.0,224.5,0.0171875,0.6236111111111111,0.01875,0.06388888888888888
2704-2021_03_20_202217.jpg,lorry_truck,29,268,640,41,360,134,2,297,175,LTAdatasets/2704/annotate/2704-2021_03_20_202217.jpg,282.5,154.5,0.44140625,0.42916666666666664,0.0453125,0.11388888888888889
2704-2021_03_20_195736.jpg,car,15,264,640,15,360,120,1,279,135,LTAdatasets/2704/annotate/2704-2021_03_20_195736.jpg,271.5,127.5,0.42421875,0.3541666666666667,0.0234375,0.041666666666666664
2704-2021_03_20_195736.jpg,bike,10,286,640,18,360,111,4,296,129,LTAdatasets/2704/annotate/2704-2021_03_20_195736.jpg,291.0,120.0,0.4546875,0.3333333333333333,0.015625,0.05
2704-2021_03_20_080719.jpg,car,20,276,640,19,360,134,1,296,153,LTAdatasets/2704/annotate/2704-2021_03_20_080719.jpg,286.0,143.5,0.446875,0.39861111111111114,0.03125,0.05277777777777778
2704-2021_03_20_080719.jpg,bus,43,0,640,48,360,183,5,43,231,LTAdatasets/2704/annotate/2704-2021_03_20_080719.jpg,21.5,207.0,0.03359375,0.575,0.0671875,0.13333333333333333
2704-2021_03_20_183952.jpg,car,21,318,640,24,360,160,1,339,184,LTAdatasets/2704/annotate/2704-2021_03_20_183952.jpg,328.5,172.0,0.51328125,0.4777777777777778,0.0328125,0.06666666666666667
2704-2021_03_20_183952.jpg,bike,12,288,640,15,360,140,4,300,155,LTAdatasets/2704/annotate/2704-2021_03_20_183952.jpg,294.0,147.5,0.459375,0.4097222222222222,0.01875,0.041666666666666664
2704-2021_03_20_183952.jpg,lorry_truck,55,518,640,55,360,166,2,573,221,LTAdatasets/2704/annotate/2704-2021_03_20_183952.jpg,545.5,193.5,0.85234375,0.5375,0.0859375,0.1527777777777778
2704-2021_03_20_183952.jpg,bus,38,599,640,32,360,152,5,637,184,LTAdatasets/2704/annotate/2704-2021_03_20_183952.jpg,618.0,168.0,0.965625,0.4666666666666667,0.059375,0.08888888888888889
2704-2021_03_20_181551.jpg,car,35,551,640,28,360,200,1,586,228,LTAdatasets/2704/annotate/2704-2021_03_20_181551.jpg,568.5,214.0,0.88828125,0.5944444444444444,0.0546875,0.07777777777777778
2704-2021_03_20_090102.jpg,car,21,61,640,19,360,208,1,82,227,LTAdatasets/2704/annotate/2704-2021_03_20_090102.jpg,71.5,217.5,0.11171875,0.6041666666666666,0.0328125,0.05277777777777778
2704-2021_03_20_092143.jpg,lorry_truck,103,270,640,165,360,186,2,373,351,LTAdatasets/2704/annotate/2704-2021_03_20_092143.jpg,321.5,268.5,0.50234375,0.7458333333333333,0.1609375,0.4583333333333333
2704-2021_03_20_092143.jpg,lorry_truck,30,261,640,35,360,121,2,291,156,LTAdatasets/2704/annotate/2704-2021_03_20_092143.jpg,276.0,138.5,0.43125,0.38472222222222224,0.046875,0.09722222222222222
2704-2021_03_20_092143.jpg,car,23,46,640,24,360,219,1,69,243,LTAdatasets/2704/annotate/2704-2021_03_20_092143.jpg,57.5,231.0,0.08984375,0.6416666666666667,0.0359375,0.06666666666666667
2704-2021_03_20_180410.jpg,car,23,36,640,24,360,203,1,59,227,LTAdatasets/2704/annotate/2704-2021_03_20_180410.jpg,47.5,215.0,0.07421875,0.5972222222222222,0.0359375,0.06666666666666667
2704-2021_03_20_180410.jpg,van,33,485,640,18,360,175,3,518,193,LTAdatasets/2704/annotate/2704-2021_03_20_180410.jpg,501.5,184.0,0.78359375,0.5111111111111111,0.0515625,0.05
2704-2021_03_20_084001.jpg,bike,12,271,640,18,360,134,4,283,152,LTAdatasets/2704/annotate/2704-2021_03_20_084001.jpg,277.0,143.0,0.4328125,0.3972222222222222,0.01875,0.05
2704-2021_03_20_084001.jpg,car,16,624,640,18,360,180,1,640,198,LTAdatasets/2704/annotate/2704-2021_03_20_084001.jpg,632.0,189.0,0.9875,0.525,0.025,0.05
2704-2021_03_20_073417.jpg,lorry_truck,16,263,640,20,360,101,2,279,121,LTAdatasets/2704/annotate/2704-2021_03_20_073417.jpg,271.0,111.0,0.4234375,0.30833333333333335,0.025,0.05555555555555555
2704-2021_03_20_193115.jpg,lorry_truck,91,275,640,128,360,232,2,366,360,LTAdatasets/2704/annotate/2704-2021_03_20_193115.jpg,320.5,296.0,0.50078125,0.8222222222222222,0.1421875,0.35555555555555557
2704-2021_03_20_193115.jpg,bus,36,25,640,37,360,164,5,61,201,LTAdatasets/2704/annotate/2704-2021_03_20_193115.jpg,43.0,182.5,0.0671875,0.5069444444444444,0.05625,0.10277777777777777
2704-2021_03_20_082440.jpg,bike,9,277,640,16,360,121,4,286,137,LTAdatasets/2704/annotate/2704-2021_03_20_082440.jpg,281.5,129.0,0.43984375,0.35833333333333334,0.0140625,0.044444444444444446
2704-2021_03_20_085501.jpg,car,60,378,640,59,360,288,1,438,347,LTAdatasets/2704/annotate/2704-2021_03_20_085501.jpg,408.0,317.5,0.6375,0.8819444444444444,0.09375,0.1638888888888889
2704-2021_03_20_203058.jpg,car,20,31,640,22,360,203,1,51,225,LTAdatasets/2704/annotate/2704-2021_03_20_203058.jpg,41.0,214.0,0.0640625,0.5944444444444444,0.03125,0.06111111111111111
2704-2021_03_20_203058.jpg,lorry_truck,45,584,640,60,360,174,2,629,234,LTAdatasets/2704/annotate/2704-2021_03_20_203058.jpg,606.5,204.0,0.94765625,0.5666666666666667,0.0703125,0.16666666666666666
2704-2021_03_20_203058.jpg,lorry_truck,58,279,640,94,360,209,2,337,303,LTAdatasets/2704/annotate/2704-2021_03_20_203058.jpg,308.0,256.0,0.48125,0.7111111111111111,0.090625,0.2611111111111111
2704-2021_03_20_094305.jpg,lorry_truck,61,255,640,91,360,181,2,316,272,LTAdatasets/2704/annotate/2704-2021_03_20_094305.jpg,285.5,226.5,0.44609375,0.6291666666666667,0.0953125,0.25277777777777777
2704-2021_03_20_181251.jpg,bus,37,2,640,42,360,187,5,39,229,LTAdatasets/2704/annotate/2704-2021_03_20_181251.jpg,20.5,208.0,0.03203125,0.5777777777777777,0.0578125,0.11666666666666667
2704-2021_03_20_090702.jpg,lorry_truck,40,281,640,48,360,152,2,321,200,LTAdatasets/2704/annotate/2704-2021_03_20_090702.jpg,301.0,176.0,0.4703125,0.4888888888888889,0.0625,0.13333333333333333
2704-2021_03_20_090702.jpg,lorry_truck,18,262,640,25,360,111,2,280,136,LTAdatasets/2704/annotate/2704-2021_03_20_090702.jpg,271.0,123.5,0.4234375,0.34305555555555556,0.028125,0.06944444444444445
2704-2021_03_20_081319.jpg,van,28,42,640,31,360,196,3,70,227,LTAdatasets/2704/annotate/2704-2021_03_20_081319.jpg,56.0,211.5,0.0875,0.5875,0.04375,0.08611111111111111
2704-2021_03_20_203358.jpg,lorry_truck,15,264,640,22,360,102,2,279,124,LTAdatasets/2704/annotate/2704-2021_03_20_203358.jpg,271.5,113.0,0.42421875,0.3138888888888889,0.0234375,0.06111111111111111
2704-2021_03_20_192214.jpg,bike,14,37,640,19,360,189,4,51,208,LTAdatasets/2704/annotate/2704-2021_03_20_192214.jpg,44.0,198.5,0.06875,0.5513888888888889,0.021875,0.05277777777777778
2704-2021_03_20_185153.jpg,car,20,57,640,21,360,222,1,77,243,LTAdatasets/2704/annotate/2704-2021_03_20_185153.jpg,67.0,232.5,0.1046875,0.6458333333333334,0.03125,0.058333333333333334
2704-2021_03_20_185153.jpg,car,21,34,640,25,360,202,1,55,227,LTAdatasets/2704/annotate/2704-2021_03_20_185153.jpg,44.5,214.5,0.06953125,0.5958333333333333,0.0328125,0.06944444444444445
2704-2021_03_20_191614.jpg,car,12,6,640,19,360,214,1,18,233,LTAdatasets/2704/annotate/2704-2021_03_20_191614.jpg,12.0,223.5,0.01875,0.6208333333333333,0.01875,0.05277777777777778
2704-2021_03_20_193935.jpg,van,24,262,640,22,360,127,3,286,149,LTAdatasets/2704/annotate/2704-2021_03_20_193935.jpg,274.0,138.0,0.428125,0.38333333333333336,0.0375,0.06111111111111111
2704-2021_03_20_075518.jpg,car,21,49,640,21,360,219,1,70,240,LTAdatasets/2704/annotate/2704-2021_03_20_075518.jpg,59.5,229.5,0.09296875,0.6375,0.0328125,0.058333333333333334
2704-2021_03_20_075518.jpg,car,14,284,640,13,360,112,1,298,125,LTAdatasets/2704/annotate/2704-2021_03_20_075518.jpg,291.0,118.5,0.4546875,0.32916666666666666,0.021875,0.03611111111111111
2704-2021_03_20_184613.jpg,car,24,312,640,18,360,159,1,336,177,LTAdatasets/2704/annotate/2704-2021_03_20_184613.jpg,324.0,168.0,0.50625,0.4666666666666667,0.0375,0.05
2704-2021_03_20_083120.jpg,car,50,578,640,38,360,211,1,628,249,LTAdatasets/2704/annotate/2704-2021_03_20_083120.jpg,603.0,230.0,0.9421875,0.6388888888888888,0.078125,0.10555555555555556
2704-2021_03_20_083120.jpg,car,30,19,640,33,360,252,1,49,285,LTAdatasets/2704/annotate/2704-2021_03_20_083120.jpg,34.0,268.5,0.053125,0.7458333333333333,0.046875,0.09166666666666666
2704-2021_03_20_181011.jpg,car,28,527,640,19,360,190,1,555,209,LTAdatasets/2704/annotate/2704-2021_03_20_181011.jpg,541.0,199.5,0.8453125,0.5541666666666667,0.04375,0.05277777777777778
2704-2021_03_20_200116.jpg,bus,23,56,640,30,360,154,5,79,184,LTAdatasets/2704/annotate/2704-2021_03_20_200116.jpg,67.5,169.0,0.10546875,0.46944444444444444,0.0359375,0.08333333333333333
2704-2021_03_20_194916.jpg,car,15,271,640,10,360,119,1,286,129,LTAdatasets/2704/annotate/2704-2021_03_20_194916.jpg,278.5,124.0,0.43515625,0.34444444444444444,0.0234375,0.027777777777777776
2704-2021_03_20_183112.jpg,lorry_truck,32,10,640,26,360,212,2,42,238,LTAdatasets/2704/annotate/2704-2021_03_20_183112.jpg,26.0,225.0,0.040625,0.625,0.05,0.07222222222222222
2704-2021_03_20_201917.jpg,car,13,268,640,12,360,117,1,281,129,LTAdatasets/2704/annotate/2704-2021_03_20_201917.jpg,274.5,123.0,0.42890625,0.3416666666666667,0.0203125,0.03333333333333333
2704-2021_03_20_094024.jpg,lorry_truck,20,275,640,21,360,148,2,295,169,LTAdatasets/2704/annotate/2704-2021_03_20_094024.jpg,285.0,158.5,0.4453125,0.44027777777777777,0.03125,0.058333333333333334
2704-2021_03_20_094605.jpg,lorry_truck,94,259,640,82,360,278,2,353,360,LTAdatasets/2704/annotate/2704-2021_03_20_094605.jpg,306.0,319.0,0.478125,0.8861111111111111,0.146875,0.22777777777777777
2704-2021_03_20_094605.jpg,lorry_truck,12,268,640,11,360,109,2,280,120,LTAdatasets/2704/annotate/2704-2021_03_20_094605.jpg,274.0,114.5,0.428125,0.31805555555555554,0.01875,0.030555555555555555
2704-2021_03_20_093103.jpg,bus,22,0,640,44,360,192,5,22,236,LTAdatasets/2704/annotate/2704-2021_03_20_093103.jpg,11.0,214.0,0.0171875,0.5944444444444444,0.034375,0.12222222222222222
2704-2021_03_20_190113.jpg,lorry_truck,22,260,640,22,360,102,2,282,124,LTAdatasets/2704/annotate/2704-2021_03_20_190113.jpg,271.0,113.0,0.4234375,0.3138888888888889,0.034375,0.06111111111111111
2704-2021_03_20_074318.jpg,lorry_truck,25,615,640,37,360,228,2,640,265,LTAdatasets/2704/annotate/2704-2021_03_20_074318.jpg,627.5,246.5,0.98046875,0.6847222222222222,0.0390625,0.10277777777777777
2704-2021_03_20_081539.jpg,lorry_truck,19,265,640,26,360,111,2,284,137,LTAdatasets/2704/annotate/2704-2021_03_20_081539.jpg,274.5,124.0,0.42890625,0.34444444444444444,0.0296875,0.07222222222222222
2704-2021_03_20_081539.jpg,van,31,11,640,31,360,214,3,42,245,LTAdatasets/2704/annotate/2704-2021_03_20_081539.jpg,26.5,229.5,0.04140625,0.6375,0.0484375,0.08611111111111111
2704-2021_03_20_192515.jpg,car,17,264,640,12,360,112,1,281,124,LTAdatasets/2704/annotate/2704-2021_03_20_192515.jpg,272.5,118.0,0.42578125,0.3277777777777778,0.0265625,0.03333333333333333
2704-2021_03_20_075138.jpg,car,19,43,640,24,360,197,1,62,221,LTAdatasets/2704/annotate/2704-2021_03_20_075138.jpg,52.5,209.0,0.08203125,0.5805555555555556,0.0296875,0.06666666666666667
2704-2021_03_20_081920.jpg,lorry_truck,21,261,640,28,360,114,2,282,142,LTAdatasets/2704/annotate/2704-2021_03_20_081920.jpg,271.5,128.0,0.42421875,0.35555555555555557,0.0328125,0.07777777777777778
2704-2021_03_20_091002.jpg,van,29,609,640,44,360,213,3,638,257,LTAdatasets/2704/annotate/2704-2021_03_20_091002.jpg,623.5,235.0,0.97421875,0.6527777777777778,0.0453125,0.12222222222222222
2704-2021_03_20_073937.jpg,car,26,302,640,32,360,188,1,328,220,LTAdatasets/2704/annotate/2704-2021_03_20_073937.jpg,315.0,204.0,0.4921875,0.5666666666666667,0.040625,0.08888888888888889
2704-2021_03_20_092543.jpg,car,32,326,640,22,360,181,1,358,203,LTAdatasets/2704/annotate/2704-2021_03_20_092543.jpg,342.0,192.0,0.534375,0.5333333333333333,0.05,0.06111111111111111
2704-2021_03_20_201317.jpg,car,12,74,640,16,360,175,1,86,191,LTAdatasets/2704/annotate/2704-2021_03_20_201317.jpg,80.0,183.0,0.125,0.5083333333333333,0.01875,0.044444444444444446
2704-2021_03_20_190634.jpg,lorry_truck,45,284,640,64,360,206,2,329,270,LTAdatasets/2704/annotate/2704-2021_03_20_190634.jpg,306.5,238.0,0.47890625,0.6611111111111111,0.0703125,0.17777777777777778
2704-2021_03_20_080419.jpg,lorry_truck,50,527,640,41,360,176,2,577,217,LTAdatasets/2704/annotate/2704-2021_03_20_080419.jpg,552.0,196.5,0.8625,0.5458333333333333,0.078125,0.11388888888888889
2704-2021_03_20_083640.jpg,car,18,69,640,11,360,183,1,87,194,LTAdatasets/2704/annotate/2704-2021_03_20_083640.jpg,78.0,188.5,0.121875,0.5236111111111111,0.028125,0.030555555555555555
2704-2021_03_20_093424.jpg,lorry_truck,16,261,640,21,360,109,2,277,130,LTAdatasets/2704/annotate/2704-2021_03_20_093424.jpg,269.0,119.5,0.4203125,0.33194444444444443,0.025,0.058333333333333334
2704-2021_03_20_091302.jpg,car,14,68,640,14,360,159,1,82,173,LTAdatasets/2704/annotate/2704-2021_03_20_091302.jpg,75.0,166.0,0.1171875,0.46111111111111114,0.021875,0.03888888888888889
2704-2021_03_20_100105.jpg,car,25,327,640,17,360,169,1,352,186,LTAdatasets/2704/annotate/2704-2021_03_20_100105.jpg,339.5,177.5,0.53046875,0.4930555555555556,0.0390625,0.04722222222222222
2704-2021_03_20_202437.jpg,car,16,70,640,15,360,177,1,86,192,LTAdatasets/2704/annotate/2704-2021_03_20_202437.jpg,78.0,184.5,0.121875,0.5125,0.025,0.041666666666666664
2704-2021_03_20_191014.jpg,car,26,46,640,21,360,224,1,72,245,LTAdatasets/2704/annotate/2704-2021_03_20_191014.jpg,59.0,234.5,0.0921875,0.6513888888888889,0.040625,0.058333333333333334
2704-2021_03_20_191014.jpg,car,17,267,640,18,360,132,1,284,150,LTAdatasets/2704/annotate/2704-2021_03_20_191014.jpg,275.5,141.0,0.43046875,0.39166666666666666,0.0265625,0.05
1504-2021_03_20_082440.jpg,van,9,167,320,7,240,14,3,176,21,LTAdatasets/1504/annotate/1504-2021_03_20_082440.jpg,171.5,17.5,0.5359375,0.07291666666666667,0.028125,0.029166666666666667
1504-2021_03_20_212801.jpg,car,11,169,320,11,240,11,1,180,22,LTAdatasets/1504/annotate/1504-2021_03_20_212801.jpg,174.5,16.5,0.5453125,0.06875,0.034375,0.04583333333333333
1504-2021_03_20_191234.jpg,bike,9,151,320,14,240,29,4,160,43,LTAdatasets/1504/annotate/1504-2021_03_20_191234.jpg,155.5,36.0,0.4859375,0.15,0.028125,0.058333333333333334
1504-2021_03_20_214902.jpg,car,27,133,320,31,240,63,1,160,94,LTAdatasets/1504/annotate/1504-2021_03_20_214902.jpg,146.5,78.5,0.4578125,0.32708333333333334,0.084375,0.12916666666666668
1504-2021_03_20_072817.jpg,car,25,186,320,27,240,55,1,211,82,LTAdatasets/1504/annotate/1504-2021_03_20_072817.jpg,198.5,68.5,0.6203125,0.28541666666666665,0.078125,0.1125
1504-2021_03_20_072817.jpg,lorry_truck,16,158,320,17,240,13,2,174,30,LTAdatasets/1504/annotate/1504-2021_03_20_072817.jpg,166.0,21.5,0.51875,0.08958333333333333,0.05,0.07083333333333333
1504-2021_03_20_214302.jpg,car,60,123,320,78,240,162,1,183,240,LTAdatasets/1504/annotate/1504-2021_03_20_214302.jpg,153.0,201.0,0.478125,0.8375,0.1875,0.325
1504-2021_03_20_184613.jpg,car,25,137,320,32,240,67,1,162,99,LTAdatasets/1504/annotate/1504-2021_03_20_184613.jpg,149.5,83.0,0.4671875,0.3458333333333333,0.078125,0.13333333333333333
1504-2021_03_20_184613.jpg,car,31,59,320,44,240,105,1,90,149,LTAdatasets/1504/annotate/1504-2021_03_20_184613.jpg,74.5,127.0,0.2328125,0.5291666666666667,0.096875,0.18333333333333332
1504-2021_03_20_184613.jpg,car,15,154,320,16,240,27,1,169,43,LTAdatasets/1504/annotate/1504-2021_03_20_184613.jpg,161.5,35.0,0.5046875,0.14583333333333334,0.046875,0.06666666666666667
1504-2021_03_20_184613.jpg,van,23,180,320,31,240,48,3,203,79,LTAdatasets/1504/annotate/1504-2021_03_20_184613.jpg,191.5,63.5,0.5984375,0.26458333333333334,0.071875,0.12916666666666668
1504-2021_03_20_184613.jpg,bike,6,161,320,8,240,20,4,167,28,LTAdatasets/1504/annotate/1504-2021_03_20_184613.jpg,164.0,24.0,0.5125,0.1,0.01875,0.03333333333333333
1504-2021_03_20_184613.jpg,bike,6,153,320,10,240,14,4,159,24,LTAdatasets/1504/annotate/1504-2021_03_20_184613.jpg,156.0,19.0,0.4875,0.07916666666666666,0.01875,0.041666666666666664
1504-2021_03_20_075818.jpg,car,18,127,320,24,240,49,1,145,73,LTAdatasets/1504/annotate/1504-2021_03_20_075818.jpg,136.0,61.0,0.425,0.25416666666666665,0.05625,0.1
1504-2021_03_20_075818.jpg,car,44,35,320,90,240,141,1,79,231,LTAdatasets/1504/annotate/1504-2021_03_20_075818.jpg,57.0,186.0,0.178125,0.775,0.1375,0.375
1504-2021_03_20_075818.jpg,car,12,151,320,12,240,18,1,163,30,LTAdatasets/1504/annotate/1504-2021_03_20_075818.jpg,157.0,24.0,0.490625,0.1,0.0375,0.05
1504-2021_03_20_181851.jpg,lorry_truck,21,142,320,37,240,39,2,163,76,LTAdatasets/1504/annotate/1504-2021_03_20_181851.jpg,152.5,57.5,0.4765625,0.23958333333333334,0.065625,0.15416666666666667
1504-2021_03_20_181851.jpg,car,10,133,320,13,240,23,1,143,36,LTAdatasets/1504/annotate/1504-2021_03_20_181851.jpg,138.0,29.5,0.43125,0.12291666666666666,0.03125,0.05416666666666667
1504-2021_03_20_181851.jpg,lorry_truck,13,153,320,13,240,25,2,166,38,LTAdatasets/1504/annotate/1504-2021_03_20_181851.jpg,159.5,31.5,0.4984375,0.13125,0.040625,0.05416666666666667
1504-2021_03_20_183412.jpg,car,12,133,320,14,240,28,1,145,42,LTAdatasets/1504/annotate/1504-2021_03_20_183412.jpg,139.0,35.0,0.434375,0.14583333333333334,0.0375,0.058333333333333334
1504-2021_03_20_183412.jpg,car,9,178,320,7,240,20,1,187,27,LTAdatasets/1504/annotate/1504-2021_03_20_183412.jpg,182.5,23.5,0.5703125,0.09791666666666667,0.028125,0.029166666666666667
1504-2021_03_20_083640.jpg,car,8,169,320,11,240,12,1,177,23,LTAdatasets/1504/annotate/1504-2021_03_20_083640.jpg,173.0,17.5,0.540625,0.07291666666666667,0.025,0.04583333333333333
1504-2021_03_20_084301.jpg,bike,16,159,320,29,240,89,4,175,118,LTAdatasets/1504/annotate/1504-2021_03_20_084301.jpg,167.0,103.5,0.521875,0.43125,0.05,0.12083333333333333
1504-2021_03_20_084301.jpg,car,12,144,320,7,240,18,1,156,25,LTAdatasets/1504/annotate/1504-2021_03_20_084301.jpg,150.0,21.5,0.46875,0.08958333333333333,0.0375,0.029166666666666667
1504-2021_03_20_084301.jpg,car,8,164,320,7,240,13,1,172,20,LTAdatasets/1504/annotate/1504-2021_03_20_084301.jpg,168.0,16.5,0.525,0.06875,0.025,0.029166666666666667
1504-2021_03_20_093424.jpg,lorry_truck,16,151,320,26,240,22,2,167,48,LTAdatasets/1504/annotate/1504-2021_03_20_093424.jpg,159.0,35.0,0.496875,0.14583333333333334,0.05,0.10833333333333334
1504-2021_03_20_093424.jpg,lorry_truck,68,194,320,92,240,70,2,262,162,LTAdatasets/1504/annotate/1504-2021_03_20_093424.jpg,228.0,116.0,0.7125,0.48333333333333334,0.2125,0.38333333333333336
1504-2021_03_20_093424.jpg,car,47,32,320,74,240,166,1,79,240,LTAdatasets/1504/annotate/1504-2021_03_20_093424.jpg,55.5,203.0,0.1734375,0.8458333333333333,0.146875,0.30833333333333335
1504-2021_03_20_200416.jpg,car,17,123,320,15,240,29,1,140,44,LTAdatasets/1504/annotate/1504-2021_03_20_200416.jpg,131.5,36.5,0.4109375,0.15208333333333332,0.053125,0.0625
1504-2021_03_20_200416.jpg,lorry_truck,15,160,320,17,240,7,2,175,24,LTAdatasets/1504/annotate/1504-2021_03_20_200416.jpg,167.5,15.5,0.5234375,0.06458333333333334,0.046875,0.07083333333333333
1504-2021_03_20_062754.jpg,car,11,143,320,10,240,17,1,154,27,LTAdatasets/1504/annotate/1504-2021_03_20_062754.jpg,148.5,22.0,0.4640625,0.09166666666666666,0.034375,0.041666666666666664
1504-2021_03_20_062754.jpg,car,14,162,320,10,240,15,1,176,25,LTAdatasets/1504/annotate/1504-2021_03_20_062754.jpg,169.0,20.0,0.528125,0.08333333333333333,0.04375,0.041666666666666664
1504-2021_03_20_073937.jpg,car,17,119,320,14,240,35,1,136,49,LTAdatasets/1504/annotate/1504-2021_03_20_073937.jpg,127.5,42.0,0.3984375,0.175,0.053125,0.058333333333333334
1504-2021_03_20_073937.jpg,car,28,90,320,34,240,81,1,118,115,LTAdatasets/1504/annotate/1504-2021_03_20_073937.jpg,104.0,98.0,0.325,0.4083333333333333,0.0875,0.14166666666666666
1504-2021_03_20_073937.jpg,lorry_truck,20,157,320,21,240,16,2,177,37,LTAdatasets/1504/annotate/1504-2021_03_20_073937.jpg,167.0,26.5,0.521875,0.11041666666666666,0.0625,0.0875
1504-2021_03_20_085141.jpg,car,7,163,320,7,240,12,1,170,19,LTAdatasets/1504/annotate/1504-2021_03_20_085141.jpg,166.5,15.5,0.5203125,0.06458333333333334,0.021875,0.029166666666666667
1504-2021_03_20_085141.jpg,car,8,181,320,6,240,11,1,189,17,LTAdatasets/1504/annotate/1504-2021_03_20_085141.jpg,185.0,14.0,0.578125,0.058333333333333334,0.025,0.025
1504-2021_03_20_211900.jpg,car,15,173,320,16,240,29,1,188,45,LTAdatasets/1504/annotate/1504-2021_03_20_211900.jpg,180.5,37.0,0.5640625,0.15416666666666667,0.046875,0.06666666666666667
1504-2021_03_20_074918.jpg,lorry_truck,15,165,320,12,240,9,2,180,21,LTAdatasets/1504/annotate/1504-2021_03_20_074918.jpg,172.5,15.0,0.5390625,0.0625,0.046875,0.05
1504-2021_03_20_074918.jpg,lorry_truck,11,180,320,13,240,6,2,191,19,LTAdatasets/1504/annotate/1504-2021_03_20_074918.jpg,185.5,12.5,0.5796875,0.052083333333333336,0.034375,0.05416666666666667
1504-2021_03_20_182752.jpg,car,34,85,320,49,240,95,1,119,144,LTAdatasets/1504/annotate/1504-2021_03_20_182752.jpg,102.0,119.5,0.31875,0.4979166666666667,0.10625,0.20416666666666666
1504-2021_03_20_182752.jpg,car,15,126,320,15,240,29,1,141,44,LTAdatasets/1504/annotate/1504-2021_03_20_182752.jpg,133.5,36.5,0.4171875,0.15208333333333332,0.046875,0.0625
1504-2021_03_20_182451.jpg,car,59,195,320,73,240,137,1,254,210,LTAdatasets/1504/annotate/1504-2021_03_20_182451.jpg,224.5,173.5,0.7015625,0.7229166666666667,0.184375,0.30416666666666664
1504-2021_03_20_182451.jpg,car,59,11,320,59,240,181,1,70,240,LTAdatasets/1504/annotate/1504-2021_03_20_182451.jpg,40.5,210.5,0.1265625,0.8770833333333333,0.184375,0.24583333333333332
1504-2021_03_20_182451.jpg,van,12,154,320,13,240,18,3,166,31,LTAdatasets/1504/annotate/1504-2021_03_20_182451.jpg,160.0,24.5,0.5,0.10208333333333333,0.0375,0.05416666666666667
1504-2021_03_20_192515.jpg,car,15,169,320,12,240,30,1,184,42,LTAdatasets/1504/annotate/1504-2021_03_20_192515.jpg,176.5,36.0,0.5515625,0.15,0.046875,0.05
1504-2021_03_20_194315.jpg,van,20,130,320,27,240,46,3,150,73,LTAdatasets/1504/annotate/1504-2021_03_20_194315.jpg,140.0,59.5,0.4375,0.24791666666666667,0.0625,0.1125
1504-2021_03_20_195136.jpg,car,44,118,320,73,240,116,1,162,189,LTAdatasets/1504/annotate/1504-2021_03_20_195136.jpg,140.0,152.5,0.4375,0.6354166666666666,0.1375,0.30416666666666664
1504-2021_03_20_195136.jpg,car,15,154,320,13,240,31,1,169,44,LTAdatasets/1504/annotate/1504-2021_03_20_195136.jpg,161.5,37.5,0.5046875,0.15625,0.046875,0.05416666666666667
1504-2021_03_20_195136.jpg,car,13,136,320,10,240,21,1,149,31,LTAdatasets/1504/annotate/1504-2021_03_20_195136.jpg,142.5,26.0,0.4453125,0.10833333333333334,0.040625,0.041666666666666664
1504-2021_03_20_074318.jpg,car,26,88,320,31,240,75,1,114,106,LTAdatasets/1504/annotate/1504-2021_03_20_074318.jpg,101.0,90.5,0.315625,0.3770833333333333,0.08125,0.12916666666666668
1504-2021_03_20_202758.jpg,car,63,14,320,55,240,185,1,77,240,LTAdatasets/1504/annotate/1504-2021_03_20_202758.jpg,45.5,212.5,0.1421875,0.8854166666666666,0.196875,0.22916666666666666
1504-2021_03_20_202758.jpg,bike,9,162,320,11,240,23,4,171,34,LTAdatasets/1504/annotate/1504-2021_03_20_202758.jpg,166.5,28.5,0.5203125,0.11875,0.028125,0.04583333333333333
1504-2021_03_20_195736.jpg,bike,8,162,320,11,240,21,4,170,32,LTAdatasets/1504/annotate/1504-2021_03_20_195736.jpg,166.0,26.5,0.51875,0.11041666666666666,0.025,0.04583333333333333
1504-2021_03_20_195736.jpg,car,16,136,320,9,240,19,1,152,28,LTAdatasets/1504/annotate/1504-2021_03_20_195736.jpg,144.0,23.5,0.45,0.09791666666666667,0.05,0.0375
1504-2021_03_20_195736.jpg,car,17,148,320,15,240,36,1,165,51,LTAdatasets/1504/annotate/1504-2021_03_20_195736.jpg,156.5,43.5,0.4890625,0.18125,0.053125,0.0625
1504-2021_03_20_195736.jpg,car,62,94,320,70,240,170,1,156,240,LTAdatasets/1504/annotate/1504-2021_03_20_195736.jpg,125.0,205.0,0.390625,0.8541666666666666,0.19375,0.2916666666666667
1504-2021_03_20_094024.jpg,car,21,118,320,16,240,45,1,139,61,LTAdatasets/1504/annotate/1504-2021_03_20_094024.jpg,128.5,53.0,0.4015625,0.22083333333333333,0.065625,0.06666666666666667
1504-2021_03_20_094024.jpg,lorry_truck,15,178,320,14,240,3,2,193,17,LTAdatasets/1504/annotate/1504-2021_03_20_094024.jpg,185.5,10.0,0.5796875,0.041666666666666664,0.046875,0.058333333333333334
1504-2021_03_20_090702.jpg,bus,80,133,320,157,240,54,5,213,211,LTAdatasets/1504/annotate/1504-2021_03_20_090702.jpg,173.0,132.5,0.540625,0.5520833333333334,0.25,0.6541666666666667
1504-2021_03_20_090702.jpg,car,12,160,320,11,240,21,1,172,32,LTAdatasets/1504/annotate/1504-2021_03_20_090702.jpg,166.0,26.5,0.51875,0.11041666666666666,0.0375,0.04583333333333333
1504-2021_03_20_090702.jpg,van,13,135,320,14,240,18,3,148,32,LTAdatasets/1504/annotate/1504-2021_03_20_090702.jpg,141.5,25.0,0.4421875,0.10416666666666667,0.040625,0.058333333333333334
1504-2021_03_20_090702.jpg,car,9,153,320,6,240,15,1,162,21,LTAdatasets/1504/annotate/1504-2021_03_20_090702.jpg,157.5,18.0,0.4921875,0.075,0.028125,0.025
1504-2021_03_20_194916.jpg,car,24,179,320,21,240,46,1,203,67,LTAdatasets/1504/annotate/1504-2021_03_20_194916.jpg,191.0,56.5,0.596875,0.23541666666666666,0.075,0.0875
1504-2021_03_20_194916.jpg,car,15,131,320,15,240,21,1,146,36,LTAdatasets/1504/annotate/1504-2021_03_20_194916.jpg,138.5,28.5,0.4328125,0.11875,0.046875,0.0625
1504-2021_03_20_194916.jpg,car,14,159,320,9,240,15,1,173,24,LTAdatasets/1504/annotate/1504-2021_03_20_194916.jpg,166.0,19.5,0.51875,0.08125,0.04375,0.0375
1504-2021_03_20_184913.jpg,car,27,100,320,33,240,81,1,127,114,LTAdatasets/1504/annotate/1504-2021_03_20_184913.jpg,113.5,97.5,0.3546875,0.40625,0.084375,0.1375
1504-2021_03_20_184913.jpg,car,18,145,320,17,240,33,1,163,50,LTAdatasets/1504/annotate/1504-2021_03_20_184913.jpg,154.0,41.5,0.48125,0.17291666666666666,0.05625,0.07083333333333333
1504-2021_03_20_220403.jpg,car,23,147,320,19,240,41,1,170,60,LTAdatasets/1504/annotate/1504-2021_03_20_220403.jpg,158.5,50.5,0.4953125,0.21041666666666667,0.071875,0.07916666666666666
1504-2021_03_20_212501.jpg,car,61,134,320,75,240,165,1,195,240,LTAdatasets/1504/annotate/1504-2021_03_20_212501.jpg,164.5,202.5,0.5140625,0.84375,0.190625,0.3125
1504-2021_03_20_212501.jpg,car,27,163,320,31,240,55,1,190,86,LTAdatasets/1504/annotate/1504-2021_03_20_212501.jpg,176.5,70.5,0.5515625,0.29375,0.084375,0.12916666666666668
1504-2021_03_20_204919.jpg,car,23,114,320,12,240,35,1,137,47,LTAdatasets/1504/annotate/1504-2021_03_20_204919.jpg,125.5,41.0,0.3921875,0.17083333333333334,0.071875,0.05
1504-2021_03_20_204919.jpg,car,14,155,320,9,240,18,1,169,27,LTAdatasets/1504/annotate/1504-2021_03_20_204919.jpg,162.0,22.5,0.50625,0.09375,0.04375,0.0375
1504-2021_03_20_080939.jpg,car,23,102,320,23,240,41,1,125,64,LTAdatasets/1504/annotate/1504-2021_03_20_080939.jpg,113.5,52.5,0.3546875,0.21875,0.071875,0.09583333333333334
1504-2021_03_20_080939.jpg,car,14,152,320,12,240,23,1,166,35,LTAdatasets/1504/annotate/1504-2021_03_20_080939.jpg,159.0,29.0,0.496875,0.12083333333333333,0.04375,0.05
1504-2021_03_20_080939.jpg,lorry_truck,33,191,320,41,240,62,2,224,103,LTAdatasets/1504/annotate/1504-2021_03_20_080939.jpg,207.5,82.5,0.6484375,0.34375,0.103125,0.17083333333333334
1504-2021_03_20_185753.jpg,car,9,152,320,9,240,19,1,161,28,LTAdatasets/1504/annotate/1504-2021_03_20_185753.jpg,156.5,23.5,0.4890625,0.09791666666666667,0.028125,0.0375
1504-2021_03_20_092803.jpg,car,26,192,320,30,240,68,1,218,98,LTAdatasets/1504/annotate/1504-2021_03_20_092803.jpg,205.0,83.0,0.640625,0.3458333333333333,0.08125,0.125
1504-2021_03_20_092803.jpg,car,13,156,320,14,240,28,1,169,42,LTAdatasets/1504/annotate/1504-2021_03_20_092803.jpg,162.5,35.0,0.5078125,0.14583333333333334,0.040625,0.058333333333333334
1504-2021_03_20_204238.jpg,car,13,136,320,12,240,19,1,149,31,LTAdatasets/1504/annotate/1504-2021_03_20_204238.jpg,142.5,25.0,0.4453125,0.10416666666666667,0.040625,0.05
1504-2021_03_20_204238.jpg,bus,16,159,320,20,240,4,5,175,24,LTAdatasets/1504/annotate/1504-2021_03_20_204238.jpg,167.0,14.0,0.521875,0.058333333333333334,0.05,0.08333333333333333
1504-2021_03_20_192735.jpg,car,21,170,320,20,240,39,1,191,59,LTAdatasets/1504/annotate/1504-2021_03_20_192735.jpg,180.5,49.0,0.5640625,0.20416666666666666,0.065625,0.08333333333333333
1504-2021_03_20_183952.jpg,car,6,168,320,5,240,11,1,174,16,LTAdatasets/1504/annotate/1504-2021_03_20_183952.jpg,171.0,13.5,0.534375,0.05625,0.01875,0.020833333333333332
1504-2021_03_20_183952.jpg,car,9,177,320,7,240,12,1,186,19,LTAdatasets/1504/annotate/1504-2021_03_20_183952.jpg,181.5,15.5,0.5671875,0.06458333333333334,0.028125,0.029166666666666667
1504-2021_03_20_190413.jpg,lorry_truck,15,158,320,15,240,8,2,173,23,LTAdatasets/1504/annotate/1504-2021_03_20_190413.jpg,165.5,15.5,0.5171875,0.06458333333333334,0.046875,0.0625
1504-2021_03_20_101005.jpg,car,63,25,320,76,240,164,1,88,240,LTAdatasets/1504/annotate/1504-2021_03_20_101005.jpg,56.5,202.0,0.1765625,0.8416666666666667,0.196875,0.31666666666666665
1504-2021_03_20_101005.jpg,lorry_truck,12,169,320,9,240,10,2,181,19,LTAdatasets/1504/annotate/1504-2021_03_20_101005.jpg,175.0,14.5,0.546875,0.06041666666666667,0.0375,0.0375
1504-2021_03_20_181011.jpg,car,52,223,320,79,240,159,1,275,238,LTAdatasets/1504/annotate/1504-2021_03_20_181011.jpg,249.0,198.5,0.778125,0.8270833333333333,0.1625,0.32916666666666666
1504-2021_03_20_181011.jpg,car,10,178,320,9,240,27,1,188,36,LTAdatasets/1504/annotate/1504-2021_03_20_181011.jpg,183.0,31.5,0.571875,0.13125,0.03125,0.0375
1504-2021_03_20_181011.jpg,car,11,143,320,9,240,17,1,154,26,LTAdatasets/1504/annotate/1504-2021_03_20_181011.jpg,148.5,21.5,0.4640625,0.08958333333333333,0.034375,0.0375
1504-2021_03_20_181011.jpg,car,10,179,320,7,240,16,1,189,23,LTAdatasets/1504/annotate/1504-2021_03_20_181011.jpg,184.0,19.5,0.575,0.08125,0.03125,0.029166666666666667
1504-2021_03_20_095505.jpg,car,10,151,320,6,240,15,1,161,21,LTAdatasets/1504/annotate/1504-2021_03_20_095505.jpg,156.0,18.0,0.4875,0.075,0.03125,0.025
1504-2021_03_20_200637.jpg,car,46,48,320,84,240,120,1,94,204,LTAdatasets/1504/annotate/1504-2021_03_20_200637.jpg,71.0,162.0,0.221875,0.675,0.14375,0.35
1504-2021_03_20_200637.jpg,car,19,143,320,20,240,39,1,162,59,LTAdatasets/1504/annotate/1504-2021_03_20_200637.jpg,152.5,49.0,0.4765625,0.20416666666666666,0.059375,0.08333333333333333
1504-2021_03_20_193415.jpg,car,53,128,320,75,240,165,1,181,240,LTAdatasets/1504/annotate/1504-2021_03_20_193415.jpg,154.5,202.5,0.4828125,0.84375,0.165625,0.3125
1504-2021_03_20_193415.jpg,car,29,88,320,37,240,72,1,117,109,LTAdatasets/1504/annotate/1504-2021_03_20_193415.jpg,102.5,90.5,0.3203125,0.3770833333333333,0.090625,0.15416666666666667
1504-2021_03_20_193415.jpg,car,13,152,320,21,240,34,1,165,55,LTAdatasets/1504/annotate/1504-2021_03_20_193415.jpg,158.5,44.5,0.4953125,0.18541666666666667,0.040625,0.0875
1504-2021_03_20_193415.jpg,car,12,143,320,7,240,19,1,155,26,LTAdatasets/1504/annotate/1504-2021_03_20_193415.jpg,149.0,22.5,0.465625,0.09375,0.0375,0.029166666666666667
1504-2021_03_20_193415.jpg,car,10,157,320,7,240,12,1,167,19,LTAdatasets/1504/annotate/1504-2021_03_20_193415.jpg,162.0,15.5,0.50625,0.06458333333333334,0.03125,0.029166666666666667
1504-2021_03_20_083340.jpg,car,51,23,320,52,240,188,1,74,240,LTAdatasets/1504/annotate/1504-2021_03_20_083340.jpg,48.5,214.0,0.1515625,0.8916666666666667,0.159375,0.21666666666666667
1504-2021_03_20_083340.jpg,car,17,151,320,16,240,30,1,168,46,LTAdatasets/1504/annotate/1504-2021_03_20_083340.jpg,159.5,38.0,0.4984375,0.15833333333333333,0.053125,0.06666666666666667
1504-2021_03_20_094305.jpg,car,21,147,320,23,240,64,1,168,87,LTAdatasets/1504/annotate/1504-2021_03_20_094305.jpg,157.5,75.5,0.4921875,0.3145833333333333,0.065625,0.09583333333333334
1504-2021_03_20_094305.jpg,car,21,106,320,29,240,47,1,127,76,LTAdatasets/1504/annotate/1504-2021_03_20_094305.jpg,116.5,61.5,0.3640625,0.25625,0.065625,0.12083333333333333
1504-2021_03_20_094305.jpg,car,10,157,320,8,240,23,1,167,31,LTAdatasets/1504/annotate/1504-2021_03_20_094305.jpg,162.0,27.0,0.50625,0.1125,0.03125,0.03333333333333333
1504-2021_03_20_094305.jpg,car,10,154,320,6,240,15,1,164,21,LTAdatasets/1504/annotate/1504-2021_03_20_094305.jpg,159.0,18.0,0.496875,0.075,0.03125,0.025
1504-2021_03_20_094904.jpg,van,21,189,320,26,240,46,3,210,72,LTAdatasets/1504/annotate/1504-2021_03_20_094904.jpg,199.5,59.0,0.6234375,0.24583333333333332,0.065625,0.10833333333333334
1504-2021_03_20_094904.jpg,van,18,148,320,19,240,44,3,166,63,LTAdatasets/1504/annotate/1504-2021_03_20_094904.jpg,157.0,53.5,0.490625,0.22291666666666668,0.05625,0.07916666666666666
1504-2021_03_20_094904.jpg,car,8,148,320,9,240,14,1,156,23,LTAdatasets/1504/annotate/1504-2021_03_20_094904.jpg,152.0,18.5,0.475,0.07708333333333334,0.025,0.0375
1504-2021_03_20_181251.jpg,lorry_truck,32,183,320,46,240,33,2,215,79,LTAdatasets/1504/annotate/1504-2021_03_20_181251.jpg,199.0,56.0,0.621875,0.23333333333333334,0.1,0.19166666666666668
1504-2021_03_20_181251.jpg,lorry_truck,13,180,320,15,240,7,2,193,22,LTAdatasets/1504/annotate/1504-2021_03_20_181251.jpg,186.5,14.5,0.5828125,0.06041666666666667,0.040625,0.0625
1504-2021_03_20_181251.jpg,car,8,168,320,5,240,12,1,176,17,LTAdatasets/1504/annotate/1504-2021_03_20_181251.jpg,172.0,14.5,0.5375,0.06041666666666667,0.025,0.020833333333333332
1504-2021_03_20_071836.jpg,car,11,168,320,4,240,15,1,179,19,LTAdatasets/1504/annotate/1504-2021_03_20_071836.jpg,173.5,17.0,0.5421875,0.07083333333333333,0.034375,0.016666666666666666
1504-2021_03_20_205439.jpg,car,16,148,320,16,240,38,1,164,54,LTAdatasets/1504/annotate/1504-2021_03_20_205439.jpg,156.0,46.0,0.4875,0.19166666666666668,0.05,0.06666666666666667
1504-2021_03_20_070416.jpg,car,56,154,320,79,240,147,1,210,226,LTAdatasets/1504/annotate/1504-2021_03_20_070416.jpg,182.0,186.5,0.56875,0.7770833333333333,0.175,0.32916666666666666
1504-2021_03_20_070416.jpg,van,15,153,320,16,240,26,3,168,42,LTAdatasets/1504/annotate/1504-2021_03_20_070416.jpg,160.5,34.0,0.5015625,0.14166666666666666,0.046875,0.06666666666666667
1504-2021_03_20_070416.jpg,car,8,173,320,7,240,13,1,181,20,LTAdatasets/1504/annotate/1504-2021_03_20_070416.jpg,177.0,16.5,0.553125,0.06875,0.025,0.029166666666666667
1504-2021_03_20_070416.jpg,car,7,162,320,7,240,12,1,169,19,LTAdatasets/1504/annotate/1504-2021_03_20_070416.jpg,165.5,15.5,0.5171875,0.06458333333333334,0.021875,0.029166666666666667
1504-2021_03_20_185453.jpg,car,49,29,320,76,240,164,1,78,240,LTAdatasets/1504/annotate/1504-2021_03_20_185453.jpg,53.5,202.0,0.1671875,0.8416666666666667,0.153125,0.31666666666666665
1504-2021_03_20_081319.jpg,car,27,85,320,40,240,78,1,112,118,LTAdatasets/1504/annotate/1504-2021_03_20_081319.jpg,98.5,98.0,0.3078125,0.4083333333333333,0.084375,0.16666666666666666
1504-2021_03_20_081319.jpg,car,16,121,320,14,240,33,1,137,47,LTAdatasets/1504/annotate/1504-2021_03_20_081319.jpg,129.0,40.0,0.403125,0.16666666666666666,0.05,0.058333333333333334
1504-2021_03_20_081319.jpg,lorry_truck,18,151,320,28,240,12,2,169,40,LTAdatasets/1504/annotate/1504-2021_03_20_081319.jpg,160.0,26.0,0.5,0.10833333333333334,0.05625,0.11666666666666667
1504-2021_03_20_210940.jpg,car,21,146,320,16,240,35,1,167,51,LTAdatasets/1504/annotate/1504-2021_03_20_210940.jpg,156.5,43.0,0.4890625,0.17916666666666667,0.065625,0.06666666666666667
1504-2021_03_20_092543.jpg,car,35,169,320,46,240,81,1,204,127,LTAdatasets/1504/annotate/1504-2021_03_20_092543.jpg,186.5,104.0,0.5828125,0.43333333333333335,0.109375,0.19166666666666668
1504-2021_03_20_092543.jpg,car,28,95,320,28,240,66,1,123,94,LTAdatasets/1504/annotate/1504-2021_03_20_092543.jpg,109.0,80.0,0.340625,0.3333333333333333,0.0875,0.11666666666666667
1504-2021_03_20_092543.jpg,car,16,132,320,14,240,23,1,148,37,LTAdatasets/1504/annotate/1504-2021_03_20_092543.jpg,140.0,30.0,0.4375,0.125,0.05,0.058333333333333334
1504-2021_03_20_092543.jpg,car,15,173,320,12,240,28,1,188,40,LTAdatasets/1504/annotate/1504-2021_03_20_092543.jpg,180.5,34.0,0.5640625,0.14166666666666666,0.046875,0.05
1504-2021_03_20_092543.jpg,car,8,180,320,8,240,15,1,188,23,LTAdatasets/1504/annotate/1504-2021_03_20_092543.jpg,184.0,19.0,0.575,0.07916666666666666,0.025,0.03333333333333333
1504-2021_03_20_202437.jpg,car,19,121,320,14,240,33,1,140,47,LTAdatasets/1504/annotate/1504-2021_03_20_202437.jpg,130.5,40.0,0.4078125,0.16666666666666666,0.059375,0.058333333333333334
1504-2021_03_20_202437.jpg,car,13,143,320,7,240,17,1,156,24,LTAdatasets/1504/annotate/1504-2021_03_20_202437.jpg,149.5,20.5,0.4671875,0.08541666666666667,0.040625,0.029166666666666667
1504-2021_03_20_091302.jpg,car,30,112,320,44,240,87,1,142,131,LTAdatasets/1504/annotate/1504-2021_03_20_091302.jpg,127.0,109.0,0.396875,0.45416666666666666,0.09375,0.18333333333333332
1504-2021_03_20_091302.jpg,lorry_truck,10,186,320,9,240,9,2,196,18,LTAdatasets/1504/annotate/1504-2021_03_20_091302.jpg,191.0,13.5,0.596875,0.05625,0.03125,0.0375
1504-2021_03_20_091302.jpg,car,6,175,320,6,240,12,1,181,18,LTAdatasets/1504/annotate/1504-2021_03_20_091302.jpg,178.0,15.0,0.55625,0.0625,0.01875,0.025
1504-2021_03_20_090402.jpg,car,43,35,320,81,240,159,1,78,240,LTAdatasets/1504/annotate/1504-2021_03_20_090402.jpg,56.5,199.5,0.1765625,0.83125,0.134375,0.3375
1504-2021_03_20_090402.jpg,car,25,101,320,24,240,56,1,126,80,LTAdatasets/1504/annotate/1504-2021_03_20_090402.jpg,113.5,68.0,0.3546875,0.2833333333333333,0.078125,0.1
1504-2021_03_20_090402.jpg,car,18,178,320,16,240,40,1,196,56,LTAdatasets/1504/annotate/1504-2021_03_20_090402.jpg,187.0,48.0,0.584375,0.2,0.05625,0.06666666666666667
1504-2021_03_20_090402.jpg,car,13,136,320,9,240,21,1,149,30,LTAdatasets/1504/annotate/1504-2021_03_20_090402.jpg,142.5,25.5,0.4453125,0.10625,0.040625,0.0375
1504-2021_03_20_090402.jpg,car,6,166,320,4,240,12,1,172,16,LTAdatasets/1504/annotate/1504-2021_03_20_090402.jpg,169.0,14.0,0.528125,0.058333333333333334,0.01875,0.016666666666666666
1504-2021_03_20_211300.jpg,car,50,212,320,64,240,111,1,262,175,LTAdatasets/1504/annotate/1504-2021_03_20_211300.jpg,237.0,143.0,0.740625,0.5958333333333333,0.15625,0.26666666666666666
1504-2021_03_20_100105.jpg,car,24,146,320,28,240,61,1,170,89,LTAdatasets/1504/annotate/1504-2021_03_20_100105.jpg,158.0,75.0,0.49375,0.3125,0.075,0.11666666666666667
1504-2021_03_20_100105.jpg,car,26,97,320,34,240,65,1,123,99,LTAdatasets/1504/annotate/1504-2021_03_20_100105.jpg,110.0,82.0,0.34375,0.3416666666666667,0.08125,0.14166666666666666
1504-2021_03_20_100105.jpg,lorry_truck,15,163,320,13,240,10,2,178,23,LTAdatasets/1504/annotate/1504-2021_03_20_100105.jpg,170.5,16.5,0.5328125,0.06875,0.046875,0.05416666666666667
1504-2021_03_20_191914.jpg,lorry_truck,18,120,320,15,240,36,2,138,51,LTAdatasets/1504/annotate/1504-2021_03_20_191914.jpg,129.0,43.5,0.403125,0.18125,0.05625,0.0625
1504-2021_03_20_191914.jpg,lorry_truck,9,178,320,10,240,22,2,187,32,LTAdatasets/1504/annotate/1504-2021_03_20_191914.jpg,182.5,27.0,0.5703125,0.1125,0.028125,0.041666666666666664
1504-2021_03_20_191914.jpg,lorry_truck,9,183,320,6,240,14,2,192,20,LTAdatasets/1504/annotate/1504-2021_03_20_191914.jpg,187.5,17.0,0.5859375,0.07083333333333333,0.028125,0.025
1504-2021_03_20_072517.jpg,bus,31,175,320,48,240,20,5,206,68,LTAdatasets/1504/annotate/1504-2021_03_20_072517.jpg,190.5,44.0,0.5953125,0.18333333333333332,0.096875,0.2
1504-2021_03_20_072517.jpg,car,12,132,320,13,240,24,1,144,37,LTAdatasets/1504/annotate/1504-2021_03_20_072517.jpg,138.0,30.5,0.43125,0.12708333333333333,0.0375,0.05416666666666667
1504-2021_03_20_100405.jpg,car,14,120,320,15,240,33,1,134,48,LTAdatasets/1504/annotate/1504-2021_03_20_100405.jpg,127.0,40.5,0.396875,0.16875,0.04375,0.0625
1504-2021_03_20_100405.jpg,car,9,163,320,8,240,16,1,172,24,LTAdatasets/1504/annotate/1504-2021_03_20_100405.jpg,167.5,20.0,0.5234375,0.08333333333333333,0.028125,0.03333333333333333
1504-2021_03_20_085822.jpg,car,7,165,320,7,240,12,1,172,19,LTAdatasets/1504/annotate/1504-2021_03_20_085822.jpg,168.5,15.5,0.5265625,0.06458333333333334,0.021875,0.029166666666666667
8702-2021_03_20_094605.jpg,car,37,507,640,30,360,168,1,544,198,LTAdatasets/8702/annotate/8702-2021_03_20_094605.jpg,525.5,183.0,0.82109375,0.5083333333333333,0.0578125,0.08333333333333333
8702-2021_03_20_094605.jpg,bike,18,303,640,19,360,139,4,321,158,LTAdatasets/8702/annotate/8702-2021_03_20_094605.jpg,312.0,148.5,0.4875,0.4125,0.028125,0.05277777777777778
8702-2021_03_20_094605.jpg,car,57,76,640,32,360,200,1,133,232,LTAdatasets/8702/annotate/8702-2021_03_20_094605.jpg,104.5,216.0,0.16328125,0.6,0.0890625,0.08888888888888889
8702-2021_03_20_094605.jpg,car,19,202,640,12,360,136,1,221,148,LTAdatasets/8702/annotate/8702-2021_03_20_094605.jpg,211.5,142.0,0.33046875,0.39444444444444443,0.0296875,0.03333333333333333
8702-2021_03_20_094605.jpg,car,11,258,640,11,360,117,1,269,128,LTAdatasets/8702/annotate/8702-2021_03_20_094605.jpg,263.5,122.5,0.41171875,0.3402777777777778,0.0171875,0.030555555555555555
8702-2021_03_20_094605.jpg,lorry_truck,19,202,640,16,360,117,2,221,133,LTAdatasets/8702/annotate/8702-2021_03_20_094605.jpg,211.5,125.0,0.33046875,0.3472222222222222,0.0296875,0.044444444444444446
8702-2021_03_20_181851.jpg,car,47,515,640,30,360,209,1,562,239,LTAdatasets/8702/annotate/8702-2021_03_20_181851.jpg,538.5,224.0,0.84140625,0.6222222222222222,0.0734375,0.08333333333333333
8702-2021_03_20_181851.jpg,car,28,177,640,21,360,163,1,205,184,LTAdatasets/8702/annotate/8702-2021_03_20_181851.jpg,191.0,173.5,0.2984375,0.48194444444444445,0.04375,0.058333333333333334
8702-2021_03_20_181851.jpg,car,16,242,640,11,360,131,1,258,142,LTAdatasets/8702/annotate/8702-2021_03_20_181851.jpg,250.0,136.5,0.390625,0.37916666666666665,0.025,0.030555555555555555
8702-2021_03_20_181851.jpg,car,17,372,640,9,360,128,1,389,137,LTAdatasets/8702/annotate/8702-2021_03_20_181851.jpg,380.5,132.5,0.59453125,0.3680555555555556,0.0265625,0.025
8702-2021_03_20_181851.jpg,bike,13,195,640,17,360,141,4,208,158,LTAdatasets/8702/annotate/8702-2021_03_20_181851.jpg,201.5,149.5,0.31484375,0.4152777777777778,0.0203125,0.04722222222222222
8702-2021_03_20_181851.jpg,van,13,256,640,14,360,116,3,269,130,LTAdatasets/8702/annotate/8702-2021_03_20_181851.jpg,262.5,123.0,0.41015625,0.3416666666666667,0.0203125,0.03888888888888889
8702-2021_03_20_181851.jpg,lorry_truck,45,532,640,38,360,146,2,577,184,LTAdatasets/8702/annotate/8702-2021_03_20_181851.jpg,554.5,165.0,0.86640625,0.4583333333333333,0.0703125,0.10555555555555556
8702-2021_03_20_183952.jpg,bike,15,545,640,33,360,225,4,560,258,LTAdatasets/8702/annotate/8702-2021_03_20_183952.jpg,552.5,241.5,0.86328125,0.6708333333333333,0.0234375,0.09166666666666666
8702-2021_03_20_183952.jpg,bike,25,559,640,36,360,267,4,584,303,LTAdatasets/8702/annotate/8702-2021_03_20_183952.jpg,571.5,285.0,0.89296875,0.7916666666666666,0.0390625,0.1
8702-2021_03_20_183952.jpg,van,48,584,640,54,360,232,3,632,286,LTAdatasets/8702/annotate/8702-2021_03_20_183952.jpg,608.0,259.0,0.95,0.7194444444444444,0.075,0.15
8702-2021_03_20_183952.jpg,car,41,471,640,34,360,203,1,512,237,LTAdatasets/8702/annotate/8702-2021_03_20_183952.jpg,491.5,220.0,0.76796875,0.6111111111111112,0.0640625,0.09444444444444444
8702-2021_03_20_183952.jpg,car,20,211,640,15,360,123,1,231,138,LTAdatasets/8702/annotate/8702-2021_03_20_183952.jpg,221.0,130.5,0.3453125,0.3625,0.03125,0.041666666666666664
8702-2021_03_20_183952.jpg,car,22,266,640,13,360,119,1,288,132,LTAdatasets/8702/annotate/8702-2021_03_20_183952.jpg,277.0,125.5,0.4328125,0.3486111111111111,0.034375,0.03611111111111111
8702-2021_03_20_183952.jpg,car,15,332,640,13,360,116,1,347,129,LTAdatasets/8702/annotate/8702-2021_03_20_183952.jpg,339.5,122.5,0.53046875,0.3402777777777778,0.0234375,0.03611111111111111
8702-2021_03_20_183952.jpg,lorry_truck,19,482,640,28,360,119,2,501,147,LTAdatasets/8702/annotate/8702-2021_03_20_183952.jpg,491.5,133.0,0.76796875,0.36944444444444446,0.0296875,0.07777777777777778
8702-2021_03_20_190413.jpg,car,52,36,640,28,360,197,1,88,225,LTAdatasets/8702/annotate/8702-2021_03_20_190413.jpg,62.0,211.0,0.096875,0.5861111111111111,0.08125,0.07777777777777778
8702-2021_03_20_190413.jpg,car,25,195,640,19,360,154,1,220,173,LTAdatasets/8702/annotate/8702-2021_03_20_190413.jpg,207.5,163.5,0.32421875,0.45416666666666666,0.0390625,0.05277777777777778
8702-2021_03_20_190413.jpg,bike,11,237,640,19,360,134,4,248,153,LTAdatasets/8702/annotate/8702-2021_03_20_190413.jpg,242.5,143.5,0.37890625,0.39861111111111114,0.0171875,0.05277777777777778
8702-2021_03_20_190413.jpg,van,14,216,640,14,360,132,3,230,146,LTAdatasets/8702/annotate/8702-2021_03_20_190413.jpg,223.0,139.0,0.3484375,0.3861111111111111,0.021875,0.03888888888888889
8702-2021_03_20_190413.jpg,van,14,256,640,12,360,117,3,270,129,LTAdatasets/8702/annotate/8702-2021_03_20_190413.jpg,263.0,123.0,0.4109375,0.3416666666666667,0.021875,0.03333333333333333
8702-2021_03_20_190413.jpg,car,19,374,640,15,360,130,1,393,145,LTAdatasets/8702/annotate/8702-2021_03_20_190413.jpg,383.5,137.5,0.59921875,0.3819444444444444,0.0296875,0.041666666666666664
8702-2021_03_20_190413.jpg,car,18,215,640,8,360,123,1,233,131,LTAdatasets/8702/annotate/8702-2021_03_20_190413.jpg,224.0,127.0,0.35,0.3527777777777778,0.028125,0.022222222222222223
8702-2021_03_20_190413.jpg,lorry_truck,23,479,640,23,360,122,2,502,145,LTAdatasets/8702/annotate/8702-2021_03_20_190413.jpg,490.5,133.5,0.76640625,0.37083333333333335,0.0359375,0.06388888888888888
8702-2021_03_20_191014.jpg,car,27,278,640,18,360,146,1,305,164,LTAdatasets/8702/annotate/8702-2021_03_20_191014.jpg,291.5,155.0,0.45546875,0.4305555555555556,0.0421875,0.05
8702-2021_03_20_191014.jpg,lorry_truck,21,465,640,34,360,154,2,486,188,LTAdatasets/8702/annotate/8702-2021_03_20_191014.jpg,475.5,171.0,0.74296875,0.475,0.0328125,0.09444444444444444
8702-2021_03_20_191014.jpg,bus,49,142,640,28,360,130,5,191,158,LTAdatasets/8702/annotate/8702-2021_03_20_191014.jpg,166.5,144.0,0.26015625,0.4,0.0765625,0.07777777777777778
8702-2021_03_20_191014.jpg,lorry_truck,18,220,640,17,360,118,2,238,135,LTAdatasets/8702/annotate/8702-2021_03_20_191014.jpg,229.0,126.5,0.3578125,0.35138888888888886,0.028125,0.04722222222222222
8702-2021_03_20_191014.jpg,car,10,242,640,9,360,125,1,252,134,LTAdatasets/8702/annotate/8702-2021_03_20_191014.jpg,247.0,129.5,0.3859375,0.3597222222222222,0.015625,0.025
8702-2021_03_20_191014.jpg,van,60,152,640,73,360,261,3,212,334,LTAdatasets/8702/annotate/8702-2021_03_20_191014.jpg,182.0,297.5,0.284375,0.8263888888888888,0.09375,0.20277777777777778
8702-2021_03_20_191014.jpg,car,17,369,640,11,360,122,1,386,133,LTAdatasets/8702/annotate/8702-2021_03_20_191014.jpg,377.5,127.5,0.58984375,0.3541666666666667,0.0265625,0.030555555555555555
8702-2021_03_20_191014.jpg,lorry_truck,17,480,640,25,360,120,2,497,145,LTAdatasets/8702/annotate/8702-2021_03_20_191014.jpg,488.5,132.5,0.76328125,0.3680555555555556,0.0265625,0.06944444444444445
8702-2021_03_20_190634.jpg,lorry_truck,58,144,640,52,360,241,2,202,293,LTAdatasets/8702/annotate/8702-2021_03_20_190634.jpg,173.0,267.0,0.2703125,0.7416666666666667,0.090625,0.14444444444444443
8702-2021_03_20_190634.jpg,bike,18,482,640,24,360,181,4,500,205,LTAdatasets/8702/annotate/8702-2021_03_20_190634.jpg,491.0,193.0,0.7671875,0.5361111111111111,0.028125,0.06666666666666667
8702-2021_03_20_190634.jpg,lorry_truck,15,318,640,19,360,133,2,333,152,LTAdatasets/8702/annotate/8702-2021_03_20_190634.jpg,325.5,142.5,0.50859375,0.3958333333333333,0.0234375,0.05277777777777778
8702-2021_03_20_190634.jpg,van,37,70,640,30,360,178,3,107,208,LTAdatasets/8702/annotate/8702-2021_03_20_190634.jpg,88.5,193.0,0.13828125,0.5361111111111111,0.0578125,0.08333333333333333
8702-2021_03_20_190634.jpg,van,35,163,640,17,360,149,3,198,166,LTAdatasets/8702/annotate/8702-2021_03_20_190634.jpg,180.5,157.5,0.28203125,0.4375,0.0546875,0.04722222222222222
8702-2021_03_20_190634.jpg,bike,27,22,640,23,360,201,4,49,224,LTAdatasets/8702/annotate/8702-2021_03_20_190634.jpg,35.5,212.5,0.05546875,0.5902777777777778,0.0421875,0.06388888888888888
8702-2021_03_20_190634.jpg,car,54,39,640,28,360,231,1,93,259,LTAdatasets/8702/annotate/8702-2021_03_20_190634.jpg,66.0,245.0,0.103125,0.6805555555555556,0.084375,0.07777777777777778
8702-2021_03_20_190634.jpg,car,20,201,640,10,360,132,1,221,142,LTAdatasets/8702/annotate/8702-2021_03_20_190634.jpg,211.0,137.0,0.3296875,0.38055555555555554,0.03125,0.027777777777777776
8702-2021_03_20_190634.jpg,lorry_truck,19,478,640,24,360,120,2,497,144,LTAdatasets/8702/annotate/8702-2021_03_20_190634.jpg,487.5,132.0,0.76171875,0.36666666666666664,0.0296875,0.06666666666666667
8702-2021_03_20_091302.jpg,car,47,571,640,51,360,235,1,618,286,LTAdatasets/8702/annotate/8702-2021_03_20_091302.jpg,594.5,260.5,0.92890625,0.7236111111111111,0.0734375,0.14166666666666666
8702-2021_03_20_183112.jpg,van,28,224,640,34,360,179,3,252,213,LTAdatasets/8702/annotate/8702-2021_03_20_183112.jpg,238.0,196.0,0.371875,0.5444444444444444,0.04375,0.09444444444444444
8702-2021_03_20_183112.jpg,car,33,515,640,22,360,183,1,548,205,LTAdatasets/8702/annotate/8702-2021_03_20_183112.jpg,531.5,194.0,0.83046875,0.5388888888888889,0.0515625,0.06111111111111111
8702-2021_03_20_183112.jpg,bus,33,291,640,52,360,126,5,324,178,LTAdatasets/8702/annotate/8702-2021_03_20_183112.jpg,307.5,152.0,0.48046875,0.4222222222222222,0.0515625,0.14444444444444443
8702-2021_03_20_183112.jpg,car,19,216,640,15,360,141,1,235,156,LTAdatasets/8702/annotate/8702-2021_03_20_183112.jpg,225.5,148.5,0.35234375,0.4125,0.0296875,0.041666666666666664
8702-2021_03_20_183112.jpg,car,17,231,640,12,360,128,1,248,140,LTAdatasets/8702/annotate/8702-2021_03_20_183112.jpg,239.5,134.0,0.37421875,0.37222222222222223,0.0265625,0.03333333333333333
8702-2021_03_20_183112.jpg,car,11,348,640,10,360,116,1,359,126,LTAdatasets/8702/annotate/8702-2021_03_20_183112.jpg,353.5,121.0,0.55234375,0.33611111111111114,0.0171875,0.027777777777777776
8702-2021_03_20_183112.jpg,lorry_truck,22,479,640,27,360,120,2,501,147,LTAdatasets/8702/annotate/8702-2021_03_20_183112.jpg,490.0,133.5,0.765625,0.37083333333333335,0.034375,0.075
8702-2021_03_20_093424.jpg,bus,94,535,640,92,360,180,5,629,272,LTAdatasets/8702/annotate/8702-2021_03_20_093424.jpg,582.0,226.0,0.909375,0.6277777777777778,0.146875,0.25555555555555554
8702-2021_03_20_093424.jpg,car,15,287,640,16,360,134,1,302,150,LTAdatasets/8702/annotate/8702-2021_03_20_093424.jpg,294.5,142.0,0.46015625,0.39444444444444443,0.0234375,0.044444444444444446
8702-2021_03_20_093424.jpg,bike,9,309,640,16,360,141,4,318,157,LTAdatasets/8702/annotate/8702-2021_03_20_093424.jpg,313.5,149.0,0.48984375,0.41388888888888886,0.0140625,0.044444444444444446
8702-2021_03_20_093424.jpg,car,43,102,640,19,360,175,1,145,194,LTAdatasets/8702/annotate/8702-2021_03_20_093424.jpg,123.5,184.5,0.19296875,0.5125,0.0671875,0.05277777777777778
8702-2021_03_20_191914.jpg,lorry_truck,63,574,640,70,360,231,2,637,301,LTAdatasets/8702/annotate/8702-2021_03_20_191914.jpg,605.5,266.0,0.94609375,0.7388888888888889,0.0984375,0.19444444444444445
8702-2021_03_20_191914.jpg,car,18,305,640,18,360,151,1,323,169,LTAdatasets/8702/annotate/8702-2021_03_20_191914.jpg,314.0,160.0,0.490625,0.4444444444444444,0.028125,0.05
8702-2021_03_20_191914.jpg,car,20,279,640,17,360,138,1,299,155,LTAdatasets/8702/annotate/8702-2021_03_20_191914.jpg,289.0,146.5,0.4515625,0.40694444444444444,0.03125,0.04722222222222222
8702-2021_03_20_191914.jpg,car,18,238,640,8,360,125,1,256,133,LTAdatasets/8702/annotate/8702-2021_03_20_191914.jpg,247.0,129.0,0.3859375,0.35833333333333334,0.028125,0.022222222222222223
8702-2021_03_20_191914.jpg,car,17,220,640,8,360,123,1,237,131,LTAdatasets/8702/annotate/8702-2021_03_20_191914.jpg,228.5,127.0,0.35703125,0.3527777777777778,0.0265625,0.022222222222222223
8702-2021_03_20_191914.jpg,car,29,97,640,16,360,153,1,126,169,LTAdatasets/8702/annotate/8702-2021_03_20_191914.jpg,111.5,161.0,0.17421875,0.44722222222222224,0.0453125,0.044444444444444446
8702-2021_03_20_191914.jpg,lorry_truck,33,138,640,23,360,154,2,171,177,LTAdatasets/8702/annotate/8702-2021_03_20_191914.jpg,154.5,165.5,0.24140625,0.4597222222222222,0.0515625,0.06388888888888888
8702-2021_03_20_191914.jpg,lorry_truck,22,478,640,28,360,120,2,500,148,LTAdatasets/8702/annotate/8702-2021_03_20_191914.jpg,489.0,134.0,0.7640625,0.37222222222222223,0.034375,0.07777777777777778
8702-2021_03_20_092143.jpg,lorry_truck,71,29,640,40,360,163,2,100,203,LTAdatasets/8702/annotate/8702-2021_03_20_092143.jpg,64.5,183.0,0.10078125,0.5083333333333333,0.1109375,0.1111111111111111
8702-2021_03_20_092143.jpg,bike,12,180,640,16,360,143,4,192,159,LTAdatasets/8702/annotate/8702-2021_03_20_092143.jpg,186.0,151.0,0.290625,0.41944444444444445,0.01875,0.044444444444444446
8702-2021_03_20_092143.jpg,car,19,223,640,14,360,126,1,242,140,LTAdatasets/8702/annotate/8702-2021_03_20_092143.jpg,232.5,133.0,0.36328125,0.36944444444444446,0.0296875,0.03888888888888889
8702-2021_03_20_092143.jpg,car,48,40,640,23,360,210,1,88,233,LTAdatasets/8702/annotate/8702-2021_03_20_092143.jpg,64.0,221.5,0.1,0.6152777777777778,0.075,0.06388888888888888
8702-2021_03_20_092143.jpg,car,14,378,640,12,360,110,1,392,122,LTAdatasets/8702/annotate/8702-2021_03_20_092143.jpg,385.0,116.0,0.6015625,0.32222222222222224,0.021875,0.03333333333333333
8702-2021_03_20_092143.jpg,lorry_truck,18,469,640,19,360,119,2,487,138,LTAdatasets/8702/annotate/8702-2021_03_20_092143.jpg,478.0,128.5,0.746875,0.35694444444444445,0.028125,0.05277777777777778
8702-2021_03_20_075818.jpg,van,42,512,640,45,360,186,3,554,231,LTAdatasets/8702/annotate/8702-2021_03_20_075818.jpg,533.0,208.5,0.8328125,0.5791666666666667,0.065625,0.125
8702-2021_03_20_075818.jpg,van,24,181,640,18,360,159,3,205,177,LTAdatasets/8702/annotate/8702-2021_03_20_075818.jpg,193.0,168.0,0.3015625,0.4666666666666667,0.0375,0.05
8702-2021_03_20_075818.jpg,car,24,155,640,18,360,157,1,179,175,LTAdatasets/8702/annotate/8702-2021_03_20_075818.jpg,167.0,166.0,0.2609375,0.46111111111111114,0.0375,0.05
8702-2021_03_20_075818.jpg,car,19,151,640,12,360,145,1,170,157,LTAdatasets/8702/annotate/8702-2021_03_20_075818.jpg,160.5,151.0,0.25078125,0.41944444444444445,0.0296875,0.03333333333333333
8702-2021_03_20_075818.jpg,car,20,127,640,18,360,141,1,147,159,LTAdatasets/8702/annotate/8702-2021_03_20_075818.jpg,137.0,150.0,0.2140625,0.4166666666666667,0.03125,0.05
8702-2021_03_20_075818.jpg,car,39,54,640,29,360,177,1,93,206,LTAdatasets/8702/annotate/8702-2021_03_20_075818.jpg,73.5,191.5,0.11484375,0.5319444444444444,0.0609375,0.08055555555555556
8702-2021_03_20_075818.jpg,car,55,12,640,32,360,238,1,67,270,LTAdatasets/8702/annotate/8702-2021_03_20_075818.jpg,39.5,254.0,0.06171875,0.7055555555555556,0.0859375,0.08888888888888889
8702-2021_03_20_075818.jpg,bike,7,176,640,18,360,123,4,183,141,LTAdatasets/8702/annotate/8702-2021_03_20_075818.jpg,179.5,132.0,0.28046875,0.36666666666666664,0.0109375,0.05
8702-2021_03_20_075818.jpg,bike,11,184,640,12,360,127,4,195,139,LTAdatasets/8702/annotate/8702-2021_03_20_075818.jpg,189.5,133.0,0.29609375,0.36944444444444446,0.0171875,0.03333333333333333
8702-2021_03_20_075818.jpg,bike,8,212,640,12,360,121,4,220,133,LTAdatasets/8702/annotate/8702-2021_03_20_075818.jpg,216.0,127.0,0.3375,0.3527777777777778,0.0125,0.03333333333333333
8702-2021_03_20_075818.jpg,bus,18,343,640,17,360,99,5,361,116,LTAdatasets/8702/annotate/8702-2021_03_20_075818.jpg,352.0,107.5,0.55,0.2986111111111111,0.028125,0.04722222222222222
8702-2021_03_20_075818.jpg,lorry_truck,25,242,640,21,360,103,2,267,124,LTAdatasets/8702/annotate/8702-2021_03_20_075818.jpg,254.5,113.5,0.39765625,0.31527777777777777,0.0390625,0.058333333333333334
8702-2021_03_20_080719.jpg,bike,34,585,640,42,360,231,4,619,273,LTAdatasets/8702/annotate/8702-2021_03_20_080719.jpg,602.0,252.0,0.940625,0.7,0.053125,0.11666666666666667
8702-2021_03_20_080719.jpg,bike,11,202,640,14,360,132,4,213,146,LTAdatasets/8702/annotate/8702-2021_03_20_080719.jpg,207.5,139.0,0.32421875,0.3861111111111111,0.0171875,0.03888888888888889
8702-2021_03_20_080719.jpg,car,32,249,640,26,360,161,1,281,187,LTAdatasets/8702/annotate/8702-2021_03_20_080719.jpg,265.0,174.0,0.4140625,0.48333333333333334,0.05,0.07222222222222222
8702-2021_03_20_080719.jpg,car,25,174,640,23,360,146,1,199,169,LTAdatasets/8702/annotate/8702-2021_03_20_080719.jpg,186.5,157.5,0.29140625,0.4375,0.0390625,0.06388888888888888
8702-2021_03_20_080719.jpg,car,47,73,640,29,360,206,1,120,235,LTAdatasets/8702/annotate/8702-2021_03_20_080719.jpg,96.5,220.5,0.15078125,0.6125,0.0734375,0.08055555555555556
8702-2021_03_20_080719.jpg,car,12,265,640,9,360,123,1,277,132,LTAdatasets/8702/annotate/8702-2021_03_20_080719.jpg,271.0,127.5,0.4234375,0.3541666666666667,0.01875,0.025
8702-2021_03_20_080719.jpg,lorry_truck,16,385,640,24,360,104,2,401,128,LTAdatasets/8702/annotate/8702-2021_03_20_080719.jpg,393.0,116.0,0.6140625,0.32222222222222224,0.025,0.06666666666666667
8702-2021_03_20_094904.jpg,lorry_truck,49,467,640,63,360,138,2,516,201,LTAdatasets/8702/annotate/8702-2021_03_20_094904.jpg,491.5,169.5,0.76796875,0.4708333333333333,0.0765625,0.175
8702-2021_03_20_094904.jpg,car,46,541,640,27,360,192,1,587,219,LTAdatasets/8702/annotate/8702-2021_03_20_094904.jpg,564.0,205.5,0.88125,0.5708333333333333,0.071875,0.075
8702-2021_03_20_094904.jpg,bike,16,472,640,30,360,192,4,488,222,LTAdatasets/8702/annotate/8702-2021_03_20_094904.jpg,480.0,207.0,0.75,0.575,0.025,0.08333333333333333
8702-2021_03_20_094904.jpg,car,24,192,640,19,360,153,1,216,172,LTAdatasets/8702/annotate/8702-2021_03_20_094904.jpg,204.0,162.5,0.31875,0.4513888888888889,0.0375,0.05277777777777778
8702-2021_03_20_094904.jpg,lorry_truck,52,101,640,36,360,130,2,153,166,LTAdatasets/8702/annotate/8702-2021_03_20_094904.jpg,127.0,148.0,0.1984375,0.4111111111111111,0.08125,0.1
8702-2021_03_20_094904.jpg,car,27,3,640,34,360,221,1,30,255,LTAdatasets/8702/annotate/8702-2021_03_20_094904.jpg,16.5,238.0,0.02578125,0.6611111111111111,0.0421875,0.09444444444444444
8702-2021_03_20_094904.jpg,car,16,245,640,15,360,129,1,261,144,LTAdatasets/8702/annotate/8702-2021_03_20_094904.jpg,253.0,136.5,0.3953125,0.37916666666666665,0.025,0.041666666666666664
8702-2021_03_20_094904.jpg,lorry_truck,14,336,640,15,360,109,2,350,124,LTAdatasets/8702/annotate/8702-2021_03_20_094904.jpg,343.0,116.5,0.5359375,0.3236111111111111,0.021875,0.041666666666666664
8702-2021_03_20_084901.jpg,car,39,250,640,31,360,184,1,289,215,LTAdatasets/8702/annotate/8702-2021_03_20_084901.jpg,269.5,199.5,0.42109375,0.5541666666666667,0.0609375,0.08611111111111111
8702-2021_03_20_084901.jpg,car,30,100,640,23,360,155,1,130,178,LTAdatasets/8702/annotate/8702-2021_03_20_084901.jpg,115.0,166.5,0.1796875,0.4625,0.046875,0.06388888888888888
8702-2021_03_20_084901.jpg,lorry_truck,29,156,640,23,360,146,2,185,169,LTAdatasets/8702/annotate/8702-2021_03_20_084901.jpg,170.5,157.5,0.26640625,0.4375,0.0453125,0.06388888888888888
8702-2021_03_20_084901.jpg,lorry_truck,24,224,640,19,360,109,2,248,128,LTAdatasets/8702/annotate/8702-2021_03_20_084901.jpg,236.0,118.5,0.36875,0.32916666666666666,0.0375,0.05277777777777778
8702-2021_03_20_084901.jpg,car,23,201,640,11,360,128,1,224,139,LTAdatasets/8702/annotate/8702-2021_03_20_084901.jpg,212.5,133.5,0.33203125,0.37083333333333335,0.0359375,0.030555555555555555
8702-2021_03_20_084901.jpg,van,17,162,640,18,360,129,3,179,147,LTAdatasets/8702/annotate/8702-2021_03_20_084901.jpg,170.5,138.0,0.26640625,0.38333333333333336,0.0265625,0.05
8702-2021_03_20_073037.jpg,car,28,281,640,22,360,168,1,309,190,LTAdatasets/8702/annotate/8702-2021_03_20_073037.jpg,295.0,179.0,0.4609375,0.49722222222222223,0.04375,0.06111111111111111
8702-2021_03_20_073037.jpg,car,31,145,640,18,360,155,1,176,173,LTAdatasets/8702/annotate/8702-2021_03_20_073037.jpg,160.5,164.0,0.25078125,0.45555555555555555,0.0484375,0.05
8702-2021_03_20_073037.jpg,lorry_truck,15,262,640,14,360,111,2,277,125,LTAdatasets/8702/annotate/8702-2021_03_20_073037.jpg,269.5,118.0,0.42109375,0.3277777777777778,0.0234375,0.03888888888888889
8702-2021_03_20_073037.jpg,lorry_truck,21,0,640,24,360,140,2,21,164,LTAdatasets/8702/annotate/8702-2021_03_20_073037.jpg,10.5,152.0,0.01640625,0.4222222222222222,0.0328125,0.06666666666666667
8702-2021_03_20_093724.jpg,lorry_truck,30,465,640,36,360,150,2,495,186,LTAdatasets/8702/annotate/8702-2021_03_20_093724.jpg,480.0,168.0,0.75,0.4666666666666667,0.046875,0.1
8702-2021_03_20_093724.jpg,lorry_truck,13,385,640,14,360,112,2,398,126,LTAdatasets/8702/annotate/8702-2021_03_20_093724.jpg,391.5,119.0,0.61171875,0.33055555555555555,0.0203125,0.03888888888888889
8702-2021_03_20_093724.jpg,car,17,236,640,10,360,123,1,253,133,LTAdatasets/8702/annotate/8702-2021_03_20_093724.jpg,244.5,128.0,0.38203125,0.35555555555555557,0.0265625,0.027777777777777776
8702-2021_03_20_090102.jpg,car,16,198,640,15,360,137,1,214,152,LTAdatasets/8702/annotate/8702-2021_03_20_090102.jpg,206.0,144.5,0.321875,0.4013888888888889,0.025,0.041666666666666664
8702-2021_03_20_090102.jpg,van,24,108,640,17,360,142,3,132,159,LTAdatasets/8702/annotate/8702-2021_03_20_090102.jpg,120.0,150.5,0.1875,0.41805555555555557,0.0375,0.04722222222222222
8702-2021_03_20_090102.jpg,car,19,309,640,19,360,135,1,328,154,LTAdatasets/8702/annotate/8702-2021_03_20_090102.jpg,318.5,144.5,0.49765625,0.4013888888888889,0.0296875,0.05277777777777778
8702-2021_03_20_090102.jpg,lorry_truck,83,557,640,75,360,187,2,640,262,LTAdatasets/8702/annotate/8702-2021_03_20_090102.jpg,598.5,224.5,0.93515625,0.6236111111111111,0.1296875,0.20833333333333334
8702-2021_03_20_192214.jpg,car,39,501,640,44,360,220,1,540,264,LTAdatasets/8702/annotate/8702-2021_03_20_192214.jpg,520.5,242.0,0.81328125,0.6722222222222223,0.0609375,0.12222222222222222
8702-2021_03_20_192214.jpg,car,35,151,640,28,360,176,1,186,204,LTAdatasets/8702/annotate/8702-2021_03_20_192214.jpg,168.5,190.0,0.26328125,0.5277777777777778,0.0546875,0.07777777777777778
8702-2021_03_20_192214.jpg,car,26,153,640,15,360,162,1,179,177,LTAdatasets/8702/annotate/8702-2021_03_20_192214.jpg,166.0,169.5,0.259375,0.4708333333333333,0.040625,0.041666666666666664
8702-2021_03_20_192214.jpg,car,31,61,640,18,360,179,1,92,197,LTAdatasets/8702/annotate/8702-2021_03_20_192214.jpg,76.5,188.0,0.11953125,0.5222222222222223,0.0484375,0.05
8702-2021_03_20_192214.jpg,car,24,216,640,15,360,135,1,240,150,LTAdatasets/8702/annotate/8702-2021_03_20_192214.jpg,228.0,142.5,0.35625,0.3958333333333333,0.0375,0.041666666666666664
8702-2021_03_20_192214.jpg,car,15,371,640,12,360,122,1,386,134,LTAdatasets/8702/annotate/8702-2021_03_20_192214.jpg,378.5,128.0,0.59140625,0.35555555555555557,0.0234375,0.03333333333333333
8702-2021_03_20_192214.jpg,car,14,317,640,12,360,116,1,331,128,LTAdatasets/8702/annotate/8702-2021_03_20_192214.jpg,324.0,122.0,0.50625,0.3388888888888889,0.021875,0.03333333333333333
8702-2021_03_20_192214.jpg,lorry_truck,12,390,640,20,360,110,2,402,130,LTAdatasets/8702/annotate/8702-2021_03_20_192214.jpg,396.0,120.0,0.61875,0.3333333333333333,0.01875,0.05555555555555555
8702-2021_03_20_075518.jpg,lorry_truck,33,510,640,43,360,165,2,543,208,LTAdatasets/8702/annotate/8702-2021_03_20_075518.jpg,526.5,186.5,0.82265625,0.5180555555555556,0.0515625,0.11944444444444445
8702-2021_03_20_075518.jpg,van,54,535,640,41,360,211,3,589,252,LTAdatasets/8702/annotate/8702-2021_03_20_075518.jpg,562.0,231.5,0.878125,0.6430555555555556,0.084375,0.11388888888888889
8702-2021_03_20_075518.jpg,car,19,463,640,21,360,165,1,482,186,LTAdatasets/8702/annotate/8702-2021_03_20_075518.jpg,472.5,175.5,0.73828125,0.4875,0.0296875,0.058333333333333334
8702-2021_03_20_075518.jpg,bike,18,41,640,34,360,203,4,59,237,LTAdatasets/8702/annotate/8702-2021_03_20_075518.jpg,50.0,220.0,0.078125,0.6111111111111112,0.028125,0.09444444444444444
8702-2021_03_20_075518.jpg,van,21,197,640,15,360,126,3,218,141,LTAdatasets/8702/annotate/8702-2021_03_20_075518.jpg,207.5,133.5,0.32421875,0.37083333333333335,0.0328125,0.041666666666666664
8702-2021_03_20_075518.jpg,car,15,386,640,9,360,119,1,401,128,LTAdatasets/8702/annotate/8702-2021_03_20_075518.jpg,393.5,123.5,0.61484375,0.34305555555555556,0.0234375,0.025
8702-2021_03_20_075518.jpg,lorry_truck,38,553,640,36,360,151,2,591,187,LTAdatasets/8702/annotate/8702-2021_03_20_075518.jpg,572.0,169.0,0.89375,0.46944444444444444,0.059375,0.1
8702-2021_03_20_095205.jpg,lorry_truck,30,499,640,31,360,165,2,529,196,LTAdatasets/8702/annotate/8702-2021_03_20_095205.jpg,514.0,180.5,0.803125,0.5013888888888889,0.046875,0.08611111111111111
8702-2021_03_20_095205.jpg,lorry_truck,55,6,640,41,360,177,2,61,218,LTAdatasets/8702/annotate/8702-2021_03_20_095205.jpg,33.5,197.5,0.05234375,0.5486111111111112,0.0859375,0.11388888888888889
8702-2021_03_20_095205.jpg,lorry_truck,41,115,640,31,360,162,2,156,193,LTAdatasets/8702/annotate/8702-2021_03_20_095205.jpg,135.5,177.5,0.21171875,0.4930555555555556,0.0640625,0.08611111111111111
8702-2021_03_20_095205.jpg,lorry_truck,69,39,640,43,360,136,2,108,179,LTAdatasets/8702/annotate/8702-2021_03_20_095205.jpg,73.5,157.5,0.11484375,0.4375,0.1078125,0.11944444444444445
8702-2021_03_20_095205.jpg,lorry_truck,29,181,640,25,360,120,2,210,145,LTAdatasets/8702/annotate/8702-2021_03_20_095205.jpg,195.5,132.5,0.30546875,0.3680555555555556,0.0453125,0.06944444444444445
8702-2021_03_20_095205.jpg,lorry_truck,22,229,640,17,360,104,2,251,121,LTAdatasets/8702/annotate/8702-2021_03_20_095205.jpg,240.0,112.5,0.375,0.3125,0.034375,0.04722222222222222
8702-2021_03_20_095205.jpg,van,20,232,640,16,360,122,3,252,138,LTAdatasets/8702/annotate/8702-2021_03_20_095205.jpg,242.0,130.0,0.378125,0.3611111111111111,0.03125,0.044444444444444446
8702-2021_03_20_095205.jpg,bus,19,261,640,14,360,105,5,280,119,LTAdatasets/8702/annotate/8702-2021_03_20_095205.jpg,270.5,112.0,0.42265625,0.3111111111111111,0.0296875,0.03888888888888889
8702-2021_03_20_200416.jpg,bus,38,191,640,24,360,116,5,229,140,LTAdatasets/8702/annotate/8702-2021_03_20_200416.jpg,210.0,128.0,0.328125,0.35555555555555557,0.059375,0.06666666666666667
8702-2021_03_20_200416.jpg,lorry_truck,70,6,640,49,360,187,2,76,236,LTAdatasets/8702/annotate/8702-2021_03_20_200416.jpg,41.0,211.5,0.0640625,0.5875,0.109375,0.1361111111111111
8702-2021_03_20_200416.jpg,lorry_truck,70,516,640,54,360,190,2,586,244,LTAdatasets/8702/annotate/8702-2021_03_20_200416.jpg,551.0,217.0,0.8609375,0.6027777777777777,0.109375,0.15
8702-2021_03_20_080419.jpg,car,36,202,640,41,360,187,1,238,228,LTAdatasets/8702/annotate/8702-2021_03_20_080419.jpg,220.0,207.5,0.34375,0.5763888888888888,0.05625,0.11388888888888889
8702-2021_03_20_080419.jpg,car,47,56,640,38,360,215,1,103,253,LTAdatasets/8702/annotate/8702-2021_03_20_080419.jpg,79.5,234.0,0.12421875,0.65,0.0734375,0.10555555555555556
8702-2021_03_20_080419.jpg,lorry_truck,32,169,640,25,360,124,2,201,149,LTAdatasets/8702/annotate/8702-2021_03_20_080419.jpg,185.0,136.5,0.2890625,0.37916666666666665,0.05,0.06944444444444445
8702-2021_03_20_080419.jpg,lorry_truck,19,232,640,16,360,110,2,251,126,LTAdatasets/8702/annotate/8702-2021_03_20_080419.jpg,241.5,118.0,0.37734375,0.3277777777777778,0.0296875,0.044444444444444446
8702-2021_03_20_080419.jpg,bike,9,237,640,15,360,122,4,246,137,LTAdatasets/8702/annotate/8702-2021_03_20_080419.jpg,241.5,129.5,0.37734375,0.3597222222222222,0.0140625,0.041666666666666664
8702-2021_03_20_191614.jpg,car,47,528,640,49,360,233,1,575,282,LTAdatasets/8702/annotate/8702-2021_03_20_191614.jpg,551.5,257.5,0.86171875,0.7152777777777778,0.0734375,0.1361111111111111
8702-2021_03_20_191614.jpg,car,38,555,640,38,360,216,1,593,254,LTAdatasets/8702/annotate/8702-2021_03_20_191614.jpg,574.0,235.0,0.896875,0.6527777777777778,0.059375,0.10555555555555556
8702-2021_03_20_191614.jpg,car,25,264,640,21,360,155,1,289,176,LTAdatasets/8702/annotate/8702-2021_03_20_191614.jpg,276.5,165.5,0.43203125,0.4597222222222222,0.0390625,0.058333333333333334
8702-2021_03_20_191614.jpg,car,17,315,640,12,360,137,1,332,149,LTAdatasets/8702/annotate/8702-2021_03_20_191614.jpg,323.5,143.0,0.50546875,0.3972222222222222,0.0265625,0.03333333333333333
8702-2021_03_20_191614.jpg,car,19,259,640,12,360,123,1,278,135,LTAdatasets/8702/annotate/8702-2021_03_20_191614.jpg,268.5,129.0,0.41953125,0.35833333333333334,0.0296875,0.03333333333333333
8702-2021_03_20_191614.jpg,lorry_truck,23,204,640,17,360,120,2,227,137,LTAdatasets/8702/annotate/8702-2021_03_20_191614.jpg,215.5,128.5,0.33671875,0.35694444444444445,0.0359375,0.04722222222222222
8702-2021_03_20_191614.jpg,lorry_truck,50,60,640,37,360,157,2,110,194,LTAdatasets/8702/annotate/8702-2021_03_20_191614.jpg,85.0,175.5,0.1328125,0.4875,0.078125,0.10277777777777777
8702-2021_03_20_191614.jpg,lorry_truck,23,477,640,26,360,119,2,500,145,LTAdatasets/8702/annotate/8702-2021_03_20_191614.jpg,488.5,132.0,0.76328125,0.36666666666666664,0.0359375,0.07222222222222222
8702-2021_03_20_201917.jpg,car,55,526,640,55,360,233,1,581,288,LTAdatasets/8702/annotate/8702-2021_03_20_201917.jpg,553.5,260.5,0.86484375,0.7236111111111111,0.0859375,0.1527777777777778
8702-2021_03_20_201917.jpg,car,35,570,640,34,360,203,1,605,237,LTAdatasets/8702/annotate/8702-2021_03_20_201917.jpg,587.5,220.0,0.91796875,0.6111111111111112,0.0546875,0.09444444444444444
8702-2021_03_20_201917.jpg,car,33,33,640,17,360,177,1,66,194,LTAdatasets/8702/annotate/8702-2021_03_20_201917.jpg,49.5,185.5,0.07734375,0.5152777777777777,0.0515625,0.04722222222222222
8702-2021_03_20_201917.jpg,car,25,144,640,27,360,158,1,169,185,LTAdatasets/8702/annotate/8702-2021_03_20_201917.jpg,156.5,171.5,0.24453125,0.47638888888888886,0.0390625,0.075
8702-2021_03_20_201917.jpg,car,24,180,640,18,360,158,1,204,176,LTAdatasets/8702/annotate/8702-2021_03_20_201917.jpg,192.0,167.0,0.3,0.4638888888888889,0.0375,0.05
8702-2021_03_20_201917.jpg,car,18,226,640,10,360,130,1,244,140,LTAdatasets/8702/annotate/8702-2021_03_20_201917.jpg,235.0,135.0,0.3671875,0.375,0.028125,0.027777777777777776
8702-2021_03_20_201917.jpg,car,17,246,640,18,360,129,1,263,147,LTAdatasets/8702/annotate/8702-2021_03_20_201917.jpg,254.5,138.0,0.39765625,0.38333333333333336,0.0265625,0.05
8702-2021_03_20_201917.jpg,car,16,206,640,15,360,124,1,222,139,LTAdatasets/8702/annotate/8702-2021_03_20_201917.jpg,214.0,131.5,0.334375,0.36527777777777776,0.025,0.041666666666666664
8702-2021_03_20_201917.jpg,lorry_truck,20,178,640,21,360,122,2,198,143,LTAdatasets/8702/annotate/8702-2021_03_20_201917.jpg,188.0,132.5,0.29375,0.3680555555555556,0.03125,0.058333333333333334
8702-2021_03_20_181551.jpg,car,34,137,640,22,360,182,1,171,204,LTAdatasets/8702/annotate/8702-2021_03_20_181551.jpg,154.0,193.0,0.240625,0.5361111111111111,0.053125,0.06111111111111111
8702-2021_03_20_181551.jpg,car,25,100,640,22,360,174,1,125,196,LTAdatasets/8702/annotate/8702-2021_03_20_181551.jpg,112.5,185.0,0.17578125,0.5138888888888888,0.0390625,0.06111111111111111
8702-2021_03_20_181551.jpg,car,19,215,640,21,360,145,1,234,166,LTAdatasets/8702/annotate/8702-2021_03_20_181551.jpg,224.5,155.5,0.35078125,0.43194444444444446,0.0296875,0.058333333333333334
8702-2021_03_20_181551.jpg,car,15,240,640,16,360,134,1,255,150,LTAdatasets/8702/annotate/8702-2021_03_20_181551.jpg,247.5,142.0,0.38671875,0.39444444444444443,0.0234375,0.044444444444444446
8702-2021_03_20_181551.jpg,bike,8,190,640,15,360,143,4,198,158,LTAdatasets/8702/annotate/8702-2021_03_20_181551.jpg,194.0,150.5,0.303125,0.41805555555555557,0.0125,0.041666666666666664
8702-2021_03_20_181551.jpg,car,15,245,640,10,360,123,1,260,133,LTAdatasets/8702/annotate/8702-2021_03_20_181551.jpg,252.5,128.0,0.39453125,0.35555555555555557,0.0234375,0.027777777777777776
8702-2021_03_20_181551.jpg,lorry_truck,38,511,640,39,360,133,2,549,172,LTAdatasets/8702/annotate/8702-2021_03_20_181551.jpg,530.0,152.5,0.828125,0.4236111111111111,0.059375,0.10833333333333334
8702-2021_03_20_084601.jpg,car,23,291,640,25,360,151,1,314,176,LTAdatasets/8702/annotate/8702-2021_03_20_084601.jpg,302.5,163.5,0.47265625,0.45416666666666666,0.0359375,0.06944444444444445
8702-2021_03_20_084601.jpg,lorry_truck,32,468,640,31,360,141,2,500,172,LTAdatasets/8702/annotate/8702-2021_03_20_084601.jpg,484.0,156.5,0.75625,0.43472222222222223,0.05,0.08611111111111111
8702-2021_03_20_084601.jpg,lorry_truck,31,99,640,20,360,148,2,130,168,LTAdatasets/8702/annotate/8702-2021_03_20_084601.jpg,114.5,158.0,0.17890625,0.4388888888888889,0.0484375,0.05555555555555555
8702-2021_03_20_084601.jpg,lorry_truck,26,35,640,20,360,133,2,61,153,LTAdatasets/8702/annotate/8702-2021_03_20_084601.jpg,48.0,143.0,0.075,0.3972222222222222,0.040625,0.05555555555555555
8702-2021_03_20_084601.jpg,car,17,215,640,10,360,125,1,232,135,LTAdatasets/8702/annotate/8702-2021_03_20_084601.jpg,223.5,130.0,0.34921875,0.3611111111111111,0.0265625,0.027777777777777776
8702-2021_03_20_092543.jpg,car,36,245,640,41,360,197,1,281,238,LTAdatasets/8702/annotate/8702-2021_03_20_092543.jpg,263.0,217.5,0.4109375,0.6041666666666666,0.05625,0.11388888888888889
8702-2021_03_20_092543.jpg,car,48,79,640,25,360,206,1,127,231,LTAdatasets/8702/annotate/8702-2021_03_20_092543.jpg,103.0,218.5,0.1609375,0.6069444444444444,0.075,0.06944444444444445
8702-2021_03_20_092543.jpg,car,21,188,640,16,360,136,1,209,152,LTAdatasets/8702/annotate/8702-2021_03_20_092543.jpg,198.5,144.0,0.31015625,0.4,0.0328125,0.044444444444444446
8702-2021_03_20_092543.jpg,car,15,296,640,15,360,123,1,311,138,LTAdatasets/8702/annotate/8702-2021_03_20_092543.jpg,303.5,130.5,0.47421875,0.3625,0.0234375,0.041666666666666664
8702-2021_03_20_092543.jpg,bike,8,325,640,14,360,120,4,333,134,LTAdatasets/8702/annotate/8702-2021_03_20_092543.jpg,329.0,127.0,0.5140625,0.3527777777777778,0.0125,0.03888888888888889
8702-2021_03_20_092543.jpg,bike,10,235,640,17,360,117,4,245,134,LTAdatasets/8702/annotate/8702-2021_03_20_092543.jpg,240.0,125.5,0.375,0.3486111111111111,0.015625,0.04722222222222222
8702-2021_03_20_092543.jpg,lorry_truck,31,138,640,25,360,132,2,169,157,LTAdatasets/8702/annotate/8702-2021_03_20_092543.jpg,153.5,144.5,0.23984375,0.4013888888888889,0.0484375,0.06944444444444445
8702-2021_03_20_092543.jpg,lorry_truck,20,470,640,19,360,117,2,490,136,LTAdatasets/8702/annotate/8702-2021_03_20_092543.jpg,480.0,126.5,0.75,0.35138888888888886,0.03125,0.05277777777777778
8702-2021_03_20_180710.jpg,lorry_truck,54,463,640,45,360,160,2,517,205,LTAdatasets/8702/annotate/8702-2021_03_20_180710.jpg,490.0,182.5,0.765625,0.5069444444444444,0.084375,0.125
8702-2021_03_20_180710.jpg,bus,25,223,640,18,360,103,5,248,121,LTAdatasets/8702/annotate/8702-2021_03_20_180710.jpg,235.5,112.0,0.36796875,0.3111111111111111,0.0390625,0.05
8702-2021_03_20_180710.jpg,lorry_truck,20,364,640,20,360,112,2,384,132,LTAdatasets/8702/annotate/8702-2021_03_20_180710.jpg,374.0,122.0,0.584375,0.3388888888888889,0.03125,0.05555555555555555
8702-2021_03_20_180710.jpg,car,21,216,640,12,360,132,1,237,144,LTAdatasets/8702/annotate/8702-2021_03_20_180710.jpg,226.5,138.0,0.35390625,0.38333333333333336,0.0328125,0.03333333333333333
8702-2021_03_20_180710.jpg,car,29,183,640,18,360,160,1,212,178,LTAdatasets/8702/annotate/8702-2021_03_20_180710.jpg,197.5,169.0,0.30859375,0.46944444444444444,0.0453125,0.05
8702-2021_03_20_180710.jpg,van,12,270,640,11,360,110,3,282,121,LTAdatasets/8702/annotate/8702-2021_03_20_180710.jpg,276.0,115.5,0.43125,0.32083333333333336,0.01875,0.030555555555555555
8702-2021_03_20_180710.jpg,lorry_truck,18,517,640,20,360,130,2,535,150,LTAdatasets/8702/annotate/8702-2021_03_20_180710.jpg,526.0,140.0,0.821875,0.3888888888888889,0.028125,0.05555555555555555
8702-2021_03_20_180710.jpg,lorry_truck,23,470,640,21,360,122,2,493,143,LTAdatasets/8702/annotate/8702-2021_03_20_180710.jpg,481.5,132.5,0.75234375,0.3680555555555556,0.0359375,0.058333333333333334
8702-2021_03_20_182752.jpg,car,28,190,640,14,360,156,1,218,170,LTAdatasets/8702/annotate/8702-2021_03_20_182752.jpg,204.0,163.0,0.31875,0.4527777777777778,0.04375,0.03888888888888889
8702-2021_03_20_182752.jpg,lorry_truck,23,187,640,16,360,134,2,210,150,LTAdatasets/8702/annotate/8702-2021_03_20_182752.jpg,198.5,142.0,0.31015625,0.39444444444444443,0.0359375,0.044444444444444446
8702-2021_03_20_182752.jpg,lorry_truck,34,82,640,31,360,160,2,116,191,LTAdatasets/8702/annotate/8702-2021_03_20_182752.jpg,99.0,175.5,0.1546875,0.4875,0.053125,0.08611111111111111
8702-2021_03_20_182752.jpg,lorry_truck,28,106,640,37,360,172,2,134,209,LTAdatasets/8702/annotate/8702-2021_03_20_182752.jpg,120.0,190.5,0.1875,0.5291666666666667,0.04375,0.10277777777777777
8702-2021_03_20_182752.jpg,lorry_truck,20,474,640,28,360,122,2,494,150,LTAdatasets/8702/annotate/8702-2021_03_20_182752.jpg,484.0,136.0,0.75625,0.37777777777777777,0.03125,0.07777777777777778
8702-2021_03_20_090702.jpg,lorry_truck,27,463,640,34,360,146,2,490,180,LTAdatasets/8702/annotate/8702-2021_03_20_090702.jpg,476.5,163.0,0.74453125,0.4527777777777778,0.0421875,0.09444444444444444
8702-2021_03_20_090702.jpg,van,36,604,640,51,360,243,3,640,294,LTAdatasets/8702/annotate/8702-2021_03_20_090702.jpg,622.0,268.5,0.971875,0.7458333333333333,0.05625,0.14166666666666666
8702-2021_03_20_090702.jpg,lorry_truck,58,84,640,36,360,130,2,142,166,LTAdatasets/8702/annotate/8702-2021_03_20_090702.jpg,113.0,148.0,0.1765625,0.4111111111111111,0.090625,0.1
8702-2021_03_20_090702.jpg,lorry_truck,29,195,640,28,360,120,2,224,148,LTAdatasets/8702/annotate/8702-2021_03_20_090702.jpg,209.5,134.0,0.32734375,0.37222222222222223,0.0453125,0.07777777777777778
8702-2021_03_20_090702.jpg,lorry_truck,24,240,640,18,360,102,2,264,120,LTAdatasets/8702/annotate/8702-2021_03_20_090702.jpg,252.0,111.0,0.39375,0.30833333333333335,0.0375,0.05
8702-2021_03_20_090702.jpg,car,24,211,640,15,360,146,1,235,161,LTAdatasets/8702/annotate/8702-2021_03_20_090702.jpg,223.0,153.5,0.3484375,0.4263888888888889,0.0375,0.041666666666666664
8702-2021_03_20_090702.jpg,van,16,318,640,18,360,124,3,334,142,LTAdatasets/8702/annotate/8702-2021_03_20_090702.jpg,326.0,133.0,0.509375,0.36944444444444446,0.025,0.05
8702-2021_03_20_090702.jpg,car,33,1,640,32,360,257,1,34,289,LTAdatasets/8702/annotate/8702-2021_03_20_090702.jpg,17.5,273.0,0.02734375,0.7583333333333333,0.0515625,0.08888888888888889
8702-2021_03_20_192515.jpg,car,30,187,640,18,360,156,1,217,174,LTAdatasets/8702/annotate/8702-2021_03_20_192515.jpg,202.0,165.0,0.315625,0.4583333333333333,0.046875,0.05
8702-2021_03_20_192515.jpg,car,13,257,640,15,360,125,1,270,140,LTAdatasets/8702/annotate/8702-2021_03_20_192515.jpg,263.5,132.5,0.41171875,0.3680555555555556,0.0203125,0.041666666666666664
8702-2021_03_20_192515.jpg,car,20,269,640,22,360,149,1,289,171,LTAdatasets/8702/annotate/8702-2021_03_20_192515.jpg,279.0,160.0,0.4359375,0.4444444444444444,0.03125,0.06111111111111111
8702-2021_03_20_192515.jpg,bike,10,124,640,25,360,179,4,134,204,LTAdatasets/8702/annotate/8702-2021_03_20_192515.jpg,129.0,191.5,0.2015625,0.5319444444444444,0.015625,0.06944444444444445
8702-2021_03_20_192515.jpg,lorry_truck,49,95,640,35,360,144,2,144,179,LTAdatasets/8702/annotate/8702-2021_03_20_192515.jpg,119.5,161.5,0.18671875,0.4486111111111111,0.0765625,0.09722222222222222
8702-2021_03_20_192515.jpg,bike,12,238,640,11,360,126,4,250,137,LTAdatasets/8702/annotate/8702-2021_03_20_192515.jpg,244.0,131.5,0.38125,0.36527777777777776,0.01875,0.030555555555555555
8702-2021_03_20_192515.jpg,car,17,79,640,19,360,155,1,96,174,LTAdatasets/8702/annotate/8702-2021_03_20_192515.jpg,87.5,164.5,0.13671875,0.45694444444444443,0.0265625,0.05277777777777778
8702-2021_03_20_192515.jpg,car,1,4,640,1,360,306,1,5,307,LTAdatasets/8702/annotate/8702-2021_03_20_192515.jpg,4.5,306.5,0.00703125,0.8513888888888889,0.0015625,0.002777777777777778
8702-2021_03_20_083120.jpg,car,40,502,640,50,360,213,1,542,263,LTAdatasets/8702/annotate/8702-2021_03_20_083120.jpg,522.0,238.0,0.815625,0.6611111111111111,0.0625,0.1388888888888889
8702-2021_03_20_083120.jpg,bike,21,539,640,28,360,204,4,560,232,LTAdatasets/8702/annotate/8702-2021_03_20_083120.jpg,549.5,218.0,0.85859375,0.6055555555555555,0.0328125,0.07777777777777778
8702-2021_03_20_083120.jpg,car,18,220,640,15,360,128,1,238,143,LTAdatasets/8702/annotate/8702-2021_03_20_083120.jpg,229.0,135.5,0.3578125,0.3763888888888889,0.028125,0.041666666666666664
8702-2021_03_20_083120.jpg,bike,11,129,640,21,360,148,4,140,169,LTAdatasets/8702/annotate/8702-2021_03_20_083120.jpg,134.5,158.5,0.21015625,0.44027777777777777,0.0171875,0.058333333333333334
8702-2021_03_20_083120.jpg,lorry_truck,59,2,640,46,360,177,2,61,223,LTAdatasets/8702/annotate/8702-2021_03_20_083120.jpg,31.5,200.0,0.04921875,0.5555555555555556,0.0921875,0.12777777777777777
8702-2021_03_20_083120.jpg,car,15,274,640,15,360,111,1,289,126,LTAdatasets/8702/annotate/8702-2021_03_20_083120.jpg,281.5,118.5,0.43984375,0.32916666666666666,0.0234375,0.041666666666666664
8702-2021_03_20_193115.jpg,car,40,496,640,33,360,180,1,536,213,LTAdatasets/8702/annotate/8702-2021_03_20_193115.jpg,516.0,196.5,0.80625,0.5458333333333333,0.0625,0.09166666666666666
8702-2021_03_20_193115.jpg,car,21,224,640,18,360,139,1,245,157,LTAdatasets/8702/annotate/8702-2021_03_20_193115.jpg,234.5,148.0,0.36640625,0.4111111111111111,0.0328125,0.05
8702-2021_03_20_193115.jpg,car,67,11,640,46,360,230,1,78,276,LTAdatasets/8702/annotate/8702-2021_03_20_193115.jpg,44.5,253.0,0.06953125,0.7027777777777777,0.1046875,0.12777777777777777
8702-2021_03_20_193115.jpg,lorry_truck,46,136,640,40,360,126,2,182,166,LTAdatasets/8702/annotate/8702-2021_03_20_193115.jpg,159.0,146.0,0.2484375,0.40555555555555556,0.071875,0.1111111111111111
8702-2021_03_20_193115.jpg,car,19,241,640,10,360,124,1,260,134,LTAdatasets/8702/annotate/8702-2021_03_20_193115.jpg,250.5,129.0,0.39140625,0.35833333333333334,0.0296875,0.027777777777777776
8702-2021_03_20_193115.jpg,car,22,370,640,13,360,123,1,392,136,LTAdatasets/8702/annotate/8702-2021_03_20_193115.jpg,381.0,129.5,0.5953125,0.3597222222222222,0.034375,0.03611111111111111
8702-2021_03_20_193115.jpg,car,17,186,640,12,360,125,1,203,137,LTAdatasets/8702/annotate/8702-2021_03_20_193115.jpg,194.5,131.0,0.30390625,0.3638888888888889,0.0265625,0.03333333333333333
8702-2021_03_20_193115.jpg,lorry_truck,17,227,640,18,360,105,2,244,123,LTAdatasets/8702/annotate/8702-2021_03_20_193115.jpg,235.5,114.0,0.36796875,0.31666666666666665,0.0265625,0.05
8702-2021_03_20_075138.jpg,bike,16,193,640,12,360,143,4,209,155,LTAdatasets/8702/annotate/8702-2021_03_20_075138.jpg,201.0,149.0,0.3140625,0.41388888888888886,0.025,0.03333333333333333
8702-2021_03_20_075138.jpg,car,23,198,640,17,360,152,1,221,169,LTAdatasets/8702/annotate/8702-2021_03_20_075138.jpg,209.5,160.5,0.32734375,0.44583333333333336,0.0359375,0.04722222222222222
8702-2021_03_20_075138.jpg,car,16,247,640,11,360,119,1,263,130,LTAdatasets/8702/annotate/8702-2021_03_20_075138.jpg,255.0,124.5,0.3984375,0.3458333333333333,0.025,0.030555555555555555
8702-2021_03_20_075138.jpg,car,15,318,640,10,360,112,1,333,122,LTAdatasets/8702/annotate/8702-2021_03_20_075138.jpg,325.5,117.0,0.50859375,0.325,0.0234375,0.027777777777777776
8702-2021_03_20_093103.jpg,car,34,472,640,35,360,197,1,506,232,LTAdatasets/8702/annotate/8702-2021_03_20_093103.jpg,489.0,214.5,0.7640625,0.5958333333333333,0.053125,0.09722222222222222
8702-2021_03_20_093103.jpg,lorry_truck,65,465,640,51,360,149,2,530,200,LTAdatasets/8702/annotate/8702-2021_03_20_093103.jpg,497.5,174.5,0.77734375,0.4847222222222222,0.1015625,0.14166666666666666
8702-2021_03_20_093103.jpg,car,54,527,640,51,360,231,1,581,282,LTAdatasets/8702/annotate/8702-2021_03_20_093103.jpg,554.0,256.5,0.865625,0.7125,0.084375,0.14166666666666666
8702-2021_03_20_093103.jpg,car,56,113,640,51,360,246,1,169,297,LTAdatasets/8702/annotate/8702-2021_03_20_093103.jpg,141.0,271.5,0.2203125,0.7541666666666667,0.0875,0.14166666666666666
8702-2021_03_20_093103.jpg,car,24,243,640,24,360,163,1,267,187,LTAdatasets/8702/annotate/8702-2021_03_20_093103.jpg,255.0,175.0,0.3984375,0.4861111111111111,0.0375,0.06666666666666667
8702-2021_03_20_093103.jpg,car,26,121,640,15,360,157,1,147,172,LTAdatasets/8702/annotate/8702-2021_03_20_093103.jpg,134.0,164.5,0.209375,0.45694444444444443,0.040625,0.041666666666666664
8702-2021_03_20_093103.jpg,car,22,115,640,16,360,144,1,137,160,LTAdatasets/8702/annotate/8702-2021_03_20_093103.jpg,126.0,152.0,0.196875,0.4222222222222222,0.034375,0.044444444444444446
8702-2021_03_20_093103.jpg,bike,23,88,640,29,360,197,4,111,226,LTAdatasets/8702/annotate/8702-2021_03_20_093103.jpg,99.5,211.5,0.15546875,0.5875,0.0359375,0.08055555555555556
8702-2021_03_20_093103.jpg,car,19,369,640,12,360,120,1,388,132,LTAdatasets/8702/annotate/8702-2021_03_20_093103.jpg,378.5,126.0,0.59140625,0.35,0.0296875,0.03333333333333333
8702-2021_03_20_074318.jpg,car,38,506,640,37,360,225,1,544,262,LTAdatasets/8702/annotate/8702-2021_03_20_074318.jpg,525.0,243.5,0.8203125,0.6763888888888889,0.059375,0.10277777777777777
8702-2021_03_20_074318.jpg,car,24,449,640,27,360,175,1,473,202,LTAdatasets/8702/annotate/8702-2021_03_20_074318.jpg,461.0,188.5,0.7203125,0.5236111111111111,0.0375,0.075
8702-2021_03_20_074318.jpg,car,17,295,640,18,360,158,1,312,176,LTAdatasets/8702/annotate/8702-2021_03_20_074318.jpg,303.5,167.0,0.47421875,0.4638888888888889,0.0265625,0.05
8702-2021_03_20_074318.jpg,car,14,257,640,21,360,157,1,271,178,LTAdatasets/8702/annotate/8702-2021_03_20_074318.jpg,264.0,167.5,0.4125,0.4652777777777778,0.021875,0.058333333333333334
8702-2021_03_20_074318.jpg,car,21,220,640,15,360,141,1,241,156,LTAdatasets/8702/annotate/8702-2021_03_20_074318.jpg,230.5,148.5,0.36015625,0.4125,0.0328125,0.041666666666666664
8702-2021_03_20_074318.jpg,lorry_truck,58,565,640,61,360,214,2,623,275,LTAdatasets/8702/annotate/8702-2021_03_20_074318.jpg,594.0,244.5,0.928125,0.6791666666666667,0.090625,0.16944444444444445
8702-2021_03_20_074318.jpg,lorry_truck,27,155,640,27,360,132,2,182,159,LTAdatasets/8702/annotate/8702-2021_03_20_074318.jpg,168.5,145.5,0.26328125,0.4041666666666667,0.0421875,0.075
8702-2021_03_20_074318.jpg,car,13,309,640,15,360,123,1,322,138,LTAdatasets/8702/annotate/8702-2021_03_20_074318.jpg,315.5,130.5,0.49296875,0.3625,0.0203125,0.041666666666666664
8702-2021_03_20_090402.jpg,van,24,277,640,26,360,161,3,301,187,LTAdatasets/8702/annotate/8702-2021_03_20_090402.jpg,289.0,174.0,0.4515625,0.48333333333333334,0.0375,0.07222222222222222
8702-2021_03_20_090402.jpg,bike,32,147,640,34,360,323,4,179,357,LTAdatasets/8702/annotate/8702-2021_03_20_090402.jpg,163.0,340.0,0.2546875,0.9444444444444444,0.05,0.09444444444444444
8702-2021_03_20_090402.jpg,car,16,368,640,12,360,122,1,384,134,LTAdatasets/8702/annotate/8702-2021_03_20_090402.jpg,376.0,128.0,0.5875,0.35555555555555557,0.025,0.03333333333333333
8702-2021_03_20_090402.jpg,car,17,247,640,17,360,125,1,264,142,LTAdatasets/8702/annotate/8702-2021_03_20_090402.jpg,255.5,133.5,0.39921875,0.37083333333333335,0.0265625,0.04722222222222222
8702-2021_03_20_090402.jpg,car,18,261,640,11,360,115,1,279,126,LTAdatasets/8702/annotate/8702-2021_03_20_090402.jpg,270.0,120.5,0.421875,0.3347222222222222,0.028125,0.030555555555555555
8702-2021_03_20_184613.jpg,car,26,174,640,18,360,165,1,200,183,LTAdatasets/8702/annotate/8702-2021_03_20_184613.jpg,187.0,174.0,0.2921875,0.48333333333333334,0.040625,0.05
8702-2021_03_20_184613.jpg,bike,12,130,640,26,360,178,4,142,204,LTAdatasets/8702/annotate/8702-2021_03_20_184613.jpg,136.0,191.0,0.2125,0.5305555555555556,0.01875,0.07222222222222222
8702-2021_03_20_184613.jpg,bike,15,104,640,23,360,183,4,119,206,LTAdatasets/8702/annotate/8702-2021_03_20_184613.jpg,111.5,194.5,0.17421875,0.5402777777777777,0.0234375,0.06388888888888888
8702-2021_03_20_184613.jpg,van,32,114,640,23,360,154,3,146,177,LTAdatasets/8702/annotate/8702-2021_03_20_184613.jpg,130.0,165.5,0.203125,0.4597222222222222,0.05,0.06388888888888888
8702-2021_03_20_184613.jpg,car,17,182,640,13,360,132,1,199,145,LTAdatasets/8702/annotate/8702-2021_03_20_184613.jpg,190.5,138.5,0.29765625,0.38472222222222224,0.0265625,0.03611111111111111
8702-2021_03_20_184613.jpg,car,24,176,640,14,360,149,1,200,163,LTAdatasets/8702/annotate/8702-2021_03_20_184613.jpg,188.0,156.0,0.29375,0.43333333333333335,0.0375,0.03888888888888889
8702-2021_03_20_184613.jpg,lorry_truck,11,389,640,18,360,109,2,400,127,LTAdatasets/8702/annotate/8702-2021_03_20_184613.jpg,394.5,118.0,0.61640625,0.3277777777777778,0.0171875,0.05
8702-2021_03_20_184613.jpg,lorry_truck,21,563,640,19,360,165,2,584,184,LTAdatasets/8702/annotate/8702-2021_03_20_184613.jpg,573.5,174.5,0.89609375,0.4847222222222222,0.0328125,0.05277777777777778
8702-2021_03_20_184613.jpg,car,14,339,640,16,360,109,1,353,125,LTAdatasets/8702/annotate/8702-2021_03_20_184613.jpg,346.0,117.0,0.540625,0.325,0.021875,0.044444444444444446
8702-2021_03_20_184613.jpg,lorry_truck,18,481,640,28,360,117,2,499,145,LTAdatasets/8702/annotate/8702-2021_03_20_184613.jpg,490.0,131.0,0.765625,0.3638888888888889,0.028125,0.07777777777777778
8702-2021_03_20_203358.jpg,bike,16,459,640,25,360,182,4,475,207,LTAdatasets/8702/annotate/8702-2021_03_20_203358.jpg,467.0,194.5,0.7296875,0.5402777777777777,0.025,0.06944444444444445
8702-2021_03_20_203358.jpg,bike,19,76,640,22,360,182,4,95,204,LTAdatasets/8702/annotate/8702-2021_03_20_203358.jpg,85.5,193.0,0.13359375,0.5361111111111111,0.0296875,0.06111111111111111
8702-2021_03_20_203358.jpg,bike,16,195,640,11,360,125,4,211,136,LTAdatasets/8702/annotate/8702-2021_03_20_203358.jpg,203.0,130.5,0.3171875,0.3625,0.025,0.030555555555555555
8702-2021_03_20_203358.jpg,lorry_truck,34,94,640,29,360,140,2,128,169,LTAdatasets/8702/annotate/8702-2021_03_20_203358.jpg,111.0,154.5,0.1734375,0.42916666666666664,0.053125,0.08055555555555556
8702-2021_03_20_203358.jpg,car,25,77,640,10,360,134,1,102,144,LTAdatasets/8702/annotate/8702-2021_03_20_203358.jpg,89.5,139.0,0.13984375,0.3861111111111111,0.0390625,0.027777777777777776
8702-2021_03_20_203358.jpg,car,17,379,640,15,360,129,1,396,144,LTAdatasets/8702/annotate/8702-2021_03_20_203358.jpg,387.5,136.5,0.60546875,0.37916666666666665,0.0265625,0.041666666666666664
8702-2021_03_20_094024.jpg,car,42,495,640,37,360,219,1,537,256,LTAdatasets/8702/annotate/8702-2021_03_20_094024.jpg,516.0,237.5,0.80625,0.6597222222222222,0.065625,0.10277777777777777
8702-2021_03_20_094024.jpg,car,48,569,640,39,360,234,1,617,273,LTAdatasets/8702/annotate/8702-2021_03_20_094024.jpg,593.0,253.5,0.9265625,0.7041666666666667,0.075,0.10833333333333334
8702-2021_03_20_094024.jpg,lorry_truck,22,477,640,25,360,181,2,499,206,LTAdatasets/8702/annotate/8702-2021_03_20_094024.jpg,488.0,193.5,0.7625,0.5375,0.034375,0.06944444444444445
8702-2021_03_20_094024.jpg,van,22,318,640,24,360,123,3,340,147,LTAdatasets/8702/annotate/8702-2021_03_20_094024.jpg,329.0,135.0,0.5140625,0.375,0.034375,0.06666666666666667
8702-2021_03_20_094024.jpg,car,19,235,640,10,360,133,1,254,143,LTAdatasets/8702/annotate/8702-2021_03_20_094024.jpg,244.5,138.0,0.38203125,0.38333333333333336,0.0296875,0.027777777777777776
8702-2021_03_20_094024.jpg,lorry_truck,60,68,640,37,360,154,2,128,191,LTAdatasets/8702/annotate/8702-2021_03_20_094024.jpg,98.0,172.5,0.153125,0.4791666666666667,0.09375,0.10277777777777777
8702-2021_03_20_094024.jpg,lorry_truck,13,261,640,10,360,112,2,274,122,LTAdatasets/8702/annotate/8702-2021_03_20_094024.jpg,267.5,117.0,0.41796875,0.325,0.0203125,0.027777777777777776
8702-2021_03_20_094024.jpg,lorry_truck,39,171,640,22,360,115,2,210,137,LTAdatasets/8702/annotate/8702-2021_03_20_094024.jpg,190.5,126.0,0.29765625,0.35,0.0609375,0.06111111111111111
8702-2021_03_20_080939.jpg,lorry_truck,22,313,640,21,360,122,2,335,143,LTAdatasets/8702/annotate/8702-2021_03_20_080939.jpg,324.0,132.5,0.50625,0.3680555555555556,0.034375,0.058333333333333334
8702-2021_03_20_080939.jpg,car,60,97,640,72,360,254,1,157,326,LTAdatasets/8702/annotate/8702-2021_03_20_080939.jpg,127.0,290.0,0.1984375,0.8055555555555556,0.09375,0.2
8702-2021_03_20_080939.jpg,bike,29,565,640,49,360,246,4,594,295,LTAdatasets/8702/annotate/8702-2021_03_20_080939.jpg,579.5,270.5,0.90546875,0.7513888888888889,0.0453125,0.1361111111111111
8702-2021_03_20_080939.jpg,bike,19,139,640,25,360,173,4,158,198,LTAdatasets/8702/annotate/8702-2021_03_20_080939.jpg,148.5,185.5,0.23203125,0.5152777777777777,0.0296875,0.06944444444444445
8702-2021_03_20_080939.jpg,car,24,186,640,15,360,143,1,210,158,LTAdatasets/8702/annotate/8702-2021_03_20_080939.jpg,198.0,150.5,0.309375,0.41805555555555557,0.0375,0.041666666666666664
8702-2021_03_20_080939.jpg,van,22,159,640,20,360,136,3,181,156,LTAdatasets/8702/annotate/8702-2021_03_20_080939.jpg,170.0,146.0,0.265625,0.40555555555555556,0.034375,0.05555555555555555
8702-2021_03_20_080939.jpg,car,17,252,640,9,360,130,1,269,139,LTAdatasets/8702/annotate/8702-2021_03_20_080939.jpg,260.5,134.5,0.40703125,0.3736111111111111,0.0265625,0.025
8702-2021_03_20_080939.jpg,car,22,225,640,13,360,123,1,247,136,LTAdatasets/8702/annotate/8702-2021_03_20_080939.jpg,236.0,129.5,0.36875,0.3597222222222222,0.034375,0.03611111111111111
8702-2021_03_20_080939.jpg,car,20,368,640,11,360,123,1,388,134,LTAdatasets/8702/annotate/8702-2021_03_20_080939.jpg,378.0,128.5,0.590625,0.35694444444444445,0.03125,0.030555555555555555
8702-2021_03_20_080939.jpg,car,34,0,640,34,360,260,1,34,294,LTAdatasets/8702/annotate/8702-2021_03_20_080939.jpg,17.0,277.0,0.0265625,0.7694444444444445,0.053125,0.09444444444444444
8702-2021_03_20_183712.jpg,car,72,153,640,60,360,279,1,225,339,LTAdatasets/8702/annotate/8702-2021_03_20_183712.jpg,189.0,309.0,0.2953125,0.8583333333333333,0.1125,0.16666666666666666
8702-2021_03_20_183712.jpg,car,30,155,640,14,360,159,1,185,173,LTAdatasets/8702/annotate/8702-2021_03_20_183712.jpg,170.0,166.0,0.265625,0.46111111111111114,0.046875,0.03888888888888889
8702-2021_03_20_183712.jpg,car,20,235,640,14,360,137,1,255,151,LTAdatasets/8702/annotate/8702-2021_03_20_183712.jpg,245.0,144.0,0.3828125,0.4,0.03125,0.03888888888888889
8702-2021_03_20_183712.jpg,car,20,226,640,9,360,129,1,246,138,LTAdatasets/8702/annotate/8702-2021_03_20_183712.jpg,236.0,133.5,0.36875,0.37083333333333335,0.03125,0.025
8702-2021_03_20_183712.jpg,car,20,150,640,15,360,140,1,170,155,LTAdatasets/8702/annotate/8702-2021_03_20_183712.jpg,160.0,147.5,0.25,0.4097222222222222,0.03125,0.041666666666666664
8702-2021_03_20_195136.jpg,car,18,377,640,17,360,130,1,395,147,LTAdatasets/8702/annotate/8702-2021_03_20_195136.jpg,386.0,138.5,0.603125,0.38472222222222224,0.028125,0.04722222222222222
8702-2021_03_20_195136.jpg,car,14,369,640,9,360,117,1,383,126,LTAdatasets/8702/annotate/8702-2021_03_20_195136.jpg,376.0,121.5,0.5875,0.3375,0.021875,0.025
8702-2021_03_20_195136.jpg,lorry_truck,20,188,640,18,360,130,2,208,148,LTAdatasets/8702/annotate/8702-2021_03_20_195136.jpg,198.0,139.0,0.309375,0.3861111111111111,0.03125,0.05
8702-2021_03_20_195136.jpg,car,20,136,640,11,360,144,1,156,155,LTAdatasets/8702/annotate/8702-2021_03_20_195136.jpg,146.0,149.5,0.228125,0.4152777777777778,0.03125,0.030555555555555555
8702-2021_03_20_085501.jpg,car,22,207,640,20,360,142,1,229,162,LTAdatasets/8702/annotate/8702-2021_03_20_085501.jpg,218.0,152.0,0.340625,0.4222222222222222,0.034375,0.05555555555555555
8702-2021_03_20_085501.jpg,car,18,461,640,17,360,168,1,479,185,LTAdatasets/8702/annotate/8702-2021_03_20_085501.jpg,470.0,176.5,0.734375,0.49027777777777776,0.028125,0.04722222222222222
8702-2021_03_20_085501.jpg,lorry_truck,24,314,640,34,360,120,2,338,154,LTAdatasets/8702/annotate/8702-2021_03_20_085501.jpg,326.0,137.0,0.509375,0.38055555555555554,0.0375,0.09444444444444444
8702-2021_03_20_085501.jpg,bike,7,385,640,11,360,118,4,392,129,LTAdatasets/8702/annotate/8702-2021_03_20_085501.jpg,388.5,123.5,0.60703125,0.34305555555555556,0.0109375,0.030555555555555555
8702-2021_03_20_081319.jpg,car,21,264,640,19,360,158,1,285,177,LTAdatasets/8702/annotate/8702-2021_03_20_081319.jpg,274.5,167.5,0.42890625,0.4652777777777778,0.0328125,0.05277777777777778
8702-2021_03_20_081319.jpg,car,33,114,640,21,360,191,1,147,212,LTAdatasets/8702/annotate/8702-2021_03_20_081319.jpg,130.5,201.5,0.20390625,0.5597222222222222,0.0515625,0.058333333333333334
8702-2021_03_20_081319.jpg,car,23,207,640,18,360,146,1,230,164,LTAdatasets/8702/annotate/8702-2021_03_20_081319.jpg,218.5,155.0,0.34140625,0.4305555555555556,0.0359375,0.05
8702-2021_03_20_081319.jpg,van,28,114,640,21,360,141,3,142,162,LTAdatasets/8702/annotate/8702-2021_03_20_081319.jpg,128.0,151.5,0.2,0.42083333333333334,0.04375,0.058333333333333334
8702-2021_03_20_081319.jpg,car,14,279,640,9,360,114,1,293,123,LTAdatasets/8702/annotate/8702-2021_03_20_081319.jpg,286.0,118.5,0.446875,0.32916666666666666,0.021875,0.025
8702-2021_03_20_081319.jpg,lorry_truck,16,383,640,24,360,103,2,399,127,LTAdatasets/8702/annotate/8702-2021_03_20_081319.jpg,391.0,115.0,0.6109375,0.3194444444444444,0.025,0.06666666666666667
8702-2021_03_20_182451.jpg,car,33,549,640,34,360,196,1,582,230,LTAdatasets/8702/annotate/8702-2021_03_20_182451.jpg,565.5,213.0,0.88359375,0.5916666666666667,0.0515625,0.09444444444444444
8702-2021_03_20_182451.jpg,car,22,470,640,24,360,153,1,492,177,LTAdatasets/8702/annotate/8702-2021_03_20_182451.jpg,481.0,165.0,0.7515625,0.4583333333333333,0.034375,0.06666666666666667
8702-2021_03_20_182451.jpg,car,39,72,640,36,360,178,1,111,214,LTAdatasets/8702/annotate/8702-2021_03_20_182451.jpg,91.5,196.0,0.14296875,0.5444444444444444,0.0609375,0.1
8702-2021_03_20_182451.jpg,car,23,201,640,15,360,149,1,224,164,LTAdatasets/8702/annotate/8702-2021_03_20_182451.jpg,212.5,156.5,0.33203125,0.43472222222222223,0.0359375,0.041666666666666664
8702-2021_03_20_182451.jpg,bike,12,273,640,21,360,151,4,285,172,LTAdatasets/8702/annotate/8702-2021_03_20_182451.jpg,279.0,161.5,0.4359375,0.4486111111111111,0.01875,0.058333333333333334
8702-2021_03_20_182451.jpg,car,14,244,640,15,360,122,1,258,137,LTAdatasets/8702/annotate/8702-2021_03_20_182451.jpg,251.0,129.5,0.3921875,0.3597222222222222,0.021875,0.041666666666666664
8702-2021_03_20_182451.jpg,car,12,273,640,12,360,120,1,285,132,LTAdatasets/8702/annotate/8702-2021_03_20_182451.jpg,279.0,126.0,0.4359375,0.35,0.01875,0.03333333333333333
8702-2021_03_20_182451.jpg,car,13,374,640,10,360,125,1,387,135,LTAdatasets/8702/annotate/8702-2021_03_20_182451.jpg,380.5,130.0,0.59453125,0.3611111111111111,0.0203125,0.027777777777777776
8702-2021_03_20_182451.jpg,car,13,365,640,10,360,116,1,378,126,LTAdatasets/8702/annotate/8702-2021_03_20_182451.jpg,371.5,121.0,0.58046875,0.33611111111111114,0.0203125,0.027777777777777776
8702-2021_03_20_182451.jpg,lorry_truck,18,476,640,28,360,120,2,494,148,LTAdatasets/8702/annotate/8702-2021_03_20_182451.jpg,485.0,134.0,0.7578125,0.37222222222222223,0.028125,0.07777777777777778
8702-2021_03_20_182451.jpg,lorry_truck,15,266,640,16,360,101,2,281,117,LTAdatasets/8702/annotate/8702-2021_03_20_182451.jpg,273.5,109.0,0.42734375,0.30277777777777776,0.0234375,0.044444444444444446
8702-2021_03_20_182451.jpg,lorry_truck,18,246,640,16,360,106,2,264,122,LTAdatasets/8702/annotate/8702-2021_03_20_182451.jpg,255.0,114.0,0.3984375,0.31666666666666665,0.028125,0.044444444444444446
8702-2021_03_20_182451.jpg,car,23,34,640,12,360,144,1,57,156,LTAdatasets/8702/annotate/8702-2021_03_20_182451.jpg,45.5,150.0,0.07109375,0.4166666666666667,0.0359375,0.03333333333333333
8702-2021_03_20_200637.jpg,car,37,466,640,24,360,171,1,503,195,LTAdatasets/8702/annotate/8702-2021_03_20_200637.jpg,484.5,183.0,0.75703125,0.5083333333333333,0.0578125,0.06666666666666667
8702-2021_03_20_200637.jpg,car,22,184,640,20,360,133,1,206,153,LTAdatasets/8702/annotate/8702-2021_03_20_200637.jpg,195.0,143.0,0.3046875,0.3972222222222222,0.034375,0.05555555555555555
8702-2021_03_20_200637.jpg,lorry_truck,58,54,640,43,360,154,2,112,197,LTAdatasets/8702/annotate/8702-2021_03_20_200637.jpg,83.0,175.5,0.1296875,0.4875,0.090625,0.11944444444444445
8702-2021_03_20_200637.jpg,car,19,336,640,9,360,119,1,355,128,LTAdatasets/8702/annotate/8702-2021_03_20_200637.jpg,345.5,123.5,0.53984375,0.34305555555555556,0.0296875,0.025
8702-2021_03_20_200637.jpg,car,15,384,640,12,360,119,1,399,131,LTAdatasets/8702/annotate/8702-2021_03_20_200637.jpg,391.5,125.0,0.61171875,0.3472222222222222,0.0234375,0.03333333333333333
8702-2021_03_20_202437.jpg,lorry_truck,75,540,640,60,360,173,2,615,233,LTAdatasets/8702/annotate/8702-2021_03_20_202437.jpg,577.5,203.0,0.90234375,0.5638888888888889,0.1171875,0.16666666666666666
8702-2021_03_20_202437.jpg,bike,16,624,640,35,360,256,4,640,291,LTAdatasets/8702/annotate/8702-2021_03_20_202437.jpg,632.0,273.5,0.9875,0.7597222222222222,0.025,0.09722222222222222
8702-2021_03_20_202437.jpg,van,26,260,640,35,360,144,3,286,179,LTAdatasets/8702/annotate/8702-2021_03_20_202437.jpg,273.0,161.5,0.4265625,0.4486111111111111,0.040625,0.09722222222222222
8702-2021_03_20_202437.jpg,car,20,194,640,10,360,131,1,214,141,LTAdatasets/8702/annotate/8702-2021_03_20_202437.jpg,204.0,136.0,0.31875,0.37777777777777777,0.03125,0.027777777777777776
8702-2021_03_20_084301.jpg,van,43,228,640,41,360,201,3,271,242,LTAdatasets/8702/annotate/8702-2021_03_20_084301.jpg,249.5,221.5,0.38984375,0.6152777777777778,0.0671875,0.11388888888888889
8702-2021_03_20_084301.jpg,lorry_truck,64,482,640,74,360,145,2,546,219,LTAdatasets/8702/annotate/8702-2021_03_20_084301.jpg,514.0,182.0,0.803125,0.5055555555555555,0.1,0.20555555555555555
8702-2021_03_20_084301.jpg,lorry_truck,25,174,640,20,360,123,2,199,143,LTAdatasets/8702/annotate/8702-2021_03_20_084301.jpg,186.5,133.0,0.29140625,0.36944444444444446,0.0390625,0.05555555555555555
8702-2021_03_20_084301.jpg,lorry_truck,33,228,640,24,360,98,2,261,122,LTAdatasets/8702/annotate/8702-2021_03_20_084301.jpg,244.5,110.0,0.38203125,0.3055555555555556,0.0515625,0.06666666666666667
8702-2021_03_20_084301.jpg,car,22,175,640,16,360,149,1,197,165,LTAdatasets/8702/annotate/8702-2021_03_20_084301.jpg,186.0,157.0,0.290625,0.4361111111111111,0.034375,0.044444444444444446
8702-2021_03_20_084301.jpg,van,28,126,640,13,360,142,3,154,155,LTAdatasets/8702/annotate/8702-2021_03_20_084301.jpg,140.0,148.5,0.21875,0.4125,0.04375,0.03611111111111111
8702-2021_03_20_084301.jpg,car,43,21,640,14,360,172,1,64,186,LTAdatasets/8702/annotate/8702-2021_03_20_084301.jpg,42.5,179.0,0.06640625,0.49722222222222223,0.0671875,0.03888888888888889
8702-2021_03_20_084301.jpg,car,16,366,640,12,360,123,1,382,135,LTAdatasets/8702/annotate/8702-2021_03_20_084301.jpg,374.0,129.0,0.584375,0.35833333333333334,0.025,0.03333333333333333
8702-2021_03_20_084001.jpg,car,30,484,640,29,360,201,1,514,230,LTAdatasets/8702/annotate/8702-2021_03_20_084001.jpg,499.0,215.5,0.7796875,0.5986111111111111,0.046875,0.08055555555555556
8702-2021_03_20_084001.jpg,car,43,74,640,24,360,206,1,117,230,LTAdatasets/8702/annotate/8702-2021_03_20_084001.jpg,95.5,218.0,0.14921875,0.6055555555555555,0.0671875,0.06666666666666667
8702-2021_03_20_084001.jpg,car,40,31,640,29,360,198,1,71,227,LTAdatasets/8702/annotate/8702-2021_03_20_084001.jpg,51.0,212.5,0.0796875,0.5902777777777778,0.0625,0.08055555555555556
8702-2021_03_20_084001.jpg,car,24,184,640,17,360,161,1,208,178,LTAdatasets/8702/annotate/8702-2021_03_20_084001.jpg,196.0,169.5,0.30625,0.4708333333333333,0.0375,0.04722222222222222
8702-2021_03_20_084001.jpg,lorry_truck,43,265,640,47,360,148,2,308,195,LTAdatasets/8702/annotate/8702-2021_03_20_084001.jpg,286.5,171.5,0.44765625,0.47638888888888886,0.0671875,0.13055555555555556
8702-2021_03_20_084001.jpg,car,30,130,640,13,360,151,1,160,164,LTAdatasets/8702/annotate/8702-2021_03_20_084001.jpg,145.0,157.5,0.2265625,0.4375,0.046875,0.03611111111111111
8702-2021_03_20_084001.jpg,bike,16,146,640,15,360,165,4,162,180,LTAdatasets/8702/annotate/8702-2021_03_20_084001.jpg,154.0,172.5,0.240625,0.4791666666666667,0.025,0.041666666666666664
8702-2021_03_20_084001.jpg,bike,11,240,640,14,360,131,4,251,145,LTAdatasets/8702/annotate/8702-2021_03_20_084001.jpg,245.5,138.0,0.38359375,0.38333333333333336,0.0171875,0.03888888888888889
8702-2021_03_20_084001.jpg,car,22,207,640,18,360,130,1,229,148,LTAdatasets/8702/annotate/8702-2021_03_20_084001.jpg,218.0,139.0,0.340625,0.3861111111111111,0.034375,0.05
8702-2021_03_20_084001.jpg,van,21,180,640,18,360,129,3,201,147,LTAdatasets/8702/annotate/8702-2021_03_20_084001.jpg,190.5,138.0,0.29765625,0.38333333333333336,0.0328125,0.05
8702-2021_03_20_084001.jpg,car,20,371,640,14,360,127,1,391,141,LTAdatasets/8702/annotate/8702-2021_03_20_084001.jpg,381.0,134.0,0.5953125,0.37222222222222223,0.03125,0.03888888888888889
8702-2021_03_20_092803.jpg,lorry_truck,67,568,640,56,360,207,2,635,263,LTAdatasets/8702/annotate/8702-2021_03_20_092803.jpg,601.5,235.0,0.93984375,0.6527777777777778,0.1046875,0.15555555555555556
8702-2021_03_20_092803.jpg,car,38,201,640,41,360,185,1,239,226,LTAdatasets/8702/annotate/8702-2021_03_20_092803.jpg,220.0,205.5,0.34375,0.5708333333333333,0.059375,0.11388888888888889
8702-2021_03_20_092803.jpg,car,24,278,640,18,360,137,1,302,155,LTAdatasets/8702/annotate/8702-2021_03_20_092803.jpg,290.0,146.0,0.453125,0.40555555555555556,0.0375,0.05
8702-2021_03_20_092803.jpg,van,24,227,640,18,360,131,3,251,149,LTAdatasets/8702/annotate/8702-2021_03_20_092803.jpg,239.0,140.0,0.3734375,0.3888888888888889,0.0375,0.05
8702-2021_03_20_092803.jpg,lorry_truck,18,322,640,14,360,121,2,340,135,LTAdatasets/8702/annotate/8702-2021_03_20_092803.jpg,331.0,128.0,0.5171875,0.35555555555555557,0.028125,0.03888888888888889
8702-2021_03_20_092803.jpg,van,18,479,640,13,360,135,3,497,148,LTAdatasets/8702/annotate/8702-2021_03_20_092803.jpg,488.0,141.5,0.7625,0.39305555555555555,0.028125,0.03611111111111111
8702-2021_03_20_092803.jpg,bike,8,235,640,12,360,110,4,243,122,LTAdatasets/8702/annotate/8702-2021_03_20_092803.jpg,239.0,116.0,0.3734375,0.32222222222222224,0.0125,0.03333333333333333
8702-2021_03_20_092803.jpg,car,12,254,640,8,360,110,1,266,118,LTAdatasets/8702/annotate/8702-2021_03_20_092803.jpg,260.0,114.0,0.40625,0.31666666666666665,0.01875,0.022222222222222223
8702-2021_03_20_091002.jpg,car,44,561,640,28,360,208,1,605,236,LTAdatasets/8702/annotate/8702-2021_03_20_091002.jpg,583.0,222.0,0.9109375,0.6166666666666667,0.06875,0.07777777777777778
8702-2021_03_20_091002.jpg,lorry_truck,34,472,640,49,360,149,2,506,198,LTAdatasets/8702/annotate/8702-2021_03_20_091002.jpg,489.0,173.5,0.7640625,0.48194444444444445,0.053125,0.1361111111111111
8702-2021_03_20_091002.jpg,lorry_truck,38,454,640,31,360,180,2,492,211,LTAdatasets/8702/annotate/8702-2021_03_20_091002.jpg,473.0,195.5,0.7390625,0.5430555555555555,0.059375,0.08611111111111111
8702-2021_03_20_091002.jpg,lorry_truck,34,110,640,27,360,154,2,144,181,LTAdatasets/8702/annotate/8702-2021_03_20_091002.jpg,127.0,167.5,0.1984375,0.4652777777777778,0.053125,0.075
8702-2021_03_20_091002.jpg,car,19,377,640,14,360,128,1,396,142,LTAdatasets/8702/annotate/8702-2021_03_20_091002.jpg,386.5,135.0,0.60390625,0.375,0.0296875,0.03888888888888889
8702-2021_03_20_202217.jpg,car,31,462,640,27,360,198,1,493,225,LTAdatasets/8702/annotate/8702-2021_03_20_202217.jpg,477.5,211.5,0.74609375,0.5875,0.0484375,0.075
8702-2021_03_20_202217.jpg,lorry_truck,35,498,640,52,360,160,2,533,212,LTAdatasets/8702/annotate/8702-2021_03_20_202217.jpg,515.5,186.0,0.80546875,0.5166666666666667,0.0546875,0.14444444444444443
8702-2021_03_20_202217.jpg,car,31,136,640,23,360,163,1,167,186,LTAdatasets/8702/annotate/8702-2021_03_20_202217.jpg,151.5,174.5,0.23671875,0.4847222222222222,0.0484375,0.06388888888888888
8702-2021_03_20_202217.jpg,bike,18,146,640,17,360,147,4,164,164,LTAdatasets/8702/annotate/8702-2021_03_20_202217.jpg,155.0,155.5,0.2421875,0.43194444444444446,0.028125,0.04722222222222222
8702-2021_03_20_202217.jpg,car,16,381,640,17,360,128,1,397,145,LTAdatasets/8702/annotate/8702-2021_03_20_202217.jpg,389.0,136.5,0.6078125,0.37916666666666665,0.025,0.04722222222222222
8702-2021_03_20_185753.jpg,car,61,19,640,32,360,236,1,80,268,LTAdatasets/8702/annotate/8702-2021_03_20_185753.jpg,49.5,252.0,0.07734375,0.7,0.0953125,0.08888888888888889
8702-2021_03_20_185753.jpg,car,34,135,640,24,360,177,1,169,201,LTAdatasets/8702/annotate/8702-2021_03_20_185753.jpg,152.0,189.0,0.2375,0.525,0.053125,0.06666666666666667
8702-2021_03_20_185753.jpg,lorry_truck,21,478,640,31,360,120,2,499,151,LTAdatasets/8702/annotate/8702-2021_03_20_185753.jpg,488.5,135.5,0.76328125,0.3763888888888889,0.0328125,0.08611111111111111
8702-2021_03_20_185753.jpg,car,16,272,640,14,360,115,1,288,129,LTAdatasets/8702/annotate/8702-2021_03_20_185753.jpg,280.0,122.0,0.4375,0.3388888888888889,0.025,0.03888888888888889
8702-2021_03_20_185753.jpg,car,11,383,640,10,360,112,1,394,122,LTAdatasets/8702/annotate/8702-2021_03_20_185753.jpg,388.5,117.0,0.60703125,0.325,0.0171875,0.027777777777777776
8702-2021_03_20_100105.jpg,car,41,517,640,30,360,200,1,558,230,LTAdatasets/8702/annotate/8702-2021_03_20_100105.jpg,537.5,215.0,0.83984375,0.5972222222222222,0.0640625,0.08333333333333333
8702-2021_03_20_100105.jpg,car,34,474,640,28,360,156,1,508,184,LTAdatasets/8702/annotate/8702-2021_03_20_100105.jpg,491.0,170.0,0.7671875,0.4722222222222222,0.053125,0.07777777777777778
8702-2021_03_20_100105.jpg,car,36,134,640,24,360,154,1,170,178,LTAdatasets/8702/annotate/8702-2021_03_20_100105.jpg,152.0,166.0,0.2375,0.46111111111111114,0.05625,0.06666666666666667
8702-2021_03_20_100105.jpg,van,14,265,640,13,360,108,3,279,121,LTAdatasets/8702/annotate/8702-2021_03_20_100105.jpg,272.0,114.5,0.425,0.31805555555555554,0.021875,0.03611111111111111
8702-2021_03_20_100105.jpg,car,11,386,640,13,360,128,1,397,141,LTAdatasets/8702/annotate/8702-2021_03_20_100105.jpg,391.5,134.5,0.61171875,0.3736111111111111,0.0171875,0.03611111111111111
8702-2021_03_20_100105.jpg,car,15,362,640,10,360,111,1,377,121,LTAdatasets/8702/annotate/8702-2021_03_20_100105.jpg,369.5,116.0,0.57734375,0.32222222222222224,0.0234375,0.027777777777777776
8702-2021_03_20_203658.jpg,car,25,275,640,22,360,171,1,300,193,LTAdatasets/8702/annotate/8702-2021_03_20_203658.jpg,287.5,182.0,0.44921875,0.5055555555555555,0.0390625,0.06111111111111111
8702-2021_03_20_203658.jpg,car,18,221,640,14,360,129,1,239,143,LTAdatasets/8702/annotate/8702-2021_03_20_203658.jpg,230.0,136.0,0.359375,0.37777777777777777,0.028125,0.03888888888888889
8702-2021_03_20_203658.jpg,car,22,261,640,11,360,124,1,283,135,LTAdatasets/8702/annotate/8702-2021_03_20_203658.jpg,272.0,129.5,0.425,0.3597222222222222,0.034375,0.030555555555555555
8702-2021_03_20_203658.jpg,car,11,265,640,8,360,116,1,276,124,LTAdatasets/8702/annotate/8702-2021_03_20_203658.jpg,270.5,120.0,0.42265625,0.3333333333333333,0.0171875,0.022222222222222223
8702-2021_03_20_201617.jpg,car,43,502,640,35,360,195,1,545,230,LTAdatasets/8702/annotate/8702-2021_03_20_201617.jpg,523.5,212.5,0.81796875,0.5902777777777778,0.0671875,0.09722222222222222
8702-2021_03_20_201617.jpg,car,22,214,640,17,360,142,1,236,159,LTAdatasets/8702/annotate/8702-2021_03_20_201617.jpg,225.0,150.5,0.3515625,0.41805555555555557,0.034375,0.04722222222222222
8702-2021_03_20_201617.jpg,car,15,202,640,11,360,131,1,217,142,LTAdatasets/8702/annotate/8702-2021_03_20_201617.jpg,209.5,136.5,0.32734375,0.37916666666666665,0.0234375,0.030555555555555555
8702-2021_03_20_201617.jpg,car,45,95,640,22,360,178,1,140,200,LTAdatasets/8702/annotate/8702-2021_03_20_201617.jpg,117.5,189.0,0.18359375,0.525,0.0703125,0.06111111111111111
8702-2021_03_20_201617.jpg,car,29,17,640,12,360,146,1,46,158,LTAdatasets/8702/annotate/8702-2021_03_20_201617.jpg,31.5,152.0,0.04921875,0.4222222222222222,0.0453125,0.03333333333333333
8702-2021_03_20_201617.jpg,car,21,77,640,15,360,137,1,98,152,LTAdatasets/8702/annotate/8702-2021_03_20_201617.jpg,87.5,144.5,0.13671875,0.4013888888888889,0.0328125,0.041666666666666664
8702-2021_03_20_182151.jpg,car,63,562,640,55,360,274,1,625,329,LTAdatasets/8702/annotate/8702-2021_03_20_182151.jpg,593.5,301.5,0.92734375,0.8375,0.0984375,0.1527777777777778
8702-2021_03_20_182151.jpg,car,27,463,640,24,360,168,1,490,192,LTAdatasets/8702/annotate/8702-2021_03_20_182151.jpg,476.5,180.0,0.74453125,0.5,0.0421875,0.06666666666666667
8702-2021_03_20_182151.jpg,lorry_truck,46,169,640,19,360,143,2,215,162,LTAdatasets/8702/annotate/8702-2021_03_20_182151.jpg,192.0,152.5,0.3,0.4236111111111111,0.071875,0.05277777777777778
8702-2021_03_20_182151.jpg,car,14,261,640,14,360,123,1,275,137,LTAdatasets/8702/annotate/8702-2021_03_20_182151.jpg,268.0,130.0,0.41875,0.3611111111111111,0.021875,0.03888888888888889
8702-2021_03_20_182151.jpg,bike,14,383,640,17,360,130,4,397,147,LTAdatasets/8702/annotate/8702-2021_03_20_182151.jpg,390.0,138.5,0.609375,0.38472222222222224,0.021875,0.04722222222222222
8702-2021_03_20_182151.jpg,lorry_truck,18,477,640,24,360,120,2,495,144,LTAdatasets/8702/annotate/8702-2021_03_20_182151.jpg,486.0,132.0,0.759375,0.36666666666666664,0.028125,0.06666666666666667
8702-2021_03_20_182151.jpg,car,18,367,640,12,360,120,1,385,132,LTAdatasets/8702/annotate/8702-2021_03_20_182151.jpg,376.0,126.0,0.5875,0.35,0.028125,0.03333333333333333
8702-2021_03_20_085822.jpg,van,69,558,640,69,360,255,3,627,324,LTAdatasets/8702/annotate/8702-2021_03_20_085822.jpg,592.5,289.5,0.92578125,0.8041666666666667,0.1078125,0.19166666666666668
8702-2021_03_20_085822.jpg,car,46,184,640,48,360,201,1,230,249,LTAdatasets/8702/annotate/8702-2021_03_20_085822.jpg,207.0,225.0,0.3234375,0.625,0.071875,0.13333333333333333
8702-2021_03_20_085822.jpg,lorry_truck,52,37,640,53,360,178,2,89,231,LTAdatasets/8702/annotate/8702-2021_03_20_085822.jpg,63.0,204.5,0.0984375,0.5680555555555555,0.08125,0.14722222222222223
8702-2021_03_20_085822.jpg,lorry_truck,20,172,640,19,360,133,2,192,152,LTAdatasets/8702/annotate/8702-2021_03_20_085822.jpg,182.0,142.5,0.284375,0.3958333333333333,0.03125,0.05277777777777778
8702-2021_03_20_202758.jpg,car,45,595,640,64,360,294,1,640,358,LTAdatasets/8702/annotate/8702-2021_03_20_202758.jpg,617.5,326.0,0.96484375,0.9055555555555556,0.0703125,0.17777777777777778
8702-2021_03_20_202758.jpg,car,25,494,640,23,360,168,1,519,191,LTAdatasets/8702/annotate/8702-2021_03_20_202758.jpg,506.5,179.5,0.79140625,0.4986111111111111,0.0390625,0.06388888888888888
8702-2021_03_20_081539.jpg,lorry_truck,66,574,640,82,360,211,2,640,293,LTAdatasets/8702/annotate/8702-2021_03_20_081539.jpg,607.0,252.0,0.9484375,0.7,0.103125,0.22777777777777777
8702-2021_03_20_081539.jpg,lorry_truck,27,303,640,31,360,129,2,330,160,LTAdatasets/8702/annotate/8702-2021_03_20_081539.jpg,316.5,144.5,0.49453125,0.4013888888888889,0.0421875,0.08611111111111111
8702-2021_03_20_081539.jpg,lorry_truck,69,23,640,68,360,142,2,92,210,LTAdatasets/8702/annotate/8702-2021_03_20_081539.jpg,57.5,176.0,0.08984375,0.4888888888888889,0.1078125,0.18888888888888888
8702-2021_03_20_081539.jpg,bike,11,241,640,15,360,118,4,252,133,LTAdatasets/8702/annotate/8702-2021_03_20_081539.jpg,246.5,125.5,0.38515625,0.3486111111111111,0.0171875,0.041666666666666664
8702-2021_03_20_081539.jpg,van,16,229,640,14,360,107,3,245,121,LTAdatasets/8702/annotate/8702-2021_03_20_081539.jpg,237.0,114.0,0.3703125,0.31666666666666665,0.025,0.03888888888888889
8702-2021_03_20_082740.jpg,car,42,58,640,29,360,216,1,100,245,LTAdatasets/8702/annotate/8702-2021_03_20_082740.jpg,79.0,230.5,0.1234375,0.6402777777777777,0.065625,0.08055555555555556
8702-2021_03_20_082740.jpg,car,35,497,640,29,360,185,1,532,214,LTAdatasets/8702/annotate/8702-2021_03_20_082740.jpg,514.5,199.5,0.80390625,0.5541666666666667,0.0546875,0.08055555555555556
8702-2021_03_20_082740.jpg,car,41,599,640,51,360,256,1,640,307,LTAdatasets/8702/annotate/8702-2021_03_20_082740.jpg,619.5,281.5,0.96796875,0.7819444444444444,0.0640625,0.14166666666666666
8702-2021_03_20_082740.jpg,van,26,466,640,24,360,149,3,492,173,LTAdatasets/8702/annotate/8702-2021_03_20_082740.jpg,479.0,161.0,0.7484375,0.44722222222222224,0.040625,0.06666666666666667
8702-2021_03_20_082740.jpg,car,15,278,640,14,360,112,1,293,126,LTAdatasets/8702/annotate/8702-2021_03_20_082740.jpg,285.5,119.0,0.44609375,0.33055555555555555,0.0234375,0.03888888888888889
8702-2021_03_20_082740.jpg,van,18,361,640,14,360,115,3,379,129,LTAdatasets/8702/annotate/8702-2021_03_20_082740.jpg,370.0,122.0,0.578125,0.3388888888888889,0.028125,0.03888888888888889
8702-2021_03_20_082740.jpg,van,29,8,640,18,360,141,3,37,159,LTAdatasets/8702/annotate/8702-2021_03_20_082740.jpg,22.5,150.0,0.03515625,0.4166666666666667,0.0453125,0.05
8702-2021_03_20_094305.jpg,car,48,506,640,40,360,227,1,554,267,LTAdatasets/8702/annotate/8702-2021_03_20_094305.jpg,530.0,247.0,0.828125,0.6861111111111111,0.075,0.1111111111111111
8702-2021_03_20_094305.jpg,car,22,473,640,22,360,151,1,495,173,LTAdatasets/8702/annotate/8702-2021_03_20_094305.jpg,484.0,162.0,0.75625,0.45,0.034375,0.06111111111111111
8702-2021_03_20_094305.jpg,van,37,125,640,20,360,163,3,162,183,LTAdatasets/8702/annotate/8702-2021_03_20_094305.jpg,143.5,173.0,0.22421875,0.48055555555555557,0.0578125,0.05555555555555555
8702-2021_03_20_094305.jpg,car,48,66,640,26,360,213,1,114,239,LTAdatasets/8702/annotate/8702-2021_03_20_094305.jpg,90.0,226.0,0.140625,0.6277777777777778,0.075,0.07222222222222222
8702-2021_03_20_094305.jpg,car,38,0,640,37,360,222,1,38,259,LTAdatasets/8702/annotate/8702-2021_03_20_094305.jpg,19.0,240.5,0.0296875,0.6680555555555555,0.059375,0.10277777777777777
8702-2021_03_20_094305.jpg,car,17,244,640,10,360,133,1,261,143,LTAdatasets/8702/annotate/8702-2021_03_20_094305.jpg,252.5,138.0,0.39453125,0.38333333333333336,0.0265625,0.027777777777777776
8702-2021_03_20_094305.jpg,lorry_truck,58,109,640,35,360,129,2,167,164,LTAdatasets/8702/annotate/8702-2021_03_20_094305.jpg,138.0,146.5,0.215625,0.40694444444444444,0.090625,0.09722222222222222
8702-2021_03_20_094305.jpg,lorry_truck,25,198,640,27,360,105,2,223,132,LTAdatasets/8702/annotate/8702-2021_03_20_094305.jpg,210.5,118.5,0.32890625,0.32916666666666666,0.0390625,0.075
8702-2021_03_20_185453.jpg,lorry_truck,77,527,640,61,360,193,2,604,254,LTAdatasets/8702/annotate/8702-2021_03_20_185453.jpg,565.5,223.5,0.88359375,0.6208333333333333,0.1203125,0.16944444444444445
8702-2021_03_20_185453.jpg,van,61,579,640,64,360,267,3,640,331,LTAdatasets/8702/annotate/8702-2021_03_20_185453.jpg,609.5,299.0,0.95234375,0.8305555555555556,0.0953125,0.17777777777777778
8702-2021_03_20_185453.jpg,car,37,475,640,36,360,205,1,512,241,LTAdatasets/8702/annotate/8702-2021_03_20_185453.jpg,493.5,223.0,0.77109375,0.6194444444444445,0.0578125,0.1
8702-2021_03_20_185453.jpg,car,27,256,640,25,360,155,1,283,180,LTAdatasets/8702/annotate/8702-2021_03_20_185453.jpg,269.5,167.5,0.42109375,0.4652777777777778,0.0421875,0.06944444444444445
8702-2021_03_20_185453.jpg,lorry_truck,58,4,640,41,360,199,2,62,240,LTAdatasets/8702/annotate/8702-2021_03_20_185453.jpg,33.0,219.5,0.0515625,0.6097222222222223,0.090625,0.11388888888888889
8702-2021_03_20_185453.jpg,lorry_truck,18,482,640,20,360,123,2,500,143,LTAdatasets/8702/annotate/8702-2021_03_20_185453.jpg,491.0,133.0,0.7671875,0.36944444444444446,0.028125,0.05555555555555555
8702-2021_03_20_185453.jpg,car,17,310,640,16,360,120,1,327,136,LTAdatasets/8702/annotate/8702-2021_03_20_185453.jpg,318.5,128.0,0.49765625,0.35555555555555557,0.0265625,0.044444444444444446
8702-2021_03_20_185453.jpg,car,15,368,640,15,360,122,1,383,137,LTAdatasets/8702/annotate/8702-2021_03_20_185453.jpg,375.5,129.5,0.58671875,0.3597222222222222,0.0234375,0.041666666666666664
8702-2021_03_20_185453.jpg,lorry_truck,13,389,640,10,360,135,2,402,145,LTAdatasets/8702/annotate/8702-2021_03_20_185453.jpg,395.5,140.0,0.61796875,0.3888888888888889,0.0203125,0.027777777777777776
8702-2021_03_20_185153.jpg,lorry_truck,24,461,640,34,360,155,2,485,189,LTAdatasets/8702/annotate/8702-2021_03_20_185153.jpg,473.0,172.0,0.7390625,0.4777777777777778,0.0375,0.09444444444444444
8702-2021_03_20_185153.jpg,lorry_truck,24,476,640,22,360,123,2,500,145,LTAdatasets/8702/annotate/8702-2021_03_20_185153.jpg,488.0,134.0,0.7625,0.37222222222222223,0.0375,0.06111111111111111
8702-2021_03_20_185153.jpg,lorry_truck,65,575,640,97,360,193,2,640,290,LTAdatasets/8702/annotate/8702-2021_03_20_185153.jpg,607.5,241.5,0.94921875,0.6708333333333333,0.1015625,0.26944444444444443
8702-2021_03_20_185153.jpg,car,31,164,640,20,360,171,1,195,191,LTAdatasets/8702/annotate/8702-2021_03_20_185153.jpg,179.5,181.0,0.28046875,0.5027777777777778,0.0484375,0.05555555555555555
8702-2021_03_20_185153.jpg,car,33,91,640,22,360,164,1,124,186,LTAdatasets/8702/annotate/8702-2021_03_20_185153.jpg,107.5,175.0,0.16796875,0.4861111111111111,0.0515625,0.06111111111111111
8702-2021_03_20_185153.jpg,car,38,77,640,21,360,191,1,115,212,LTAdatasets/8702/annotate/8702-2021_03_20_185153.jpg,96.0,201.5,0.15,0.5597222222222222,0.059375,0.058333333333333334
8702-2021_03_20_185153.jpg,car,51,59,640,28,360,220,1,110,248,LTAdatasets/8702/annotate/8702-2021_03_20_185153.jpg,84.5,234.0,0.13203125,0.65,0.0796875,0.07777777777777778
8702-2021_03_20_185153.jpg,car,17,274,640,12,360,119,1,291,131,LTAdatasets/8702/annotate/8702-2021_03_20_185153.jpg,282.5,125.0,0.44140625,0.3472222222222222,0.0265625,0.03333333333333333
8702-2021_03_20_185153.jpg,car,16,220,640,7,360,119,1,236,126,LTAdatasets/8702/annotate/8702-2021_03_20_185153.jpg,228.0,122.5,0.35625,0.3402777777777778,0.025,0.019444444444444445
8702-2021_03_20_185153.jpg,car,15,366,640,10,360,116,1,381,126,LTAdatasets/8702/annotate/8702-2021_03_20_185153.jpg,373.5,121.0,0.58359375,0.33611111111111114,0.0234375,0.027777777777777776
8702-2021_03_20_195736.jpg,bike,22,497,640,26,360,191,4,519,217,LTAdatasets/8702/annotate/8702-2021_03_20_195736.jpg,508.0,204.0,0.79375,0.5666666666666667,0.034375,0.07222222222222222
8702-2021_03_20_195736.jpg,bike,8,196,640,12,360,130,4,204,142,LTAdatasets/8702/annotate/8702-2021_03_20_195736.jpg,200.0,136.0,0.3125,0.37777777777777777,0.0125,0.03333333333333333
8702-2021_03_20_195736.jpg,car,17,244,640,15,360,122,1,261,137,LTAdatasets/8702/annotate/8702-2021_03_20_195736.jpg,252.5,129.5,0.39453125,0.3597222222222222,0.0265625,0.041666666666666664
8702-2021_03_20_195736.jpg,car,25,142,640,14,360,147,1,167,161,LTAdatasets/8702/annotate/8702-2021_03_20_195736.jpg,154.5,154.0,0.24140625,0.42777777777777776,0.0390625,0.03888888888888889
8702-2021_03_20_195736.jpg,car,30,132,640,16,360,167,1,162,183,LTAdatasets/8702/annotate/8702-2021_03_20_195736.jpg,147.0,175.0,0.2296875,0.4861111111111111,0.046875,0.044444444444444446
8702-2021_03_20_195736.jpg,car,38,50,640,22,360,165,1,88,187,LTAdatasets/8702/annotate/8702-2021_03_20_195736.jpg,69.0,176.0,0.1078125,0.4888888888888889,0.059375,0.06111111111111111
8702-2021_03_20_195736.jpg,car,15,369,640,12,360,120,1,384,132,LTAdatasets/8702/annotate/8702-2021_03_20_195736.jpg,376.5,126.0,0.58828125,0.35,0.0234375,0.03333333333333333
8702-2021_03_20_201317.jpg,car,36,126,640,21,360,183,1,162,204,LTAdatasets/8702/annotate/8702-2021_03_20_201317.jpg,144.0,193.5,0.225,0.5375,0.05625,0.058333333333333334
8702-2021_03_20_201317.jpg,car,18,384,640,13,360,131,1,402,144,LTAdatasets/8702/annotate/8702-2021_03_20_201317.jpg,393.0,137.5,0.6140625,0.3819444444444444,0.028125,0.03611111111111111
8702-2021_03_20_201317.jpg,car,19,236,640,14,360,125,1,255,139,LTAdatasets/8702/annotate/8702-2021_03_20_201317.jpg,245.5,132.0,0.38359375,0.36666666666666664,0.0296875,0.03888888888888889
8702-2021_03_20_082440.jpg,car,33,484,640,35,360,174,1,517,209,LTAdatasets/8702/annotate/8702-2021_03_20_082440.jpg,500.5,191.5,0.78203125,0.5319444444444444,0.0515625,0.09722222222222222
8702-2021_03_20_082440.jpg,car,38,602,640,60,360,299,1,640,359,LTAdatasets/8702/annotate/8702-2021_03_20_082440.jpg,621.0,329.0,0.9703125,0.9138888888888889,0.059375,0.16666666666666666
8702-2021_03_20_082440.jpg,car,18,318,640,6,360,128,1,336,134,LTAdatasets/8702/annotate/8702-2021_03_20_082440.jpg,327.0,131.0,0.5109375,0.3638888888888889,0.028125,0.016666666666666666
8702-2021_03_20_082440.jpg,lorry_truck,27,212,640,21,360,114,2,239,135,LTAdatasets/8702/annotate/8702-2021_03_20_082440.jpg,225.5,124.5,0.35234375,0.3458333333333333,0.0421875,0.058333333333333334
8702-2021_03_20_082440.jpg,bike,10,387,640,12,360,118,4,397,130,LTAdatasets/8702/annotate/8702-2021_03_20_082440.jpg,392.0,124.0,0.6125,0.34444444444444444,0.015625,0.03333333333333333
8702-2021_03_20_200116.jpg,car,25,257,640,22,360,157,1,282,179,LTAdatasets/8702/annotate/8702-2021_03_20_200116.jpg,269.5,168.0,0.42109375,0.4666666666666667,0.0390625,0.06111111111111111
8702-2021_03_20_200116.jpg,car,23,173,640,18,360,152,1,196,170,LTAdatasets/8702/annotate/8702-2021_03_20_200116.jpg,184.5,161.0,0.28828125,0.44722222222222224,0.0359375,0.05
8702-2021_03_20_200116.jpg,car,19,161,640,18,360,138,1,180,156,LTAdatasets/8702/annotate/8702-2021_03_20_200116.jpg,170.5,147.0,0.26640625,0.4083333333333333,0.0296875,0.05
8702-2021_03_20_200116.jpg,car,33,89,640,21,360,170,1,122,191,LTAdatasets/8702/annotate/8702-2021_03_20_200116.jpg,105.5,180.5,0.16484375,0.5013888888888889,0.0515625,0.058333333333333334
8702-2021_03_20_200116.jpg,car,17,258,640,9,360,126,1,275,135,LTAdatasets/8702/annotate/8702-2021_03_20_200116.jpg,266.5,130.5,0.41640625,0.3625,0.0265625,0.025
8702-2021_03_20_200116.jpg,car,17,317,640,15,360,122,1,334,137,LTAdatasets/8702/annotate/8702-2021_03_20_200116.jpg,325.5,129.5,0.50859375,0.3597222222222222,0.0265625,0.041666666666666664
8702-2021_03_20_200116.jpg,bike,8,374,640,12,360,120,4,382,132,LTAdatasets/8702/annotate/8702-2021_03_20_200116.jpg,378.0,126.0,0.590625,0.35,0.0125,0.03333333333333333
8702-2021_03_20_200116.jpg,lorry_truck,74,525,640,63,360,195,2,599,258,LTAdatasets/8702/annotate/8702-2021_03_20_200116.jpg,562.0,226.5,0.878125,0.6291666666666667,0.115625,0.175
8702-2021_03_20_200116.jpg,lorry_truck,19,237,640,16,360,109,2,256,125,LTAdatasets/8702/annotate/8702-2021_03_20_200116.jpg,246.5,117.0,0.38515625,0.325,0.0296875,0.044444444444444446
8702-2021_03_20_190113.jpg,lorry_truck,33,147,640,27,360,136,2,180,163,LTAdatasets/8702/annotate/8702-2021_03_20_190113.jpg,163.5,149.5,0.25546875,0.4152777777777778,0.0515625,0.075
8702-2021_03_20_190113.jpg,lorry_truck,42,4,640,29,360,191,2,46,220,LTAdatasets/8702/annotate/8702-2021_03_20_190113.jpg,25.0,205.5,0.0390625,0.5708333333333333,0.065625,0.08055555555555556
8702-2021_03_20_190113.jpg,lorry_truck,26,0,640,37,360,216,2,26,253,LTAdatasets/8702/annotate/8702-2021_03_20_190113.jpg,13.0,234.5,0.0203125,0.6513888888888889,0.040625,0.10277777777777777
8702-2021_03_20_190113.jpg,lorry_truck,22,480,640,22,360,123,2,502,145,LTAdatasets/8702/annotate/8702-2021_03_20_190113.jpg,491.0,134.0,0.7671875,0.37222222222222223,0.034375,0.06111111111111111
8702-2021_03_20_190113.jpg,bus,16,379,640,22,360,102,5,395,124,LTAdatasets/8702/annotate/8702-2021_03_20_190113.jpg,387.0,113.0,0.6046875,0.3138888888888889,0.025,0.06111111111111111
8702-2021_03_20_181251.jpg,lorry_truck,23,484,640,30,360,124,2,507,154,LTAdatasets/8702/annotate/8702-2021_03_20_181251.jpg,495.5,139.0,0.77421875,0.3861111111111111,0.0359375,0.08333333333333333
8702-2021_03_20_181251.jpg,lorry_truck,24,513,640,25,360,128,2,537,153,LTAdatasets/8702/annotate/8702-2021_03_20_181251.jpg,525.0,140.5,0.8203125,0.3902777777777778,0.0375,0.06944444444444445
8702-2021_03_20_181251.jpg,car,11,259,640,13,360,126,1,270,139,LTAdatasets/8702/annotate/8702-2021_03_20_181251.jpg,264.5,132.5,0.41328125,0.3680555555555556,0.0171875,0.03611111111111111
8702-2021_03_20_181251.jpg,car,13,365,640,12,360,121,1,378,133,LTAdatasets/8702/annotate/8702-2021_03_20_181251.jpg,371.5,127.0,0.58046875,0.3527777777777778,0.0203125,0.03333333333333333
8702-2021_03_20_181251.jpg,car,14,245,640,16,360,121,1,259,137,LTAdatasets/8702/annotate/8702-2021_03_20_181251.jpg,252.0,129.0,0.39375,0.35833333333333334,0.021875,0.044444444444444446
8702-2021_03_20_181251.jpg,car,38,39,640,25,360,205,1,77,230,LTAdatasets/8702/annotate/8702-2021_03_20_181251.jpg,58.0,217.5,0.090625,0.6041666666666666,0.059375,0.06944444444444445
8702-2021_03_20_181251.jpg,car,46,60,640,32,360,219,1,106,251,LTAdatasets/8702/annotate/8702-2021_03_20_181251.jpg,83.0,235.0,0.1296875,0.6527777777777778,0.071875,0.08888888888888889
8702-2021_03_20_194916.jpg,car,43,78,640,27,360,184,1,121,211,LTAdatasets/8702/annotate/8702-2021_03_20_194916.jpg,99.5,197.5,0.15546875,0.5486111111111112,0.0671875,0.075
8702-2021_03_20_194916.jpg,bike,17,468,640,18,360,169,4,485,187,LTAdatasets/8702/annotate/8702-2021_03_20_194916.jpg,476.5,178.0,0.74453125,0.49444444444444446,0.0265625,0.05
8702-2021_03_20_194916.jpg,car,17,245,640,13,360,131,1,262,144,LTAdatasets/8702/annotate/8702-2021_03_20_194916.jpg,253.5,137.5,0.39609375,0.3819444444444444,0.0265625,0.03611111111111111
8702-2021_03_20_194916.jpg,car,12,231,640,8,360,121,1,243,129,LTAdatasets/8702/annotate/8702-2021_03_20_194916.jpg,237.0,125.0,0.3703125,0.3472222222222222,0.01875,0.022222222222222223
8702-2021_03_20_194916.jpg,car,14,273,640,10,360,119,1,287,129,LTAdatasets/8702/annotate/8702-2021_03_20_194916.jpg,280.0,124.0,0.4375,0.34444444444444444,0.021875,0.027777777777777776
8702-2021_03_20_194916.jpg,car,12,385,640,10,360,118,1,397,128,LTAdatasets/8702/annotate/8702-2021_03_20_194916.jpg,391.0,123.0,0.6109375,0.3416666666666667,0.01875,0.027777777777777776
8702-2021_03_20_194315.jpg,car,38,512,640,49,360,229,1,550,278,LTAdatasets/8702/annotate/8702-2021_03_20_194315.jpg,531.0,253.5,0.8296875,0.7041666666666667,0.059375,0.1361111111111111
8702-2021_03_20_194315.jpg,car,47,556,640,39,360,222,1,603,261,LTAdatasets/8702/annotate/8702-2021_03_20_194315.jpg,579.5,241.5,0.90546875,0.6708333333333333,0.0734375,0.10833333333333334
8702-2021_03_20_194315.jpg,bike,14,323,640,17,360,133,4,337,150,LTAdatasets/8702/annotate/8702-2021_03_20_194315.jpg,330.0,141.5,0.515625,0.39305555555555555,0.021875,0.04722222222222222
8702-2021_03_20_194315.jpg,lorry_truck,49,98,640,45,360,138,2,147,183,LTAdatasets/8702/annotate/8702-2021_03_20_194315.jpg,122.5,160.5,0.19140625,0.44583333333333336,0.0765625,0.125
8702-2021_03_20_194315.jpg,lorry_truck,29,172,640,21,360,119,2,201,140,LTAdatasets/8702/annotate/8702-2021_03_20_194315.jpg,186.5,129.5,0.29140625,0.3597222222222222,0.0453125,0.058333333333333334
8702-2021_03_20_194315.jpg,lorry_truck,22,232,640,18,360,121,2,254,139,LTAdatasets/8702/annotate/8702-2021_03_20_194315.jpg,243.0,130.0,0.3796875,0.3611111111111111,0.034375,0.05
8702-2021_03_20_194315.jpg,lorry_truck,20,255,640,21,360,104,2,275,125,LTAdatasets/8702/annotate/8702-2021_03_20_194315.jpg,265.0,114.5,0.4140625,0.31805555555555554,0.03125,0.058333333333333334
8702-2021_03_20_083640.jpg,lorry_truck,47,523,640,39,360,193,2,570,232,LTAdatasets/8702/annotate/8702-2021_03_20_083640.jpg,546.5,212.5,0.85390625,0.5902777777777778,0.0734375,0.10833333333333334
8702-2021_03_20_083640.jpg,lorry_truck,56,220,640,69,360,186,2,276,255,LTAdatasets/8702/annotate/8702-2021_03_20_083640.jpg,248.0,220.5,0.3875,0.6125,0.0875,0.19166666666666668
8702-2021_03_20_083640.jpg,car,45,169,640,39,360,205,1,214,244,LTAdatasets/8702/annotate/8702-2021_03_20_083640.jpg,191.5,224.5,0.29921875,0.6236111111111111,0.0703125,0.10833333333333334
8702-2021_03_20_083640.jpg,van,19,299,640,25,360,138,3,318,163,LTAdatasets/8702/annotate/8702-2021_03_20_083640.jpg,308.5,150.5,0.48203125,0.41805555555555557,0.0296875,0.06944444444444445
8702-2021_03_20_083640.jpg,van,16,189,640,16,360,129,3,205,145,LTAdatasets/8702/annotate/8702-2021_03_20_083640.jpg,197.0,137.0,0.3078125,0.38055555555555554,0.025,0.044444444444444446
8702-2021_03_20_083640.jpg,lorry_truck,37,140,640,22,360,126,2,177,148,LTAdatasets/8702/annotate/8702-2021_03_20_083640.jpg,158.5,137.0,0.24765625,0.38055555555555554,0.0578125,0.06111111111111111
8702-2021_03_20_083640.jpg,car,17,232,640,18,360,135,1,249,153,LTAdatasets/8702/annotate/8702-2021_03_20_083640.jpg,240.5,144.0,0.37578125,0.4,0.0265625,0.05
8702-2021_03_20_083640.jpg,car,16,214,640,10,360,131,1,230,141,LTAdatasets/8702/annotate/8702-2021_03_20_083640.jpg,222.0,136.0,0.346875,0.37777777777777777,0.025,0.027777777777777776
8702-2021_03_20_083640.jpg,car,17,255,640,9,360,124,1,272,133,LTAdatasets/8702/annotate/8702-2021_03_20_083640.jpg,263.5,128.5,0.41171875,0.35694444444444445,0.0265625,0.025
8702-2021_03_20_083640.jpg,lorry_truck,15,253,640,15,360,98,2,268,113,LTAdatasets/8702/annotate/8702-2021_03_20_083640.jpg,260.5,105.5,0.40703125,0.29305555555555557,0.0234375,0.041666666666666664
8702-2021_03_20_083640.jpg,lorry_truck,11,287,640,12,360,109,2,298,121,LTAdatasets/8702/annotate/8702-2021_03_20_083640.jpg,292.5,115.0,0.45703125,0.3194444444444444,0.0171875,0.03333333333333333
8702-2021_03_20_083640.jpg,bike,14,247,640,18,360,162,4,261,180,LTAdatasets/8702/annotate/8702-2021_03_20_083640.jpg,254.0,171.0,0.396875,0.475,0.021875,0.05
8702-2021_03_20_095505.jpg,car,50,508,640,46,360,227,1,558,273,LTAdatasets/8702/annotate/8702-2021_03_20_095505.jpg,533.0,250.0,0.8328125,0.6944444444444444,0.078125,0.12777777777777777
8702-2021_03_20_095505.jpg,car,39,163,640,36,360,218,1,202,254,LTAdatasets/8702/annotate/8702-2021_03_20_095505.jpg,182.5,236.0,0.28515625,0.6555555555555556,0.0609375,0.1
8702-2021_03_20_095505.jpg,lorry_truck,61,218,640,93,360,170,2,279,263,LTAdatasets/8702/annotate/8702-2021_03_20_095505.jpg,248.5,216.5,0.38828125,0.6013888888888889,0.0953125,0.25833333333333336
8702-2021_03_20_095505.jpg,lorry_truck,20,329,640,14,360,112,2,349,126,LTAdatasets/8702/annotate/8702-2021_03_20_095505.jpg,339.0,119.0,0.5296875,0.33055555555555555,0.03125,0.03888888888888889
8702-2021_03_20_095505.jpg,lorry_truck,15,384,640,18,360,101,2,399,119,LTAdatasets/8702/annotate/8702-2021_03_20_095505.jpg,391.5,110.0,0.61171875,0.3055555555555556,0.0234375,0.05
8702-2021_03_20_095505.jpg,lorry_truck,24,232,640,17,360,105,2,256,122,LTAdatasets/8702/annotate/8702-2021_03_20_095505.jpg,244.0,113.5,0.38125,0.31527777777777777,0.0375,0.04722222222222222
8702-2021_03_20_095505.jpg,car,24,235,640,18,360,123,1,259,141,LTAdatasets/8702/annotate/8702-2021_03_20_095505.jpg,247.0,132.0,0.3859375,0.36666666666666664,0.0375,0.05
8702-2021_03_20_095505.jpg,car,15,273,640,11,360,115,1,288,126,LTAdatasets/8702/annotate/8702-2021_03_20_095505.jpg,280.5,120.5,0.43828125,0.3347222222222222,0.0234375,0.030555555555555555
8702-2021_03_20_095505.jpg,car,11,359,640,5,360,110,1,370,115,LTAdatasets/8702/annotate/8702-2021_03_20_095505.jpg,364.5,112.5,0.56953125,0.3125,0.0171875,0.013888888888888888
8702-2021_03_20_191234.jpg,car,48,561,640,54,360,254,1,609,308,LTAdatasets/8702/annotate/8702-2021_03_20_191234.jpg,585.0,281.0,0.9140625,0.7805555555555556,0.075,0.15
8702-2021_03_20_191234.jpg,car,49,216,640,37,360,188,1,265,225,LTAdatasets/8702/annotate/8702-2021_03_20_191234.jpg,240.5,206.5,0.37578125,0.5736111111111111,0.0765625,0.10277777777777777
8702-2021_03_20_191234.jpg,car,78,79,640,61,360,275,1,157,336,LTAdatasets/8702/annotate/8702-2021_03_20_191234.jpg,118.0,305.5,0.184375,0.8486111111111111,0.121875,0.16944444444444445
8702-2021_03_20_191234.jpg,car,30,154,640,21,360,173,1,184,194,LTAdatasets/8702/annotate/8702-2021_03_20_191234.jpg,169.0,183.5,0.2640625,0.5097222222222222,0.046875,0.058333333333333334
8702-2021_03_20_191234.jpg,car,23,170,640,18,360,151,1,193,169,LTAdatasets/8702/annotate/8702-2021_03_20_191234.jpg,181.5,160.0,0.28359375,0.4444444444444444,0.0359375,0.05
8702-2021_03_20_191234.jpg,bike,12,330,640,12,360,124,4,342,136,LTAdatasets/8702/annotate/8702-2021_03_20_191234.jpg,336.0,130.0,0.525,0.3611111111111111,0.01875,0.03333333333333333
8702-2021_03_20_191234.jpg,car,21,130,640,19,360,156,1,151,175,LTAdatasets/8702/annotate/8702-2021_03_20_191234.jpg,140.5,165.5,0.21953125,0.4597222222222222,0.0328125,0.05277777777777778
8702-2021_03_20_191234.jpg,lorry_truck,20,480,640,20,360,123,2,500,143,LTAdatasets/8702/annotate/8702-2021_03_20_191234.jpg,490.0,133.0,0.765625,0.36944444444444446,0.03125,0.05555555555555555
8702-2021_03_20_191234.jpg,car,23,0,640,22,360,214,1,23,236,LTAdatasets/8702/annotate/8702-2021_03_20_191234.jpg,11.5,225.0,0.01796875,0.625,0.0359375,0.06111111111111111
8702-2021_03_20_073417.jpg,car,50,186,640,35,360,208,1,236,243,LTAdatasets/8702/annotate/8702-2021_03_20_073417.jpg,211.0,225.5,0.3296875,0.6263888888888889,0.078125,0.09722222222222222
8702-2021_03_20_073417.jpg,lorry_truck,20,380,640,21,360,125,2,400,146,LTAdatasets/8702/annotate/8702-2021_03_20_073417.jpg,390.0,135.5,0.609375,0.3763888888888889,0.03125,0.058333333333333334
8702-2021_03_20_073417.jpg,bike,23,51,640,30,360,201,4,74,231,LTAdatasets/8702/annotate/8702-2021_03_20_073417.jpg,62.5,216.0,0.09765625,0.6,0.0359375,0.08333333333333333
8702-2021_03_20_073417.jpg,car,34,106,640,19,360,162,1,140,181,LTAdatasets/8702/annotate/8702-2021_03_20_073417.jpg,123.0,171.5,0.1921875,0.47638888888888886,0.053125,0.05277777777777778
8702-2021_03_20_073937.jpg,car,22,197,640,15,360,138,1,219,153,LTAdatasets/8702/annotate/8702-2021_03_20_073937.jpg,208.0,145.5,0.325,0.4041666666666667,0.034375,0.041666666666666664
8702-2021_03_20_073937.jpg,car,18,231,640,12,360,126,1,249,138,LTAdatasets/8702/annotate/8702-2021_03_20_073937.jpg,240.0,132.0,0.375,0.36666666666666664,0.028125,0.03333333333333333
8702-2021_03_20_073937.jpg,lorry_truck,25,193,640,18,360,119,2,218,137,LTAdatasets/8702/annotate/8702-2021_03_20_073937.jpg,205.5,128.0,0.32109375,0.35555555555555557,0.0390625,0.05
8702-2021_03_20_073937.jpg,lorry_truck,35,132,640,23,360,128,2,167,151,LTAdatasets/8702/annotate/8702-2021_03_20_073937.jpg,149.5,139.5,0.23359375,0.3875,0.0546875,0.06388888888888888
8702-2021_03_20_073937.jpg,lorry_truck,19,372,640,12,360,124,2,391,136,LTAdatasets/8702/annotate/8702-2021_03_20_073937.jpg,381.5,130.0,0.59609375,0.3611111111111111,0.0296875,0.03333333333333333
8702-2021_03_20_085141.jpg,lorry_truck,42,109,640,32,360,129,2,151,161,LTAdatasets/8702/annotate/8702-2021_03_20_085141.jpg,130.0,145.0,0.203125,0.4027777777777778,0.065625,0.08888888888888889
8702-2021_03_20_085141.jpg,bike,19,540,640,24,360,186,4,559,210,LTAdatasets/8702/annotate/8702-2021_03_20_085141.jpg,549.5,198.0,0.85859375,0.55,0.0296875,0.06666666666666667
8702-2021_03_20_085141.jpg,car,21,304,640,17,360,144,1,325,161,LTAdatasets/8702/annotate/8702-2021_03_20_085141.jpg,314.5,152.5,0.49140625,0.4236111111111111,0.0328125,0.04722222222222222
8702-2021_03_20_085141.jpg,lorry_truck,17,379,640,21,360,118,2,396,139,LTAdatasets/8702/annotate/8702-2021_03_20_085141.jpg,387.5,128.5,0.60546875,0.35694444444444445,0.0265625,0.058333333333333334
8702-2021_03_20_085141.jpg,lorry_truck,50,16,640,34,360,212,2,66,246,LTAdatasets/8702/annotate/8702-2021_03_20_085141.jpg,41.0,229.0,0.0640625,0.6361111111111111,0.078125,0.09444444444444444
8702-2021_03_20_085141.jpg,bike,6,333,640,11,360,114,4,339,125,LTAdatasets/8702/annotate/8702-2021_03_20_085141.jpg,336.0,119.5,0.525,0.33194444444444443,0.009375,0.030555555555555555
8702-2021_03_20_180110.jpg,lorry_truck,34,548,640,41,360,202,2,582,243,LTAdatasets/8702/annotate/8702-2021_03_20_180110.jpg,565.0,222.5,0.8828125,0.6180555555555556,0.053125,0.11388888888888889
8702-2021_03_20_180110.jpg,car,37,103,640,35,360,194,1,140,229,LTAdatasets/8702/annotate/8702-2021_03_20_180110.jpg,121.5,211.5,0.18984375,0.5875,0.0578125,0.09722222222222222
8702-2021_03_20_180110.jpg,car,28,3,640,36,360,197,1,31,233,LTAdatasets/8702/annotate/8702-2021_03_20_180110.jpg,17.0,215.0,0.0265625,0.5972222222222222,0.04375,0.1
8702-2021_03_20_180110.jpg,car,25,149,640,21,360,154,1,174,175,LTAdatasets/8702/annotate/8702-2021_03_20_180110.jpg,161.5,164.5,0.25234375,0.45694444444444443,0.0390625,0.058333333333333334
8702-2021_03_20_180110.jpg,car,14,248,640,15,360,120,1,262,135,LTAdatasets/8702/annotate/8702-2021_03_20_180110.jpg,255.0,127.5,0.3984375,0.3541666666666667,0.021875,0.041666666666666664
8702-2021_03_20_180110.jpg,lorry_truck,21,470,640,27,360,119,2,491,146,LTAdatasets/8702/annotate/8702-2021_03_20_180110.jpg,480.5,132.5,0.75078125,0.3680555555555556,0.0328125,0.075
8702-2021_03_20_074618.jpg,car,36,468,640,32,360,199,1,504,231,LTAdatasets/8702/annotate/8702-2021_03_20_074618.jpg,486.0,215.0,0.759375,0.5972222222222222,0.05625,0.08888888888888889
8702-2021_03_20_074618.jpg,bus,51,508,640,54,360,170,5,559,224,LTAdatasets/8702/annotate/8702-2021_03_20_074618.jpg,533.5,197.0,0.83359375,0.5472222222222223,0.0796875,0.15
8702-2021_03_20_074618.jpg,car,33,106,640,30,360,194,1,139,224,LTAdatasets/8702/annotate/8702-2021_03_20_074618.jpg,122.5,209.0,0.19140625,0.5805555555555556,0.0515625,0.08333333333333333
8702-2021_03_20_074618.jpg,car,15,368,640,13,360,118,1,383,131,LTAdatasets/8702/annotate/8702-2021_03_20_074618.jpg,375.5,124.5,0.58671875,0.3458333333333333,0.0234375,0.03611111111111111
8702-2021_03_20_184913.jpg,lorry_truck,40,469,640,43,360,157,2,509,200,LTAdatasets/8702/annotate/8702-2021_03_20_184913.jpg,489.0,178.5,0.7640625,0.49583333333333335,0.0625,0.11944444444444445
8702-2021_03_20_184913.jpg,car,53,522,640,44,360,235,1,575,279,LTAdatasets/8702/annotate/8702-2021_03_20_184913.jpg,548.5,257.0,0.85703125,0.7138888888888889,0.0828125,0.12222222222222222
8702-2021_03_20_184913.jpg,car,25,192,640,20,360,153,1,217,173,LTAdatasets/8702/annotate/8702-2021_03_20_184913.jpg,204.5,163.0,0.31953125,0.4527777777777778,0.0390625,0.05555555555555555
8702-2021_03_20_184913.jpg,car,15,223,640,14,360,125,1,238,139,LTAdatasets/8702/annotate/8702-2021_03_20_184913.jpg,230.5,132.0,0.36015625,0.36666666666666664,0.0234375,0.03888888888888889
8702-2021_03_20_184913.jpg,car,20,256,640,11,360,126,1,276,137,LTAdatasets/8702/annotate/8702-2021_03_20_184913.jpg,266.0,131.5,0.415625,0.36527777777777776,0.03125,0.030555555555555555
8702-2021_03_20_184913.jpg,car,12,256,640,10,360,118,1,268,128,LTAdatasets/8702/annotate/8702-2021_03_20_184913.jpg,262.0,123.0,0.409375,0.3416666666666667,0.01875,0.027777777777777776
8702-2021_03_20_091623.jpg,car,45,162,640,42,360,222,1,207,264,LTAdatasets/8702/annotate/8702-2021_03_20_091623.jpg,184.5,243.0,0.28828125,0.675,0.0703125,0.11666666666666667
8702-2021_03_20_091623.jpg,bike,31,18,640,36,360,238,4,49,274,LTAdatasets/8702/annotate/8702-2021_03_20_091623.jpg,33.5,256.0,0.05234375,0.7111111111111111,0.0484375,0.1
8702-2021_03_20_091623.jpg,car,25,447,640,21,360,177,1,472,198,LTAdatasets/8702/annotate/8702-2021_03_20_091623.jpg,459.5,187.5,0.71796875,0.5208333333333334,0.0390625,0.058333333333333334
8702-2021_03_20_091623.jpg,car,15,246,640,15,360,128,1,261,143,LTAdatasets/8702/annotate/8702-2021_03_20_091623.jpg,253.5,135.5,0.39609375,0.3763888888888889,0.0234375,0.041666666666666664
8702-2021_03_20_091623.jpg,lorry_truck,22,220,640,16,360,122,2,242,138,LTAdatasets/8702/annotate/8702-2021_03_20_091623.jpg,231.0,130.0,0.3609375,0.3611111111111111,0.034375,0.044444444444444446
8702-2021_03_20_193635.jpg,car,51,53,640,33,360,223,1,104,256,LTAdatasets/8702/annotate/8702-2021_03_20_193635.jpg,78.5,239.5,0.12265625,0.6652777777777777,0.0796875,0.09166666666666666
8702-2021_03_20_193635.jpg,car,42,65,640,18,360,178,1,107,196,LTAdatasets/8702/annotate/8702-2021_03_20_193635.jpg,86.0,187.0,0.134375,0.5194444444444445,0.065625,0.05
8702-2021_03_20_193635.jpg,van,34,145,640,25,360,158,3,179,183,LTAdatasets/8702/annotate/8702-2021_03_20_193635.jpg,162.0,170.5,0.253125,0.4736111111111111,0.053125,0.06944444444444445
8702-2021_03_20_193635.jpg,car,12,285,640,17,360,145,1,297,162,LTAdatasets/8702/annotate/8702-2021_03_20_193635.jpg,291.0,153.5,0.4546875,0.4263888888888889,0.01875,0.04722222222222222
8702-2021_03_20_193635.jpg,lorry_truck,56,73,640,38,360,131,2,129,169,LTAdatasets/8702/annotate/8702-2021_03_20_193635.jpg,101.0,150.0,0.1578125,0.4166666666666667,0.0875,0.10555555555555556
8702-2021_03_20_083340.jpg,lorry_truck,42,121,640,40,360,126,2,163,166,LTAdatasets/8702/annotate/8702-2021_03_20_083340.jpg,142.0,146.0,0.221875,0.40555555555555556,0.065625,0.1111111111111111
8702-2021_03_20_083340.jpg,lorry_truck,50,472,640,49,360,153,2,522,202,LTAdatasets/8702/annotate/8702-2021_03_20_083340.jpg,497.0,177.5,0.7765625,0.4930555555555556,0.078125,0.1361111111111111
8702-2021_03_20_083340.jpg,car,16,380,640,20,360,130,1,396,150,LTAdatasets/8702/annotate/8702-2021_03_20_083340.jpg,388.0,140.0,0.60625,0.3888888888888889,0.025,0.05555555555555555
8702-2021_03_20_083340.jpg,car,12,369,640,10,360,119,1,381,129,LTAdatasets/8702/annotate/8702-2021_03_20_083340.jpg,375.0,124.0,0.5859375,0.34444444444444444,0.01875,0.027777777777777776
8702-2021_03_20_083340.jpg,car,25,111,640,28,360,183,1,136,211,LTAdatasets/8702/annotate/8702-2021_03_20_083340.jpg,123.5,197.0,0.19296875,0.5472222222222223,0.0390625,0.07777777777777778
8702-2021_03_20_083340.jpg,van,57,195,640,63,360,235,3,252,298,LTAdatasets/8702/annotate/8702-2021_03_20_083340.jpg,223.5,266.5,0.34921875,0.7402777777777778,0.0890625,0.175
8702-2021_03_20_083340.jpg,car,19,258,640,11,360,120,1,277,131,LTAdatasets/8702/annotate/8702-2021_03_20_083340.jpg,267.5,125.5,0.41796875,0.3486111111111111,0.0296875,0.030555555555555555
8702-2021_03_20_193415.jpg,car,49,513,640,43,360,226,1,562,269,LTAdatasets/8702/annotate/8702-2021_03_20_193415.jpg,537.5,247.5,0.83984375,0.6875,0.0765625,0.11944444444444445
8702-2021_03_20_193415.jpg,car,35,135,640,28,360,176,1,170,204,LTAdatasets/8702/annotate/8702-2021_03_20_193415.jpg,152.5,190.0,0.23828125,0.5277777777777778,0.0546875,0.07777777777777778
8702-2021_03_20_193415.jpg,car,22,221,640,18,360,135,1,243,153,LTAdatasets/8702/annotate/8702-2021_03_20_193415.jpg,232.0,144.0,0.3625,0.4,0.034375,0.05
8702-2021_03_20_193415.jpg,car,21,173,640,20,360,145,1,194,165,LTAdatasets/8702/annotate/8702-2021_03_20_193415.jpg,183.5,155.0,0.28671875,0.4305555555555556,0.0328125,0.05555555555555555
8702-2021_03_20_193415.jpg,car,15,211,640,12,360,134,1,226,146,LTAdatasets/8702/annotate/8702-2021_03_20_193415.jpg,218.5,140.0,0.34140625,0.3888888888888889,0.0234375,0.03333333333333333
8702-2021_03_20_192735.jpg,car,32,510,640,31,360,193,1,542,224,LTAdatasets/8702/annotate/8702-2021_03_20_192735.jpg,526.0,208.5,0.821875,0.5791666666666667,0.05,0.08611111111111111
8702-2021_03_20_192735.jpg,car,29,459,640,29,360,187,1,488,216,LTAdatasets/8702/annotate/8702-2021_03_20_192735.jpg,473.5,201.5,0.73984375,0.5597222222222222,0.0453125,0.08055555555555556
8702-2021_03_20_192735.jpg,car,43,597,640,54,360,255,1,640,309,LTAdatasets/8702/annotate/8702-2021_03_20_192735.jpg,618.5,282.0,0.96640625,0.7833333333333333,0.0671875,0.15
8702-2021_03_20_192735.jpg,car,28,179,640,19,360,160,1,207,179,LTAdatasets/8702/annotate/8702-2021_03_20_192735.jpg,193.0,169.5,0.3015625,0.4708333333333333,0.04375,0.05277777777777778
8702-2021_03_20_192735.jpg,car,20,309,640,15,360,118,1,329,133,LTAdatasets/8702/annotate/8702-2021_03_20_192735.jpg,319.0,125.5,0.4984375,0.3486111111111111,0.03125,0.041666666666666664
8702-2021_03_20_081920.jpg,car,33,262,640,31,360,178,1,295,209,LTAdatasets/8702/annotate/8702-2021_03_20_081920.jpg,278.5,193.5,0.43515625,0.5375,0.0515625,0.08611111111111111
8702-2021_03_20_081920.jpg,lorry_truck,38,481,640,31,360,170,2,519,201,LTAdatasets/8702/annotate/8702-2021_03_20_081920.jpg,500.0,185.5,0.78125,0.5152777777777777,0.059375,0.08611111111111111
8702-2021_03_20_081920.jpg,car,20,183,640,16,360,143,1,203,159,LTAdatasets/8702/annotate/8702-2021_03_20_081920.jpg,193.0,151.0,0.3015625,0.41944444444444445,0.03125,0.044444444444444446
8702-2021_03_20_081920.jpg,car,20,171,640,12,360,136,1,191,148,LTAdatasets/8702/annotate/8702-2021_03_20_081920.jpg,181.0,142.0,0.2828125,0.39444444444444443,0.03125,0.03333333333333333
8702-2021_03_20_081920.jpg,car,14,386,640,12,360,136,1,400,148,LTAdatasets/8702/annotate/8702-2021_03_20_081920.jpg,393.0,142.0,0.6140625,0.39444444444444443,0.021875,0.03333333333333333
8702-2021_03_20_183412.jpg,car,48,516,640,55,360,230,1,564,285,LTAdatasets/8702/annotate/8702-2021_03_20_183412.jpg,540.0,257.5,0.84375,0.7152777777777778,0.075,0.1527777777777778
8702-2021_03_20_183412.jpg,car,34,227,640,32,360,176,1,261,208,LTAdatasets/8702/annotate/8702-2021_03_20_183412.jpg,244.0,192.0,0.38125,0.5333333333333333,0.053125,0.08888888888888889
8702-2021_03_20_183412.jpg,lorry_truck,54,48,640,38,360,178,2,102,216,LTAdatasets/8702/annotate/8702-2021_03_20_183412.jpg,75.0,197.0,0.1171875,0.5472222222222223,0.084375,0.10555555555555556
8702-2021_03_20_183412.jpg,lorry_truck,26,174,640,17,360,134,2,200,151,LTAdatasets/8702/annotate/8702-2021_03_20_183412.jpg,187.0,142.5,0.2921875,0.3958333333333333,0.040625,0.04722222222222222
8702-2021_03_20_183412.jpg,lorry_truck,27,182,640,17,360,120,2,209,137,LTAdatasets/8702/annotate/8702-2021_03_20_183412.jpg,195.5,128.5,0.30546875,0.35694444444444445,0.0421875,0.04722222222222222
8702-2021_03_20_183412.jpg,car,29,137,640,17,360,165,1,166,182,LTAdatasets/8702/annotate/8702-2021_03_20_183412.jpg,151.5,173.5,0.23671875,0.48194444444444445,0.0453125,0.04722222222222222
8702-2021_03_20_183412.jpg,car,48,36,640,36,360,232,1,84,268,LTAdatasets/8702/annotate/8702-2021_03_20_183412.jpg,60.0,250.0,0.09375,0.6944444444444444,0.075,0.1
8702-2021_03_20_183412.jpg,car,16,301,640,20,360,127,1,317,147,LTAdatasets/8702/annotate/8702-2021_03_20_183412.jpg,309.0,137.0,0.4828125,0.38055555555555554,0.025,0.05555555555555555
8702-2021_03_20_183412.jpg,car,17,232,640,12,360,131,1,249,143,LTAdatasets/8702/annotate/8702-2021_03_20_183412.jpg,240.5,137.0,0.37578125,0.38055555555555554,0.0265625,0.03333333333333333
8702-2021_03_20_183412.jpg,bus,26,461,640,33,360,147,5,487,180,LTAdatasets/8702/annotate/8702-2021_03_20_183412.jpg,474.0,163.5,0.740625,0.45416666666666666,0.040625,0.09166666666666666
8702-2021_03_20_091903.jpg,car,49,173,640,41,360,206,1,222,247,LTAdatasets/8702/annotate/8702-2021_03_20_091903.jpg,197.5,226.5,0.30859375,0.6291666666666667,0.0765625,0.11388888888888889
8702-2021_03_20_091903.jpg,car,49,0,640,39,360,248,1,49,287,LTAdatasets/8702/annotate/8702-2021_03_20_091903.jpg,24.5,267.5,0.03828125,0.7430555555555556,0.0765625,0.10833333333333334
8702-2021_03_20_091903.jpg,car,31,134,640,19,360,155,1,165,174,LTAdatasets/8702/annotate/8702-2021_03_20_091903.jpg,149.5,164.5,0.23359375,0.45694444444444443,0.0484375,0.05277777777777778
8702-2021_03_20_091903.jpg,lorry_truck,24,193,640,17,360,134,2,217,151,LTAdatasets/8702/annotate/8702-2021_03_20_091903.jpg,205.0,142.5,0.3203125,0.3958333333333333,0.0375,0.04722222222222222
8702-2021_03_20_091903.jpg,lorry_truck,32,86,640,29,360,139,2,118,168,LTAdatasets/8702/annotate/8702-2021_03_20_091903.jpg,102.0,153.5,0.159375,0.4263888888888889,0.05,0.08055555555555556
8702-2021_03_20_091903.jpg,car,16,323,640,11,360,122,1,339,133,LTAdatasets/8702/annotate/8702-2021_03_20_091903.jpg,331.0,127.5,0.5171875,0.3541666666666667,0.025,0.030555555555555555
8702-2021_03_20_180410.jpg,lorry_truck,79,561,640,77,360,215,2,640,292,LTAdatasets/8702/annotate/8702-2021_03_20_180410.jpg,600.5,253.5,0.93828125,0.7041666666666667,0.1234375,0.21388888888888888
8702-2021_03_20_180410.jpg,car,30,465,640,24,360,169,1,495,193,LTAdatasets/8702/annotate/8702-2021_03_20_180410.jpg,480.0,181.0,0.75,0.5027777777777778,0.046875,0.06666666666666667
8702-2021_03_20_180410.jpg,car,19,275,640,20,360,146,1,294,166,LTAdatasets/8702/annotate/8702-2021_03_20_180410.jpg,284.5,156.0,0.44453125,0.43333333333333335,0.0296875,0.05555555555555555
8702-2021_03_20_180410.jpg,car,20,184,640,16,360,145,1,204,161,LTAdatasets/8702/annotate/8702-2021_03_20_180410.jpg,194.0,153.0,0.303125,0.425,0.03125,0.044444444444444446
8702-2021_03_20_180410.jpg,van,15,326,640,15,360,125,3,341,140,LTAdatasets/8702/annotate/8702-2021_03_20_180410.jpg,333.5,132.5,0.52109375,0.3680555555555556,0.0234375,0.041666666666666664
8702-2021_03_20_180410.jpg,lorry_truck,24,467,640,22,360,118,2,491,140,LTAdatasets/8702/annotate/8702-2021_03_20_180410.jpg,479.0,129.0,0.7484375,0.35833333333333334,0.0375,0.06111111111111111
8702-2021_03_20_080119.jpg,lorry_truck,63,543,640,54,360,201,2,606,255,LTAdatasets/8702/annotate/8702-2021_03_20_080119.jpg,574.5,228.0,0.89765625,0.6333333333333333,0.0984375,0.15
8702-2021_03_20_080119.jpg,lorry_truck,35,460,640,34,360,181,2,495,215,LTAdatasets/8702/annotate/8702-2021_03_20_080119.jpg,477.5,198.0,0.74609375,0.55,0.0546875,0.09444444444444444
8702-2021_03_20_080119.jpg,van,43,95,640,31,360,173,3,138,204,LTAdatasets/8702/annotate/8702-2021_03_20_080119.jpg,116.5,188.5,0.18203125,0.5236111111111111,0.0671875,0.08611111111111111
8702-2021_03_20_080119.jpg,car,19,212,640,21,360,144,1,231,165,LTAdatasets/8702/annotate/8702-2021_03_20_080119.jpg,221.5,154.5,0.34609375,0.42916666666666664,0.0296875,0.058333333333333334
8702-2021_03_20_080119.jpg,car,38,57,640,19,360,163,1,95,182,LTAdatasets/8702/annotate/8702-2021_03_20_080119.jpg,76.0,172.5,0.11875,0.4791666666666667,0.059375,0.05277777777777778
8702-2021_03_20_080119.jpg,car,18,244,640,16,360,124,1,262,140,LTAdatasets/8702/annotate/8702-2021_03_20_080119.jpg,253.0,132.0,0.3953125,0.36666666666666664,0.028125,0.044444444444444446
8702-2021_03_20_203058.jpg,car,16,461,640,17,360,161,1,477,178,LTAdatasets/8702/annotate/8702-2021_03_20_203058.jpg,469.0,169.5,0.7328125,0.4708333333333333,0.025,0.04722222222222222
8702-2021_03_20_203058.jpg,bike,32,568,640,37,360,256,4,600,293,LTAdatasets/8702/annotate/8702-2021_03_20_203058.jpg,584.0,274.5,0.9125,0.7625,0.05,0.10277777777777777
8702-2021_03_20_203058.jpg,car,39,601,640,58,360,295,1,640,353,LTAdatasets/8702/annotate/8702-2021_03_20_203058.jpg,620.5,324.0,0.96953125,0.9,0.0609375,0.16111111111111112
8702-2021_03_20_203058.jpg,car,42,97,640,24,360,198,1,139,222,LTAdatasets/8702/annotate/8702-2021_03_20_203058.jpg,118.0,210.0,0.184375,0.5833333333333334,0.065625,0.06666666666666667
8702-2021_03_20_203058.jpg,car,24,204,640,18,360,149,1,228,167,LTAdatasets/8702/annotate/8702-2021_03_20_203058.jpg,216.0,158.0,0.3375,0.4388888888888889,0.0375,0.05
8702-2021_03_20_203058.jpg,car,20,226,640,16,360,132,1,246,148,LTAdatasets/8702/annotate/8702-2021_03_20_203058.jpg,236.0,140.0,0.36875,0.3888888888888889,0.03125,0.044444444444444446
8702-2021_03_20_181011.jpg,car,40,471,640,32,360,194,1,511,226,LTAdatasets/8702/annotate/8702-2021_03_20_181011.jpg,491.0,210.0,0.7671875,0.5833333333333334,0.0625,0.08888888888888889
8702-2021_03_20_181011.jpg,lorry_truck,16,518,640,22,360,130,2,534,152,LTAdatasets/8702/annotate/8702-2021_03_20_181011.jpg,526.0,141.0,0.821875,0.39166666666666666,0.025,0.06111111111111111
8702-2021_03_20_181011.jpg,lorry_truck,26,466,640,22,360,119,2,492,141,LTAdatasets/8702/annotate/8702-2021_03_20_181011.jpg,479.0,130.0,0.7484375,0.3611111111111111,0.040625,0.06111111111111111
8702-2021_03_20_181011.jpg,lorry_truck,44,133,640,28,360,135,2,177,163,LTAdatasets/8702/annotate/8702-2021_03_20_181011.jpg,155.0,149.0,0.2421875,0.41388888888888886,0.06875,0.07777777777777778
8702-2021_03_20_181011.jpg,lorry_truck,22,99,640,21,360,123,2,121,144,LTAdatasets/8702/annotate/8702-2021_03_20_181011.jpg,110.0,133.5,0.171875,0.37083333333333335,0.034375,0.058333333333333334
8702-2021_03_20_181011.jpg,lorry_truck,25,46,640,17,360,139,2,71,156,LTAdatasets/8702/annotate/8702-2021_03_20_181011.jpg,58.5,147.5,0.09140625,0.4097222222222222,0.0390625,0.04722222222222222
8702-2021_03_20_181011.jpg,lorry_truck,21,2,640,17,360,146,2,23,163,LTAdatasets/8702/annotate/8702-2021_03_20_181011.jpg,12.5,154.5,0.01953125,0.42916666666666664,0.0328125,0.04722222222222222
8702-2021_03_20_181011.jpg,van,12,388,640,15,360,135,3,400,150,LTAdatasets/8702/annotate/8702-2021_03_20_181011.jpg,394.0,142.5,0.615625,0.3958333333333333,0.01875,0.041666666666666664
8702-2021_03_20_181011.jpg,car,14,371,640,10,360,123,1,385,133,LTAdatasets/8702/annotate/8702-2021_03_20_181011.jpg,378.0,128.0,0.590625,0.35555555555555557,0.021875,0.027777777777777776
8702-2021_03_20_073717.jpg,car,46,448,640,35,360,183,1,494,218,LTAdatasets/8702/annotate/8702-2021_03_20_073717.jpg,471.0,200.5,0.7359375,0.5569444444444445,0.071875,0.09722222222222222
8702-2021_03_20_073717.jpg,lorry_truck,52,529,640,45,360,172,2,581,217,LTAdatasets/8702/annotate/8702-2021_03_20_073717.jpg,555.0,194.5,0.8671875,0.5402777777777777,0.08125,0.125
8702-2021_03_20_073717.jpg,lorry_truck,38,137,640,22,360,138,2,175,160,LTAdatasets/8702/annotate/8702-2021_03_20_073717.jpg,156.0,149.0,0.24375,0.41388888888888886,0.059375,0.06111111111111111
8702-2021_03_20_073717.jpg,lorry_truck,25,204,640,24,360,112,2,229,136,LTAdatasets/8702/annotate/8702-2021_03_20_073717.jpg,216.5,124.0,0.33828125,0.34444444444444444,0.0390625,0.06666666666666667
8702-2021_03_20_073717.jpg,bus,23,238,640,20,360,104,5,261,124,LTAdatasets/8702/annotate/8702-2021_03_20_073717.jpg,249.5,114.0,0.38984375,0.31666666666666665,0.0359375,0.05555555555555555
8702-2021_03_20_073717.jpg,bike,11,313,640,12,360,135,4,324,147,LTAdatasets/8702/annotate/8702-2021_03_20_073717.jpg,318.5,141.0,0.49765625,0.39166666666666666,0.0171875,0.03333333333333333
8702-2021_03_20_073717.jpg,bike,10,336,640,12,360,118,4,346,130,LTAdatasets/8702/annotate/8702-2021_03_20_073717.jpg,341.0,124.0,0.5328125,0.34444444444444444,0.015625,0.03333333333333333
8702-2021_03_20_073717.jpg,bike,15,160,640,17,360,161,4,175,178,LTAdatasets/8702/annotate/8702-2021_03_20_073717.jpg,167.5,169.5,0.26171875,0.4708333333333333,0.0234375,0.04722222222222222
8702-2021_03_20_073717.jpg,car,48,23,640,33,360,236,1,71,269,LTAdatasets/8702/annotate/8702-2021_03_20_073717.jpg,47.0,252.5,0.0734375,0.7013888888888888,0.075,0.09166666666666666
8702-2021_03_20_073717.jpg,car,69,123,640,70,360,290,1,192,360,LTAdatasets/8702/annotate/8702-2021_03_20_073717.jpg,157.5,325.0,0.24609375,0.9027777777777778,0.1078125,0.19444444444444445
8702-2021_03_20_073717.jpg,bike,34,571,640,44,360,264,4,605,308,LTAdatasets/8702/annotate/8702-2021_03_20_073717.jpg,588.0,286.0,0.91875,0.7944444444444444,0.053125,0.12222222222222222
8702-2021_03_20_073717.jpg,lorry_truck,38,41,640,20,360,129,2,79,149,LTAdatasets/8702/annotate/8702-2021_03_20_073717.jpg,60.0,139.0,0.09375,0.3861111111111111,0.059375,0.05555555555555555
8702-2021_03_20_073717.jpg,bike,11,506,640,22,360,192,4,517,214,LTAdatasets/8702/annotate/8702-2021_03_20_073717.jpg,511.5,203.0,0.79921875,0.5638888888888889,0.0171875,0.06111111111111111
8702-2021_03_20_073717.jpg,bike,10,81,640,11,360,137,4,91,148,LTAdatasets/8702/annotate/8702-2021_03_20_073717.jpg,86.0,142.5,0.134375,0.3958333333333333,0.015625,0.030555555555555555
8702-2021_03_20_082220.jpg,bike,18,6,640,26,360,202,4,24,228,LTAdatasets/8702/annotate/8702-2021_03_20_082220.jpg,15.0,215.0,0.0234375,0.5972222222222222,0.028125,0.07222222222222222
8702-2021_03_20_082220.jpg,car,35,233,640,37,360,204,1,268,241,LTAdatasets/8702/annotate/8702-2021_03_20_082220.jpg,250.5,222.5,0.39140625,0.6180555555555556,0.0546875,0.10277777777777777
8702-2021_03_20_082220.jpg,car,48,586,640,48,360,212,1,634,260,LTAdatasets/8702/annotate/8702-2021_03_20_082220.jpg,610.0,236.0,0.953125,0.6555555555555556,0.075,0.13333333333333333
8702-2021_03_20_082220.jpg,lorry_truck,45,478,640,55,360,148,2,523,203,LTAdatasets/8702/annotate/8702-2021_03_20_082220.jpg,500.5,175.5,0.78203125,0.4875,0.0703125,0.1527777777777778
8702-2021_03_20_082220.jpg,lorry_truck,63,531,640,56,360,239,2,594,295,LTAdatasets/8702/annotate/8702-2021_03_20_082220.jpg,562.5,267.0,0.87890625,0.7416666666666667,0.0984375,0.15555555555555556
8702-2021_03_20_082220.jpg,car,28,446,640,25,360,178,1,474,203,LTAdatasets/8702/annotate/8702-2021_03_20_082220.jpg,460.0,190.5,0.71875,0.5291666666666667,0.04375,0.06944444444444445
8702-2021_03_20_082220.jpg,car,14,323,640,16,360,126,1,337,142,LTAdatasets/8702/annotate/8702-2021_03_20_082220.jpg,330.0,134.0,0.515625,0.37222222222222223,0.021875,0.044444444444444446
8702-2021_03_20_082220.jpg,lorry_truck,20,216,640,19,360,122,2,236,141,LTAdatasets/8702/annotate/8702-2021_03_20_082220.jpg,226.0,131.5,0.353125,0.36527777777777776,0.03125,0.05277777777777778
8702-2021_03_20_082220.jpg,lorry_truck,18,466,640,13,360,117,2,484,130,LTAdatasets/8702/annotate/8702-2021_03_20_082220.jpg,475.0,123.5,0.7421875,0.34305555555555556,0.028125,0.03611111111111111
8702-2021_03_20_200937.jpg,car,29,143,640,18,360,160,1,172,178,LTAdatasets/8702/annotate/8702-2021_03_20_200937.jpg,157.5,169.0,0.24609375,0.46944444444444444,0.0453125,0.05
8702-2021_03_20_200937.jpg,lorry_truck,38,66,640,25,360,121,2,104,146,LTAdatasets/8702/annotate/8702-2021_03_20_200937.jpg,85.0,133.5,0.1328125,0.37083333333333335,0.059375,0.06944444444444445
8702-2021_03_20_074918.jpg,lorry_truck,32,202,640,24,360,114,2,234,138,LTAdatasets/8702/annotate/8702-2021_03_20_074918.jpg,218.0,126.0,0.340625,0.35,0.05,0.06666666666666667
8702-2021_03_20_074918.jpg,lorry_truck,33,0,640,39,360,214,2,33,253,LTAdatasets/8702/annotate/8702-2021_03_20_074918.jpg,16.5,233.5,0.02578125,0.6486111111111111,0.0515625,0.10833333333333334
8702-2021_03_20_074918.jpg,lorry_truck,28,31,640,18,360,139,2,59,157,LTAdatasets/8702/annotate/8702-2021_03_20_074918.jpg,45.0,148.0,0.0703125,0.4111111111111111,0.04375,0.05
8702-2021_03_20_074918.jpg,lorry_truck,27,448,640,19,360,178,2,475,197,LTAdatasets/8702/annotate/8702-2021_03_20_074918.jpg,461.5,187.5,0.72109375,0.5208333333333334,0.0421875,0.05277777777777778
8702-2021_03_20_074918.jpg,lorry_truck,18,463,640,20,360,151,2,481,171,LTAdatasets/8702/annotate/8702-2021_03_20_074918.jpg,472.0,161.0,0.7375,0.44722222222222224,0.028125,0.05555555555555555
8702-2021_03_20_074918.jpg,car,23,226,640,16,360,140,1,249,156,LTAdatasets/8702/annotate/8702-2021_03_20_074918.jpg,237.5,148.0,0.37109375,0.4111111111111111,0.0359375,0.044444444444444446
8702-2021_03_20_074918.jpg,car,11,263,640,9,360,126,1,274,135,LTAdatasets/8702/annotate/8702-2021_03_20_074918.jpg,268.5,130.5,0.41953125,0.3625,0.0171875,0.025
8702-2021_03_20_074918.jpg,van,12,247,640,13,360,119,3,259,132,LTAdatasets/8702/annotate/8702-2021_03_20_074918.jpg,253.0,125.5,0.3953125,0.3486111111111111,0.01875,0.03611111111111111
8702-2021_03_20_074918.jpg,car,12,282,640,12,360,106,1,294,118,LTAdatasets/8702/annotate/8702-2021_03_20_074918.jpg,288.0,112.0,0.45,0.3111111111111111,0.01875,0.03333333333333333
8702-2021_03_20_193935.jpg,lorry_truck,92,525,640,85,360,206,2,617,291,LTAdatasets/8702/annotate/8702-2021_03_20_193935.jpg,571.0,248.5,0.8921875,0.6902777777777778,0.14375,0.2361111111111111
8702-2021_03_20_193935.jpg,lorry_truck,31,465,640,42,360,152,2,496,194,LTAdatasets/8702/annotate/8702-2021_03_20_193935.jpg,480.5,173.0,0.75078125,0.48055555555555557,0.0484375,0.11666666666666667
8702-2021_03_20_193935.jpg,car,24,508,640,25,360,170,1,532,195,LTAdatasets/8702/annotate/8702-2021_03_20_193935.jpg,520.0,182.5,0.8125,0.5069444444444444,0.0375,0.06944444444444445
8702-2021_03_20_193935.jpg,car,42,200,640,35,360,195,1,242,230,LTAdatasets/8702/annotate/8702-2021_03_20_193935.jpg,221.0,212.5,0.3453125,0.5902777777777778,0.065625,0.09722222222222222
8702-2021_03_20_193935.jpg,car,14,370,640,11,360,123,1,384,134,LTAdatasets/8702/annotate/8702-2021_03_20_193935.jpg,377.0,128.5,0.5890625,0.35694444444444445,0.021875,0.030555555555555555
8702-2021_03_20_193935.jpg,car,21,237,640,10,360,134,1,258,144,LTAdatasets/8702/annotate/8702-2021_03_20_193935.jpg,247.5,139.0,0.38671875,0.3861111111111111,0.0328125,0.027777777777777776
8702-2021_03_20_193935.jpg,car,23,104,640,8,360,130,1,127,138,LTAdatasets/8702/annotate/8702-2021_03_20_193935.jpg,115.5,134.0,0.18046875,0.37222222222222223,0.0359375,0.022222222222222223
8702-2021_03_20_193935.jpg,lorry_truck,15,243,640,12,360,115,2,258,127,LTAdatasets/8702/annotate/8702-2021_03_20_193935.jpg,250.5,121.0,0.39140625,0.33611111111111114,0.0234375,0.03333333333333333
2702-2021_03_20_073037.jpg,lorry_truck,23,381,640,35,360,271,2,404,306,LTAdatasets/2702/annotate/2702-2021_03_20_073037.jpg,392.5,288.5,0.61328125,0.8013888888888889,0.0359375,0.09722222222222222
2702-2021_03_20_073037.jpg,lorry_truck,28,405,640,37,360,303,2,433,340,LTAdatasets/2702/annotate/2702-2021_03_20_073037.jpg,419.0,321.5,0.6546875,0.8930555555555556,0.04375,0.10277777777777777
2702-2021_03_20_073037.jpg,lorry_truck,14,223,640,20,360,185,2,237,205,LTAdatasets/2702/annotate/2702-2021_03_20_073037.jpg,230.0,195.0,0.359375,0.5416666666666666,0.021875,0.05555555555555555
2702-2021_03_20_073037.jpg,lorry_truck,10,207,640,13,360,180,2,217,193,LTAdatasets/2702/annotate/2702-2021_03_20_073037.jpg,212.0,186.5,0.33125,0.5180555555555556,0.015625,0.03611111111111111
2702-2021_03_20_183712.jpg,lorry_truck,20,221,640,16,360,185,2,241,201,LTAdatasets/2702/annotate/2702-2021_03_20_183712.jpg,231.0,193.0,0.3609375,0.5361111111111111,0.03125,0.044444444444444446
2702-2021_03_20_183712.jpg,lorry_truck,17,206,640,16,360,189,2,223,205,LTAdatasets/2702/annotate/2702-2021_03_20_183712.jpg,214.5,197.0,0.33515625,0.5472222222222223,0.0265625,0.044444444444444446
2702-2021_03_20_183712.jpg,lorry_truck,12,234,640,21,360,166,2,246,187,LTAdatasets/2702/annotate/2702-2021_03_20_183712.jpg,240.0,176.5,0.375,0.49027777777777776,0.01875,0.058333333333333334
2702-2021_03_20_183712.jpg,lorry_truck,14,218,640,15,360,149,2,232,164,LTAdatasets/2702/annotate/2702-2021_03_20_183712.jpg,225.0,156.5,0.3515625,0.43472222222222223,0.021875,0.041666666666666664
2702-2021_03_20_183712.jpg,car,12,201,640,7,360,166,1,213,173,LTAdatasets/2702/annotate/2702-2021_03_20_183712.jpg,207.0,169.5,0.3234375,0.4708333333333333,0.01875,0.019444444444444445
2702-2021_03_20_183712.jpg,car,12,206,640,6,360,173,1,218,179,LTAdatasets/2702/annotate/2702-2021_03_20_183712.jpg,212.0,176.0,0.33125,0.4888888888888889,0.01875,0.016666666666666666
2702-2021_03_20_183712.jpg,car,11,109,640,9,360,115,1,120,124,LTAdatasets/2702/annotate/2702-2021_03_20_183712.jpg,114.5,119.5,0.17890625,0.33194444444444443,0.0171875,0.025
2702-2021_03_20_183412.jpg,lorry_truck,18,332,640,22,360,236,2,350,258,LTAdatasets/2702/annotate/2702-2021_03_20_183412.jpg,341.0,247.0,0.5328125,0.6861111111111111,0.028125,0.06111111111111111
2702-2021_03_20_183412.jpg,lorry_truck,17,220,640,17,360,186,2,237,203,LTAdatasets/2702/annotate/2702-2021_03_20_183412.jpg,228.5,194.5,0.35703125,0.5402777777777777,0.0265625,0.04722222222222222
2702-2021_03_20_183412.jpg,car,9,208,640,14,360,189,1,217,203,LTAdatasets/2702/annotate/2702-2021_03_20_183412.jpg,212.5,196.0,0.33203125,0.5444444444444444,0.0140625,0.03888888888888889
2702-2021_03_20_183412.jpg,car,11,199,640,11,360,181,1,210,192,LTAdatasets/2702/annotate/2702-2021_03_20_183412.jpg,204.5,186.5,0.31953125,0.5180555555555556,0.0171875,0.030555555555555555
2702-2021_03_20_183412.jpg,lorry_truck,10,216,640,11,360,175,2,226,186,LTAdatasets/2702/annotate/2702-2021_03_20_183412.jpg,221.0,180.5,0.3453125,0.5013888888888889,0.015625,0.030555555555555555
2702-2021_03_20_181251.jpg,lorry_truck,18,195,640,14,360,174,2,213,188,LTAdatasets/2702/annotate/2702-2021_03_20_181251.jpg,204.0,181.0,0.31875,0.5027777777777778,0.028125,0.03888888888888889
2702-2021_03_20_181251.jpg,lorry_truck,12,220,640,7,360,187,2,232,194,LTAdatasets/2702/annotate/2702-2021_03_20_181251.jpg,226.0,190.5,0.353125,0.5291666666666667,0.01875,0.019444444444444445
2702-2021_03_20_181251.jpg,lorry_truck,16,222,640,12,360,192,2,238,204,LTAdatasets/2702/annotate/2702-2021_03_20_181251.jpg,230.0,198.0,0.359375,0.55,0.025,0.03333333333333333
2702-2021_03_20_181251.jpg,lorry_truck,11,200,640,14,360,96,2,211,110,LTAdatasets/2702/annotate/2702-2021_03_20_181251.jpg,205.5,103.0,0.32109375,0.2861111111111111,0.0171875,0.03888888888888889
2702-2021_03_20_181251.jpg,lorry_truck,11,192,640,11,360,98,2,203,109,LTAdatasets/2702/annotate/2702-2021_03_20_181251.jpg,197.5,103.5,0.30859375,0.2875,0.0171875,0.030555555555555555
2702-2021_03_20_181251.jpg,car,8,213,640,11,360,192,1,221,203,LTAdatasets/2702/annotate/2702-2021_03_20_181251.jpg,217.0,197.5,0.3390625,0.5486111111111112,0.0125,0.030555555555555555
2702-2021_03_20_181251.jpg,car,7,217,640,12,360,177,1,224,189,LTAdatasets/2702/annotate/2702-2021_03_20_181251.jpg,220.5,183.0,0.34453125,0.5083333333333333,0.0109375,0.03333333333333333
2702-2021_03_20_181251.jpg,car,9,205,640,9,360,189,1,214,198,LTAdatasets/2702/annotate/2702-2021_03_20_181251.jpg,209.5,193.5,0.32734375,0.5375,0.0140625,0.025
2702-2021_03_20_091623.jpg,lorry_truck,35,234,640,21,360,174,2,269,195,LTAdatasets/2702/annotate/2702-2021_03_20_091623.jpg,251.5,184.5,0.39296875,0.5125,0.0546875,0.058333333333333334
2702-2021_03_20_091623.jpg,lorry_truck,19,204,640,19,360,161,2,223,180,LTAdatasets/2702/annotate/2702-2021_03_20_091623.jpg,213.5,170.5,0.33359375,0.4736111111111111,0.0296875,0.05277777777777778
2702-2021_03_20_074318.jpg,car,13,225,640,11,360,191,1,238,202,LTAdatasets/2702/annotate/2702-2021_03_20_074318.jpg,231.5,196.5,0.36171875,0.5458333333333333,0.0203125,0.030555555555555555
2702-2021_03_20_081920.jpg,car,12,256,640,11,360,255,1,268,266,LTAdatasets/2702/annotate/2702-2021_03_20_081920.jpg,262.0,260.5,0.409375,0.7236111111111111,0.01875,0.030555555555555555
2702-2021_03_20_081920.jpg,lorry_truck,17,233,640,24,360,178,2,250,202,LTAdatasets/2702/annotate/2702-2021_03_20_081920.jpg,241.5,190.0,0.37734375,0.5277777777777778,0.0265625,0.06666666666666667
2702-2021_03_20_081920.jpg,car,12,206,640,9,360,170,1,218,179,LTAdatasets/2702/annotate/2702-2021_03_20_081920.jpg,212.0,174.5,0.33125,0.4847222222222222,0.01875,0.025
2702-2021_03_20_081920.jpg,car,12,203,640,9,360,158,1,215,167,LTAdatasets/2702/annotate/2702-2021_03_20_081920.jpg,209.0,162.5,0.3265625,0.4513888888888889,0.01875,0.025
2702-2021_03_20_190634.jpg,lorry_truck,16,225,640,19,360,189,2,241,208,LTAdatasets/2702/annotate/2702-2021_03_20_190634.jpg,233.0,198.5,0.3640625,0.5513888888888889,0.025,0.05277777777777778
2702-2021_03_20_190634.jpg,car,14,209,640,14,360,190,1,223,204,LTAdatasets/2702/annotate/2702-2021_03_20_190634.jpg,216.0,197.0,0.3375,0.5472222222222223,0.021875,0.03888888888888889
2702-2021_03_20_190634.jpg,car,12,211,640,10,360,181,1,223,191,LTAdatasets/2702/annotate/2702-2021_03_20_190634.jpg,217.0,186.0,0.3390625,0.5166666666666667,0.01875,0.027777777777777776
2702-2021_03_20_092803.jpg,lorry_truck,22,246,640,21,360,167,2,268,188,LTAdatasets/2702/annotate/2702-2021_03_20_092803.jpg,257.0,177.5,0.4015625,0.4930555555555556,0.034375,0.058333333333333334
2702-2021_03_20_092803.jpg,lorry_truck,24,281,640,20,360,205,2,305,225,LTAdatasets/2702/annotate/2702-2021_03_20_092803.jpg,293.0,215.0,0.4578125,0.5972222222222222,0.0375,0.05555555555555555
2702-2021_03_20_092803.jpg,lorry_truck,26,264,640,34,360,261,2,290,295,LTAdatasets/2702/annotate/2702-2021_03_20_092803.jpg,277.0,278.0,0.4328125,0.7722222222222223,0.040625,0.09444444444444444
2702-2021_03_20_092803.jpg,car,10,209,640,10,360,190,1,219,200,LTAdatasets/2702/annotate/2702-2021_03_20_092803.jpg,214.0,195.0,0.334375,0.5416666666666666,0.015625,0.027777777777777776
2702-2021_03_20_092803.jpg,car,15,202,640,8,360,186,1,217,194,LTAdatasets/2702/annotate/2702-2021_03_20_092803.jpg,209.5,190.0,0.32734375,0.5277777777777778,0.0234375,0.022222222222222223
2702-2021_03_20_085141.jpg,lorry_truck,31,399,640,53,360,298,2,430,351,LTAdatasets/2702/annotate/2702-2021_03_20_085141.jpg,414.5,324.5,0.64765625,0.9013888888888889,0.0484375,0.14722222222222223
2702-2021_03_20_085141.jpg,lorry_truck,25,310,640,25,360,215,2,335,240,LTAdatasets/2702/annotate/2702-2021_03_20_085141.jpg,322.5,227.5,0.50390625,0.6319444444444444,0.0390625,0.06944444444444445
2702-2021_03_20_085141.jpg,lorry_truck,19,250,640,21,360,182,2,269,203,LTAdatasets/2702/annotate/2702-2021_03_20_085141.jpg,259.5,192.5,0.40546875,0.5347222222222222,0.0296875,0.058333333333333334
2702-2021_03_20_085141.jpg,lorry_truck,17,221,640,19,360,184,2,238,203,LTAdatasets/2702/annotate/2702-2021_03_20_085141.jpg,229.5,193.5,0.35859375,0.5375,0.0265625,0.05277777777777778
2702-2021_03_20_085141.jpg,lorry_truck,19,218,640,25,360,209,2,237,234,LTAdatasets/2702/annotate/2702-2021_03_20_085141.jpg,227.5,221.5,0.35546875,0.6152777777777778,0.0296875,0.06944444444444445
2702-2021_03_20_085141.jpg,bike,9,255,640,14,360,250,4,264,264,LTAdatasets/2702/annotate/2702-2021_03_20_085141.jpg,259.5,257.0,0.40546875,0.7138888888888889,0.0140625,0.03888888888888889
2702-2021_03_20_085141.jpg,bike,10,248,640,16,360,241,4,258,257,LTAdatasets/2702/annotate/2702-2021_03_20_085141.jpg,253.0,249.0,0.3953125,0.6916666666666667,0.015625,0.044444444444444446
2702-2021_03_20_085141.jpg,lorry_truck,15,204,640,15,360,162,2,219,177,LTAdatasets/2702/annotate/2702-2021_03_20_085141.jpg,211.5,169.5,0.33046875,0.4708333333333333,0.0234375,0.041666666666666664
2702-2021_03_20_095205.jpg,lorry_truck,16,224,640,18,360,184,2,240,202,LTAdatasets/2702/annotate/2702-2021_03_20_095205.jpg,232.0,193.0,0.3625,0.5361111111111111,0.025,0.05
2702-2021_03_20_095205.jpg,lorry_truck,16,251,640,24,360,180,2,267,204,LTAdatasets/2702/annotate/2702-2021_03_20_095205.jpg,259.0,192.0,0.4046875,0.5333333333333333,0.025,0.06666666666666667
2702-2021_03_20_095205.jpg,car,12,208,640,12,360,188,1,220,200,LTAdatasets/2702/annotate/2702-2021_03_20_095205.jpg,214.0,194.0,0.334375,0.5388888888888889,0.01875,0.03333333333333333
2702-2021_03_20_182752.jpg,lorry_truck,15,218,640,16,360,190,2,233,206,LTAdatasets/2702/annotate/2702-2021_03_20_182752.jpg,225.5,198.0,0.35234375,0.55,0.0234375,0.044444444444444446
2702-2021_03_20_092543.jpg,lorry_truck,29,331,640,24,360,239,2,360,263,LTAdatasets/2702/annotate/2702-2021_03_20_092543.jpg,345.5,251.0,0.53984375,0.6972222222222222,0.0453125,0.06666666666666667
2702-2021_03_20_092543.jpg,car,15,221,640,15,360,189,1,236,204,LTAdatasets/2702/annotate/2702-2021_03_20_092543.jpg,228.5,196.5,0.35703125,0.5458333333333333,0.0234375,0.041666666666666664
2702-2021_03_20_092543.jpg,car,9,208,640,7,360,191,1,217,198,LTAdatasets/2702/annotate/2702-2021_03_20_092543.jpg,212.5,194.5,0.33203125,0.5402777777777777,0.0140625,0.019444444444444445
2702-2021_03_20_092543.jpg,lorry_truck,31,170,640,18,360,165,2,201,183,LTAdatasets/2702/annotate/2702-2021_03_20_092543.jpg,185.5,174.0,0.28984375,0.48333333333333334,0.0484375,0.05
2702-2021_03_20_182151.jpg,lorry_truck,20,196,640,15,360,164,2,216,179,LTAdatasets/2702/annotate/2702-2021_03_20_182151.jpg,206.0,171.5,0.321875,0.47638888888888886,0.03125,0.041666666666666664
2702-2021_03_20_182151.jpg,lorry_truck,23,199,640,19,360,150,2,222,169,LTAdatasets/2702/annotate/2702-2021_03_20_182151.jpg,210.5,159.5,0.32890625,0.44305555555555554,0.0359375,0.05277777777777778
2702-2021_03_20_182151.jpg,van,11,248,640,8,360,172,3,259,180,LTAdatasets/2702/annotate/2702-2021_03_20_182151.jpg,253.5,176.0,0.39609375,0.4888888888888889,0.0171875,0.022222222222222223
2702-2021_03_20_194315.jpg,car,15,223,640,10,360,192,1,238,202,LTAdatasets/2702/annotate/2702-2021_03_20_194315.jpg,230.5,197.0,0.36015625,0.5472222222222223,0.0234375,0.027777777777777776
2702-2021_03_20_194315.jpg,car,14,208,640,7,360,191,1,222,198,LTAdatasets/2702/annotate/2702-2021_03_20_194315.jpg,215.0,194.5,0.3359375,0.5402777777777777,0.021875,0.019444444444444445
2702-2021_03_20_074918.jpg,lorry_truck,25,402,640,38,360,293,2,427,331,LTAdatasets/2702/annotate/2702-2021_03_20_074918.jpg,414.5,312.0,0.64765625,0.8666666666666667,0.0390625,0.10555555555555556
2702-2021_03_20_074918.jpg,lorry_truck,35,428,640,32,360,326,2,463,358,LTAdatasets/2702/annotate/2702-2021_03_20_074918.jpg,445.5,342.0,0.69609375,0.95,0.0546875,0.08888888888888889
2702-2021_03_20_074918.jpg,van,11,221,640,14,360,186,3,232,200,LTAdatasets/2702/annotate/2702-2021_03_20_074918.jpg,226.5,193.0,0.35390625,0.5361111111111111,0.0171875,0.03888888888888889
2702-2021_03_20_074918.jpg,van,10,204,640,12,360,172,3,214,184,LTAdatasets/2702/annotate/2702-2021_03_20_074918.jpg,209.0,178.0,0.3265625,0.49444444444444446,0.015625,0.03333333333333333
2702-2021_03_20_074918.jpg,car,12,213,640,11,360,177,1,225,188,LTAdatasets/2702/annotate/2702-2021_03_20_074918.jpg,219.0,182.5,0.3421875,0.5069444444444444,0.01875,0.030555555555555555
2702-2021_03_20_180410.jpg,car,10,209,640,8,360,190,1,219,198,LTAdatasets/2702/annotate/2702-2021_03_20_180410.jpg,214.0,194.0,0.334375,0.5388888888888889,0.015625,0.022222222222222223
2702-2021_03_20_180410.jpg,car,8,223,640,8,360,191,1,231,199,LTAdatasets/2702/annotate/2702-2021_03_20_180410.jpg,227.0,195.0,0.3546875,0.5416666666666666,0.0125,0.022222222222222223
2702-2021_03_20_180410.jpg,lorry_truck,21,271,640,18,360,202,2,292,220,LTAdatasets/2702/annotate/2702-2021_03_20_180410.jpg,281.5,211.0,0.43984375,0.5861111111111111,0.0328125,0.05
2702-2021_03_20_180410.jpg,lorry_truck,16,202,640,15,360,154,2,218,169,LTAdatasets/2702/annotate/2702-2021_03_20_180410.jpg,210.0,161.5,0.328125,0.4486111111111111,0.025,0.041666666666666664
2702-2021_03_20_180410.jpg,car,9,204,640,11,360,169,1,213,180,LTAdatasets/2702/annotate/2702-2021_03_20_180410.jpg,208.5,174.5,0.32578125,0.4847222222222222,0.0140625,0.030555555555555555
2702-2021_03_20_200937.jpg,lorry_truck,11,218,640,16,360,175,2,229,191,LTAdatasets/2702/annotate/2702-2021_03_20_200937.jpg,223.5,183.0,0.34921875,0.5083333333333333,0.0171875,0.044444444444444446
2702-2021_03_20_200937.jpg,car,10,225,640,13,360,191,1,235,204,LTAdatasets/2702/annotate/2702-2021_03_20_200937.jpg,230.0,197.5,0.359375,0.5486111111111112,0.015625,0.03611111111111111
2702-2021_03_20_200937.jpg,car,11,205,640,15,360,186,1,216,201,LTAdatasets/2702/annotate/2702-2021_03_20_200937.jpg,210.5,193.5,0.32890625,0.5375,0.0171875,0.041666666666666664
2702-2021_03_20_200937.jpg,lorry_truck,43,262,640,39,360,321,2,305,360,LTAdatasets/2702/annotate/2702-2021_03_20_200937.jpg,283.5,340.5,0.44296875,0.9458333333333333,0.0671875,0.10833333333333334
2702-2021_03_20_091302.jpg,lorry_truck,31,297,640,30,360,330,2,328,360,LTAdatasets/2702/annotate/2702-2021_03_20_091302.jpg,312.5,345.0,0.48828125,0.9583333333333334,0.0484375,0.08333333333333333
2702-2021_03_20_091302.jpg,car,13,225,640,8,360,193,1,238,201,LTAdatasets/2702/annotate/2702-2021_03_20_091302.jpg,231.5,197.0,0.36171875,0.5472222222222223,0.0203125,0.022222222222222223
2702-2021_03_20_091302.jpg,car,11,209,640,12,360,189,1,220,201,LTAdatasets/2702/annotate/2702-2021_03_20_091302.jpg,214.5,195.0,0.33515625,0.5416666666666666,0.0171875,0.03333333333333333
2702-2021_03_20_091302.jpg,lorry_truck,11,203,640,17,360,161,2,214,178,LTAdatasets/2702/annotate/2702-2021_03_20_091302.jpg,208.5,169.5,0.32578125,0.4708333333333333,0.0171875,0.04722222222222222
2702-2021_03_20_082740.jpg,lorry_truck,17,256,640,20,360,187,2,273,207,LTAdatasets/2702/annotate/2702-2021_03_20_082740.jpg,264.5,197.0,0.41328125,0.5472222222222223,0.0265625,0.05555555555555555
2702-2021_03_20_082740.jpg,lorry_truck,14,276,640,15,360,205,2,290,220,LTAdatasets/2702/annotate/2702-2021_03_20_082740.jpg,283.0,212.5,0.4421875,0.5902777777777778,0.021875,0.041666666666666664
2702-2021_03_20_082740.jpg,van,11,207,640,14,360,174,3,218,188,LTAdatasets/2702/annotate/2702-2021_03_20_082740.jpg,212.5,181.0,0.33203125,0.5027777777777778,0.0171875,0.03888888888888889
2702-2021_03_20_094605.jpg,lorry_truck,21,218,640,22,360,215,2,239,237,LTAdatasets/2702/annotate/2702-2021_03_20_094605.jpg,228.5,226.0,0.35703125,0.6277777777777778,0.0328125,0.06111111111111111
2702-2021_03_20_094605.jpg,lorry_truck,21,248,640,23,360,177,2,269,200,LTAdatasets/2702/annotate/2702-2021_03_20_094605.jpg,258.5,188.5,0.40390625,0.5236111111111111,0.0328125,0.06388888888888888
2702-2021_03_20_094605.jpg,lorry_truck,16,217,640,17,360,143,2,233,160,LTAdatasets/2702/annotate/2702-2021_03_20_094605.jpg,225.0,151.5,0.3515625,0.42083333333333334,0.025,0.04722222222222222
2702-2021_03_20_094605.jpg,lorry_truck,14,203,640,17,360,150,2,217,167,LTAdatasets/2702/annotate/2702-2021_03_20_094605.jpg,210.0,158.5,0.328125,0.44027777777777777,0.021875,0.04722222222222222
2702-2021_03_20_183112.jpg,lorry_truck,37,405,640,36,360,324,2,442,360,LTAdatasets/2702/annotate/2702-2021_03_20_183112.jpg,423.5,342.0,0.66171875,0.95,0.0578125,0.1
2702-2021_03_20_183112.jpg,lorry_truck,17,242,640,24,360,175,2,259,199,LTAdatasets/2702/annotate/2702-2021_03_20_183112.jpg,250.5,187.0,0.39140625,0.5194444444444445,0.0265625,0.06666666666666667
2702-2021_03_20_183112.jpg,lorry_truck,13,223,640,20,360,182,2,236,202,LTAdatasets/2702/annotate/2702-2021_03_20_183112.jpg,229.5,192.0,0.35859375,0.5333333333333333,0.0203125,0.05555555555555555
2702-2021_03_20_183112.jpg,lorry_truck,9,210,640,20,360,181,2,219,201,LTAdatasets/2702/annotate/2702-2021_03_20_183112.jpg,214.5,191.0,0.33515625,0.5305555555555556,0.0140625,0.05555555555555555
2702-2021_03_20_183112.jpg,van,7,207,640,11,360,160,3,214,171,LTAdatasets/2702/annotate/2702-2021_03_20_183112.jpg,210.5,165.5,0.32890625,0.4597222222222222,0.0109375,0.030555555555555555
2702-2021_03_20_075518.jpg,lorry_truck,21,248,640,20,360,181,2,269,201,LTAdatasets/2702/annotate/2702-2021_03_20_075518.jpg,258.5,191.0,0.40390625,0.5305555555555556,0.0328125,0.05555555555555555
2702-2021_03_20_075518.jpg,car,12,203,640,10,360,154,1,215,164,LTAdatasets/2702/annotate/2702-2021_03_20_075518.jpg,209.0,159.0,0.3265625,0.44166666666666665,0.01875,0.027777777777777776
2702-2021_03_20_183952.jpg,lorry_truck,25,225,640,17,360,171,2,250,188,LTAdatasets/2702/annotate/2702-2021_03_20_183952.jpg,237.5,179.5,0.37109375,0.4986111111111111,0.0390625,0.04722222222222222
2702-2021_03_20_183952.jpg,lorry_truck,12,223,640,13,360,186,2,235,199,LTAdatasets/2702/annotate/2702-2021_03_20_183952.jpg,229.0,192.5,0.3578125,0.5347222222222222,0.01875,0.03611111111111111
2702-2021_03_20_183952.jpg,car,9,201,640,14,360,169,1,210,183,LTAdatasets/2702/annotate/2702-2021_03_20_183952.jpg,205.5,176.0,0.32109375,0.4888888888888889,0.0140625,0.03888888888888889
2702-2021_03_20_191914.jpg,car,10,202,640,8,360,171,1,212,179,LTAdatasets/2702/annotate/2702-2021_03_20_191914.jpg,207.0,175.0,0.3234375,0.4861111111111111,0.015625,0.022222222222222223
2702-2021_03_20_191914.jpg,lorry_truck,11,204,640,12,360,151,2,215,163,LTAdatasets/2702/annotate/2702-2021_03_20_191914.jpg,209.5,157.0,0.32734375,0.4361111111111111,0.0171875,0.03333333333333333
2702-2021_03_20_083640.jpg,lorry_truck,10,219,640,18,360,163,2,229,181,LTAdatasets/2702/annotate/2702-2021_03_20_083640.jpg,224.0,172.0,0.35,0.4777777777777778,0.015625,0.05
2702-2021_03_20_083640.jpg,lorry_truck,15,234,640,20,360,161,2,249,181,LTAdatasets/2702/annotate/2702-2021_03_20_083640.jpg,241.5,171.0,0.37734375,0.475,0.0234375,0.05555555555555555
2702-2021_03_20_083640.jpg,lorry_truck,9,252,640,17,360,169,2,261,186,LTAdatasets/2702/annotate/2702-2021_03_20_083640.jpg,256.5,177.5,0.40078125,0.4930555555555556,0.0140625,0.04722222222222222
2702-2021_03_20_083640.jpg,lorry_truck,20,241,640,26,360,228,2,261,254,LTAdatasets/2702/annotate/2702-2021_03_20_083640.jpg,251.0,241.0,0.3921875,0.6694444444444444,0.03125,0.07222222222222222
2702-2021_03_20_083640.jpg,car,11,204,640,9,360,173,1,215,182,LTAdatasets/2702/annotate/2702-2021_03_20_083640.jpg,209.5,177.5,0.32734375,0.4930555555555556,0.0171875,0.025
2702-2021_03_20_084601.jpg,lorry_truck,14,292,640,16,360,210,2,306,226,LTAdatasets/2702/annotate/2702-2021_03_20_084601.jpg,299.0,218.0,0.4671875,0.6055555555555555,0.021875,0.044444444444444446
2702-2021_03_20_084601.jpg,lorry_truck,17,263,640,26,360,187,2,280,213,LTAdatasets/2702/annotate/2702-2021_03_20_084601.jpg,271.5,200.0,0.42421875,0.5555555555555556,0.0265625,0.07222222222222222
2702-2021_03_20_084601.jpg,lorry_truck,14,246,640,16,360,178,2,260,194,LTAdatasets/2702/annotate/2702-2021_03_20_084601.jpg,253.0,186.0,0.3953125,0.5166666666666667,0.021875,0.044444444444444446
2702-2021_03_20_084601.jpg,lorry_truck,19,220,640,20,360,203,2,239,223,LTAdatasets/2702/annotate/2702-2021_03_20_084601.jpg,229.5,213.0,0.35859375,0.5916666666666667,0.0296875,0.05555555555555555
2702-2021_03_20_084601.jpg,lorry_truck,20,209,640,12,360,186,2,229,198,LTAdatasets/2702/annotate/2702-2021_03_20_084601.jpg,219.0,192.0,0.3421875,0.5333333333333333,0.03125,0.03333333333333333
2702-2021_03_20_084601.jpg,lorry_truck,14,205,640,18,360,160,2,219,178,LTAdatasets/2702/annotate/2702-2021_03_20_084601.jpg,212.0,169.0,0.33125,0.46944444444444444,0.021875,0.05
2702-2021_03_20_202217.jpg,bus,18,220,640,23,360,177,5,238,200,LTAdatasets/2702/annotate/2702-2021_03_20_202217.jpg,229.0,188.5,0.3578125,0.5236111111111111,0.028125,0.06388888888888888
2702-2021_03_20_202217.jpg,car,12,205,640,12,360,169,1,217,181,LTAdatasets/2702/annotate/2702-2021_03_20_202217.jpg,211.0,175.0,0.3296875,0.4861111111111111,0.01875,0.03333333333333333
2702-2021_03_20_094024.jpg,car,14,207,640,8,360,191,1,221,199,LTAdatasets/2702/annotate/2702-2021_03_20_094024.jpg,214.0,195.0,0.334375,0.5416666666666666,0.021875,0.022222222222222223
2702-2021_03_20_094024.jpg,van,11,239,640,9,360,189,3,250,198,LTAdatasets/2702/annotate/2702-2021_03_20_094024.jpg,244.5,193.5,0.38203125,0.5375,0.0171875,0.025
2702-2021_03_20_094024.jpg,lorry_truck,21,248,640,23,360,178,2,269,201,LTAdatasets/2702/annotate/2702-2021_03_20_094024.jpg,258.5,189.5,0.40390625,0.5263888888888889,0.0328125,0.06388888888888888
2702-2021_03_20_094024.jpg,lorry_truck,14,221,640,21,360,181,2,235,202,LTAdatasets/2702/annotate/2702-2021_03_20_094024.jpg,228.0,191.5,0.35625,0.5319444444444444,0.021875,0.058333333333333334
2702-2021_03_20_085501.jpg,lorry_truck,28,264,640,37,360,259,2,292,296,LTAdatasets/2702/annotate/2702-2021_03_20_085501.jpg,278.0,277.5,0.434375,0.7708333333333334,0.04375,0.10277777777777777
2702-2021_03_20_085501.jpg,lorry_truck,23,255,640,21,360,247,2,278,268,LTAdatasets/2702/annotate/2702-2021_03_20_085501.jpg,266.5,257.5,0.41640625,0.7152777777777778,0.0359375,0.058333333333333334
2702-2021_03_20_085501.jpg,lorry_truck,19,204,640,16,360,161,2,223,177,LTAdatasets/2702/annotate/2702-2021_03_20_085501.jpg,213.5,169.0,0.33359375,0.46944444444444444,0.0296875,0.044444444444444446
2702-2021_03_20_193935.jpg,lorry_truck,16,219,640,14,360,184,2,235,198,LTAdatasets/2702/annotate/2702-2021_03_20_193935.jpg,227.0,191.0,0.3546875,0.5305555555555556,0.025,0.03888888888888889
2702-2021_03_20_193935.jpg,lorry_truck,15,206,640,8,360,183,2,221,191,LTAdatasets/2702/annotate/2702-2021_03_20_193935.jpg,213.5,187.0,0.33359375,0.5194444444444445,0.0234375,0.022222222222222223
2702-2021_03_20_193935.jpg,car,10,231,640,12,360,168,1,241,180,LTAdatasets/2702/annotate/2702-2021_03_20_193935.jpg,236.0,174.0,0.36875,0.48333333333333334,0.015625,0.03333333333333333
2702-2021_03_20_193935.jpg,car,15,210,640,10,360,173,1,225,183,LTAdatasets/2702/annotate/2702-2021_03_20_193935.jpg,217.5,178.0,0.33984375,0.49444444444444446,0.0234375,0.027777777777777776
2702-2021_03_20_193935.jpg,van,15,205,640,11,360,164,3,220,175,LTAdatasets/2702/annotate/2702-2021_03_20_193935.jpg,212.5,169.5,0.33203125,0.4708333333333333,0.0234375,0.030555555555555555
2702-2021_03_20_084001.jpg,lorry_truck,9,202,640,19,360,161,2,211,180,LTAdatasets/2702/annotate/2702-2021_03_20_084001.jpg,206.5,170.5,0.32265625,0.4736111111111111,0.0140625,0.05277777777777778
2702-2021_03_20_084001.jpg,lorry_truck,12,208,640,14,360,157,2,220,171,LTAdatasets/2702/annotate/2702-2021_03_20_084001.jpg,214.0,164.0,0.334375,0.45555555555555555,0.01875,0.03888888888888889
2702-2021_03_20_080119.jpg,lorry_truck,20,376,640,31,360,263,2,396,294,LTAdatasets/2702/annotate/2702-2021_03_20_080119.jpg,386.0,278.5,0.603125,0.7736111111111111,0.03125,0.08611111111111111
2702-2021_03_20_080119.jpg,bus,18,302,640,19,360,227,5,320,246,LTAdatasets/2702/annotate/2702-2021_03_20_080119.jpg,311.0,236.5,0.4859375,0.6569444444444444,0.028125,0.05277777777777778
2702-2021_03_20_080119.jpg,lorry_truck,19,308,640,33,360,207,2,327,240,LTAdatasets/2702/annotate/2702-2021_03_20_080119.jpg,317.5,223.5,0.49609375,0.6208333333333333,0.0296875,0.09166666666666666
2702-2021_03_20_080119.jpg,lorry_truck,18,204,640,22,360,157,2,222,179,LTAdatasets/2702/annotate/2702-2021_03_20_080119.jpg,213.0,168.0,0.3328125,0.4666666666666667,0.028125,0.06111111111111111
2702-2021_03_20_080119.jpg,car,12,217,640,11,360,199,1,229,210,LTAdatasets/2702/annotate/2702-2021_03_20_080119.jpg,223.0,204.5,0.3484375,0.5680555555555555,0.01875,0.030555555555555555
2702-2021_03_20_195736.jpg,bus,46,215,640,18,360,170,5,261,188,LTAdatasets/2702/annotate/2702-2021_03_20_195736.jpg,238.0,179.0,0.371875,0.49722222222222223,0.071875,0.05
2702-2021_03_20_195736.jpg,van,17,210,640,15,360,214,3,227,229,LTAdatasets/2702/annotate/2702-2021_03_20_195736.jpg,218.5,221.5,0.34140625,0.6152777777777778,0.0265625,0.041666666666666664
2702-2021_03_20_195736.jpg,lorry_truck,16,226,640,21,360,217,2,242,238,LTAdatasets/2702/annotate/2702-2021_03_20_195736.jpg,234.0,227.5,0.365625,0.6319444444444444,0.025,0.058333333333333334
2702-2021_03_20_074618.jpg,van,14,214,640,13,360,217,3,228,230,LTAdatasets/2702/annotate/2702-2021_03_20_074618.jpg,221.0,223.5,0.3453125,0.6208333333333333,0.021875,0.03611111111111111
2702-2021_03_20_074618.jpg,car,14,235,640,12,360,229,1,249,241,LTAdatasets/2702/annotate/2702-2021_03_20_074618.jpg,242.0,235.0,0.378125,0.6527777777777778,0.021875,0.03333333333333333
2702-2021_03_20_074618.jpg,lorry_truck,17,219,640,35,360,176,2,236,211,LTAdatasets/2702/annotate/2702-2021_03_20_074618.jpg,227.5,193.5,0.35546875,0.5375,0.0265625,0.09722222222222222
2702-2021_03_20_074618.jpg,lorry_truck,15,212,640,17,360,138,2,227,155,LTAdatasets/2702/annotate/2702-2021_03_20_074618.jpg,219.5,146.5,0.34296875,0.40694444444444444,0.0234375,0.04722222222222222
2702-2021_03_20_074618.jpg,bike,12,431,640,19,360,336,4,443,355,LTAdatasets/2702/annotate/2702-2021_03_20_074618.jpg,437.0,345.5,0.6828125,0.9597222222222223,0.01875,0.05277777777777778
2702-2021_03_20_082440.jpg,bus,16,220,640,25,360,179,5,236,204,LTAdatasets/2702/annotate/2702-2021_03_20_082440.jpg,228.0,191.5,0.35625,0.5319444444444444,0.025,0.06944444444444445
2702-2021_03_20_082440.jpg,car,12,204,640,11,360,169,1,216,180,LTAdatasets/2702/annotate/2702-2021_03_20_082440.jpg,210.0,174.5,0.328125,0.4847222222222222,0.01875,0.030555555555555555
2702-2021_03_20_082440.jpg,car,15,207,640,10,360,194,1,222,204,LTAdatasets/2702/annotate/2702-2021_03_20_082440.jpg,214.5,199.0,0.33515625,0.5527777777777778,0.0234375,0.027777777777777776
2702-2021_03_20_093424.jpg,lorry_truck,29,268,640,38,360,265,2,297,303,LTAdatasets/2702/annotate/2702-2021_03_20_093424.jpg,282.5,284.0,0.44140625,0.7888888888888889,0.0453125,0.10555555555555556
2702-2021_03_20_093424.jpg,lorry_truck,32,357,640,45,360,240,2,389,285,LTAdatasets/2702/annotate/2702-2021_03_20_093424.jpg,373.0,262.5,0.5828125,0.7291666666666666,0.05,0.125
2702-2021_03_20_093424.jpg,bus,17,254,640,29,360,179,5,271,208,LTAdatasets/2702/annotate/2702-2021_03_20_093424.jpg,262.5,193.5,0.41015625,0.5375,0.0265625,0.08055555555555556
2702-2021_03_20_093424.jpg,car,23,229,640,12,360,204,1,252,216,LTAdatasets/2702/annotate/2702-2021_03_20_093424.jpg,240.5,210.0,0.37578125,0.5833333333333334,0.0359375,0.03333333333333333
2702-2021_03_20_093424.jpg,lorry_truck,14,217,640,26,360,172,2,231,198,LTAdatasets/2702/annotate/2702-2021_03_20_093424.jpg,224.0,185.0,0.35,0.5138888888888888,0.021875,0.07222222222222222
2702-2021_03_20_093424.jpg,van,12,224,640,14,360,191,3,236,205,LTAdatasets/2702/annotate/2702-2021_03_20_093424.jpg,230.0,198.0,0.359375,0.55,0.01875,0.03888888888888889
2702-2021_03_20_094305.jpg,lorry_truck,20,310,640,17,360,224,2,330,241,LTAdatasets/2702/annotate/2702-2021_03_20_094305.jpg,320.0,232.5,0.5,0.6458333333333334,0.03125,0.04722222222222222
2702-2021_03_20_094305.jpg,lorry_truck,22,248,640,14,360,185,2,270,199,LTAdatasets/2702/annotate/2702-2021_03_20_094305.jpg,259.0,192.0,0.4046875,0.5333333333333333,0.034375,0.03888888888888889
2702-2021_03_20_094305.jpg,lorry_truck,23,259,640,16,360,198,2,282,214,LTAdatasets/2702/annotate/2702-2021_03_20_094305.jpg,270.5,206.0,0.42265625,0.5722222222222222,0.0359375,0.044444444444444446
2702-2021_03_20_201917.jpg,lorry_truck,17,245,640,26,360,236,2,262,262,LTAdatasets/2702/annotate/2702-2021_03_20_201917.jpg,253.5,249.0,0.39609375,0.6916666666666667,0.0265625,0.07222222222222222
2702-2021_03_20_201917.jpg,bike,10,238,640,10,360,173,4,248,183,LTAdatasets/2702/annotate/2702-2021_03_20_201917.jpg,243.0,178.0,0.3796875,0.49444444444444446,0.015625,0.027777777777777776
2702-2021_03_20_195136.jpg,car,15,216,640,11,360,185,1,231,196,LTAdatasets/2702/annotate/2702-2021_03_20_195136.jpg,223.5,190.5,0.34921875,0.5291666666666667,0.0234375,0.030555555555555555
2702-2021_03_20_195136.jpg,car,10,215,640,11,360,199,1,225,210,LTAdatasets/2702/annotate/2702-2021_03_20_195136.jpg,220.0,204.5,0.34375,0.5680555555555555,0.015625,0.030555555555555555
2702-2021_03_20_195136.jpg,car,17,195,640,12,360,195,1,212,207,LTAdatasets/2702/annotate/2702-2021_03_20_195136.jpg,203.5,201.0,0.31796875,0.5583333333333333,0.0265625,0.03333333333333333
2702-2021_03_20_081539.jpg,lorry_truck,23,293,640,34,360,311,2,316,345,LTAdatasets/2702/annotate/2702-2021_03_20_081539.jpg,304.5,328.0,0.47578125,0.9111111111111111,0.0359375,0.09444444444444444
2702-2021_03_20_081539.jpg,car,17,210,640,10,360,181,1,227,191,LTAdatasets/2702/annotate/2702-2021_03_20_081539.jpg,218.5,186.0,0.34140625,0.5166666666666667,0.0265625,0.027777777777777776
2702-2021_03_20_081539.jpg,car,16,205,640,8,360,172,1,221,180,LTAdatasets/2702/annotate/2702-2021_03_20_081539.jpg,213.0,176.0,0.3328125,0.4888888888888889,0.025,0.022222222222222223
2702-2021_03_20_081539.jpg,car,11,204,640,10,360,157,1,215,167,LTAdatasets/2702/annotate/2702-2021_03_20_081539.jpg,209.5,162.0,0.32734375,0.45,0.0171875,0.027777777777777776
2702-2021_03_20_092143.jpg,bike,9,415,640,21,360,308,4,424,329,LTAdatasets/2702/annotate/2702-2021_03_20_092143.jpg,419.5,318.5,0.65546875,0.8847222222222222,0.0140625,0.058333333333333334
2702-2021_03_20_092143.jpg,lorry_truck,25,362,640,33,360,253,2,387,286,LTAdatasets/2702/annotate/2702-2021_03_20_092143.jpg,374.5,269.5,0.58515625,0.7486111111111111,0.0390625,0.09166666666666666
2702-2021_03_20_092143.jpg,lorry_truck,23,309,640,21,360,219,2,332,240,LTAdatasets/2702/annotate/2702-2021_03_20_092143.jpg,320.5,229.5,0.50078125,0.6375,0.0359375,0.058333333333333334
2702-2021_03_20_092143.jpg,lorry_truck,24,236,640,29,360,253,2,260,282,LTAdatasets/2702/annotate/2702-2021_03_20_092143.jpg,248.0,267.5,0.3875,0.7430555555555556,0.0375,0.08055555555555556
2702-2021_03_20_092143.jpg,lorry_truck,14,204,640,16,360,161,2,218,177,LTAdatasets/2702/annotate/2702-2021_03_20_092143.jpg,211.0,169.0,0.3296875,0.46944444444444444,0.021875,0.044444444444444446
2702-2021_03_20_075138.jpg,lorry_truck,13,211,640,20,360,174,2,224,194,LTAdatasets/2702/annotate/2702-2021_03_20_075138.jpg,217.5,184.0,0.33984375,0.5111111111111111,0.0203125,0.05555555555555555
2702-2021_03_20_075138.jpg,van,12,220,640,14,360,186,3,232,200,LTAdatasets/2702/annotate/2702-2021_03_20_075138.jpg,226.0,193.0,0.353125,0.5361111111111111,0.01875,0.03888888888888889
2702-2021_03_20_075138.jpg,lorry_truck,12,266,640,19,360,189,2,278,208,LTAdatasets/2702/annotate/2702-2021_03_20_075138.jpg,272.0,198.5,0.425,0.5513888888888889,0.01875,0.05277777777777778
2702-2021_03_20_075138.jpg,lorry_truck,17,250,640,23,360,184,2,267,207,LTAdatasets/2702/annotate/2702-2021_03_20_075138.jpg,258.5,195.5,0.40390625,0.5430555555555555,0.0265625,0.06388888888888888
2702-2021_03_20_075138.jpg,lorry_truck,12,201,640,20,360,144,2,213,164,LTAdatasets/2702/annotate/2702-2021_03_20_075138.jpg,207.0,154.0,0.3234375,0.42777777777777776,0.01875,0.05555555555555555
2702-2021_03_20_075138.jpg,lorry_truck,25,255,640,30,360,220,2,280,250,LTAdatasets/2702/annotate/2702-2021_03_20_075138.jpg,267.5,235.0,0.41796875,0.6527777777777778,0.0390625,0.08333333333333333
2702-2021_03_20_075138.jpg,bike,10,295,640,15,360,209,4,305,224,LTAdatasets/2702/annotate/2702-2021_03_20_075138.jpg,300.0,216.5,0.46875,0.6013888888888889,0.015625,0.041666666666666664
2702-2021_03_20_185453.jpg,lorry_truck,16,223,640,16,360,183,2,239,199,LTAdatasets/2702/annotate/2702-2021_03_20_185453.jpg,231.0,191.0,0.3609375,0.5305555555555556,0.025,0.044444444444444446
2702-2021_03_20_185453.jpg,car,10,204,640,11,360,173,1,214,184,LTAdatasets/2702/annotate/2702-2021_03_20_185453.jpg,209.0,178.5,0.3265625,0.49583333333333335,0.015625,0.030555555555555555
2702-2021_03_20_082220.jpg,lorry_truck,23,287,640,33,360,303,2,310,336,LTAdatasets/2702/annotate/2702-2021_03_20_082220.jpg,298.5,319.5,0.46640625,0.8875,0.0359375,0.09166666666666666
2702-2021_03_20_082220.jpg,lorry_truck,32,285,640,33,360,262,2,317,295,LTAdatasets/2702/annotate/2702-2021_03_20_082220.jpg,301.0,278.5,0.4703125,0.7736111111111111,0.05,0.09166666666666666
2702-2021_03_20_082220.jpg,lorry_truck,24,230,640,27,360,240,2,254,267,LTAdatasets/2702/annotate/2702-2021_03_20_082220.jpg,242.0,253.5,0.378125,0.7041666666666667,0.0375,0.075
2702-2021_03_20_082220.jpg,lorry_truck,16,228,640,22,360,184,2,244,206,LTAdatasets/2702/annotate/2702-2021_03_20_082220.jpg,236.0,195.0,0.36875,0.5416666666666666,0.025,0.06111111111111111
2702-2021_03_20_200637.jpg,car,13,222,640,12,360,191,1,235,203,LTAdatasets/2702/annotate/2702-2021_03_20_200637.jpg,228.5,197.0,0.35703125,0.5472222222222223,0.0203125,0.03333333333333333
2702-2021_03_20_200637.jpg,car,14,207,640,14,360,168,1,221,182,LTAdatasets/2702/annotate/2702-2021_03_20_200637.jpg,214.0,175.0,0.334375,0.4861111111111111,0.021875,0.03888888888888889
2702-2021_03_20_200637.jpg,car,12,208,640,12,360,189,1,220,201,LTAdatasets/2702/annotate/2702-2021_03_20_200637.jpg,214.0,195.0,0.334375,0.5416666666666666,0.01875,0.03333333333333333
2702-2021_03_20_200637.jpg,car,8,221,640,6,360,185,1,229,191,LTAdatasets/2702/annotate/2702-2021_03_20_200637.jpg,225.0,188.0,0.3515625,0.5222222222222223,0.0125,0.016666666666666666
2702-2021_03_20_073717.jpg,lorry_truck,17,218,640,15,360,186,2,235,201,LTAdatasets/2702/annotate/2702-2021_03_20_073717.jpg,226.5,193.5,0.35390625,0.5375,0.0265625,0.041666666666666664
2702-2021_03_20_073717.jpg,lorry_truck,22,218,640,18,360,163,2,240,181,LTAdatasets/2702/annotate/2702-2021_03_20_073717.jpg,229.0,172.0,0.3578125,0.4777777777777778,0.034375,0.05
2702-2021_03_20_073717.jpg,car,14,208,640,16,360,176,1,222,192,LTAdatasets/2702/annotate/2702-2021_03_20_073717.jpg,215.0,184.0,0.3359375,0.5111111111111111,0.021875,0.044444444444444446
2702-2021_03_20_080719.jpg,lorry_truck,26,273,640,36,360,277,2,299,313,LTAdatasets/2702/annotate/2702-2021_03_20_080719.jpg,286.0,295.0,0.446875,0.8194444444444444,0.040625,0.1
2702-2021_03_20_080719.jpg,lorry_truck,27,214,640,27,360,210,2,241,237,LTAdatasets/2702/annotate/2702-2021_03_20_080719.jpg,227.5,223.5,0.35546875,0.6208333333333333,0.0421875,0.075
2702-2021_03_20_080719.jpg,bus,17,218,640,16,360,183,5,235,199,LTAdatasets/2702/annotate/2702-2021_03_20_080719.jpg,226.5,191.0,0.35390625,0.5305555555555556,0.0265625,0.044444444444444446
2702-2021_03_20_080719.jpg,lorry_truck,17,252,640,24,360,179,2,269,203,LTAdatasets/2702/annotate/2702-2021_03_20_080719.jpg,260.5,191.0,0.40703125,0.5305555555555556,0.0265625,0.06666666666666667
2702-2021_03_20_080719.jpg,car,12,201,640,10,360,174,1,213,184,LTAdatasets/2702/annotate/2702-2021_03_20_080719.jpg,207.0,179.0,0.3234375,0.49722222222222223,0.01875,0.027777777777777776
2702-2021_03_20_182451.jpg,bus,16,268,640,19,360,243,5,284,262,LTAdatasets/2702/annotate/2702-2021_03_20_182451.jpg,276.0,252.5,0.43125,0.7013888888888888,0.025,0.05277777777777778
2702-2021_03_20_182451.jpg,lorry_truck,29,361,640,32,360,252,2,390,284,LTAdatasets/2702/annotate/2702-2021_03_20_182451.jpg,375.5,268.0,0.58671875,0.7444444444444445,0.0453125,0.08888888888888889
2702-2021_03_20_182451.jpg,lorry_truck,12,221,640,18,360,182,2,233,200,LTAdatasets/2702/annotate/2702-2021_03_20_182451.jpg,227.0,191.0,0.3546875,0.5305555555555556,0.01875,0.05
2702-2021_03_20_182451.jpg,car,14,244,640,11,360,202,1,258,213,LTAdatasets/2702/annotate/2702-2021_03_20_182451.jpg,251.0,207.5,0.3921875,0.5763888888888888,0.021875,0.030555555555555555
2702-2021_03_20_182451.jpg,car,15,282,640,15,360,199,1,297,214,LTAdatasets/2702/annotate/2702-2021_03_20_182451.jpg,289.5,206.5,0.45234375,0.5736111111111111,0.0234375,0.041666666666666664
2702-2021_03_20_182451.jpg,lorry_truck,35,302,640,19,360,195,2,337,214,LTAdatasets/2702/annotate/2702-2021_03_20_182451.jpg,319.5,204.5,0.49921875,0.5680555555555555,0.0546875,0.05277777777777778
2702-2021_03_20_182451.jpg,car,12,215,640,9,360,169,1,227,178,LTAdatasets/2702/annotate/2702-2021_03_20_182451.jpg,221.0,173.5,0.3453125,0.48194444444444445,0.01875,0.025
2702-2021_03_20_182451.jpg,car,12,203,640,8,360,170,1,215,178,LTAdatasets/2702/annotate/2702-2021_03_20_182451.jpg,209.0,174.0,0.3265625,0.48333333333333334,0.01875,0.022222222222222223
2702-2021_03_20_182451.jpg,lorry_truck,32,165,640,21,360,159,2,197,180,LTAdatasets/2702/annotate/2702-2021_03_20_182451.jpg,181.0,169.5,0.2828125,0.4708333333333333,0.05,0.058333333333333334
2702-2021_03_20_193115.jpg,car,11,229,640,13,360,192,1,240,205,LTAdatasets/2702/annotate/2702-2021_03_20_193115.jpg,234.5,198.5,0.36640625,0.5513888888888889,0.0171875,0.03611111111111111
2702-2021_03_20_193115.jpg,car,9,207,640,9,360,191,1,216,200,LTAdatasets/2702/annotate/2702-2021_03_20_193115.jpg,211.5,195.5,0.33046875,0.5430555555555555,0.0140625,0.025
2702-2021_03_20_193115.jpg,car,16,207,640,14,360,174,1,223,188,LTAdatasets/2702/annotate/2702-2021_03_20_193115.jpg,215.0,181.0,0.3359375,0.5027777777777778,0.025,0.03888888888888889
2702-2021_03_20_080419.jpg,lorry_truck,26,252,640,28,360,245,2,278,273,LTAdatasets/2702/annotate/2702-2021_03_20_080419.jpg,265.0,259.0,0.4140625,0.7194444444444444,0.040625,0.07777777777777778
2702-2021_03_20_080419.jpg,car,9,207,640,11,360,170,1,216,181,LTAdatasets/2702/annotate/2702-2021_03_20_080419.jpg,211.5,175.5,0.33046875,0.4875,0.0140625,0.030555555555555555
2702-2021_03_20_093724.jpg,lorry_truck,12,206,640,18,360,157,2,218,175,LTAdatasets/2702/annotate/2702-2021_03_20_093724.jpg,212.0,166.0,0.33125,0.46111111111111114,0.01875,0.05
2702-2021_03_20_100405.jpg,lorry_truck,18,218,640,23,360,175,2,236,198,LTAdatasets/2702/annotate/2702-2021_03_20_100405.jpg,227.0,186.5,0.3546875,0.5180555555555556,0.028125,0.06388888888888888
2702-2021_03_20_090702.jpg,lorry_truck,37,383,640,44,360,277,2,420,321,LTAdatasets/2702/annotate/2702-2021_03_20_090702.jpg,401.5,299.0,0.62734375,0.8305555555555556,0.0578125,0.12222222222222222
2702-2021_03_20_090702.jpg,lorry_truck,14,216,640,17,360,176,2,230,193,LTAdatasets/2702/annotate/2702-2021_03_20_090702.jpg,223.0,184.5,0.3484375,0.5125,0.021875,0.04722222222222222
2702-2021_03_20_090702.jpg,car,12,223,640,10,360,192,1,235,202,LTAdatasets/2702/annotate/2702-2021_03_20_090702.jpg,229.0,197.0,0.3578125,0.5472222222222223,0.01875,0.027777777777777776
2702-2021_03_20_090702.jpg,lorry_truck,20,275,640,22,360,201,2,295,223,LTAdatasets/2702/annotate/2702-2021_03_20_090702.jpg,285.0,212.0,0.4453125,0.5888888888888889,0.03125,0.06111111111111111
2702-2021_03_20_090702.jpg,lorry_truck,13,202,640,20,360,159,2,215,179,LTAdatasets/2702/annotate/2702-2021_03_20_090702.jpg,208.5,169.0,0.32578125,0.46944444444444444,0.0203125,0.05555555555555555
2702-2021_03_20_180110.jpg,lorry_truck,19,255,640,17,360,189,2,274,206,LTAdatasets/2702/annotate/2702-2021_03_20_180110.jpg,264.5,197.5,0.41328125,0.5486111111111112,0.0296875,0.04722222222222222
2702-2021_03_20_180110.jpg,lorry_truck,11,205,640,14,360,155,2,216,169,LTAdatasets/2702/annotate/2702-2021_03_20_180110.jpg,210.5,162.0,0.32890625,0.45,0.0171875,0.03888888888888889
2702-2021_03_20_180110.jpg,car,11,226,640,11,360,189,1,237,200,LTAdatasets/2702/annotate/2702-2021_03_20_180110.jpg,231.5,194.5,0.36171875,0.5402777777777777,0.0171875,0.030555555555555555
2702-2021_03_20_180110.jpg,car,8,212,640,14,360,186,1,220,200,LTAdatasets/2702/annotate/2702-2021_03_20_180110.jpg,216.0,193.0,0.3375,0.5361111111111111,0.0125,0.03888888888888889
2702-2021_03_20_180110.jpg,lorry_truck,20,204,640,14,360,176,2,224,190,LTAdatasets/2702/annotate/2702-2021_03_20_180110.jpg,214.0,183.0,0.334375,0.5083333333333333,0.03125,0.03888888888888889
2702-2021_03_20_184913.jpg,lorry_truck,15,208,640,16,360,184,2,223,200,LTAdatasets/2702/annotate/2702-2021_03_20_184913.jpg,215.5,192.0,0.33671875,0.5333333333333333,0.0234375,0.044444444444444446
2702-2021_03_20_184913.jpg,lorry_truck,13,204,640,16,360,162,2,217,178,LTAdatasets/2702/annotate/2702-2021_03_20_184913.jpg,210.5,170.0,0.32890625,0.4722222222222222,0.0203125,0.044444444444444446
2702-2021_03_20_190113.jpg,lorry_truck,15,217,640,17,360,175,2,232,192,LTAdatasets/2702/annotate/2702-2021_03_20_190113.jpg,224.5,183.5,0.35078125,0.5097222222222222,0.0234375,0.04722222222222222
2702-2021_03_20_190113.jpg,car,11,203,640,16,360,169,1,214,185,LTAdatasets/2702/annotate/2702-2021_03_20_190113.jpg,208.5,177.0,0.32578125,0.49166666666666664,0.0171875,0.044444444444444446
2702-2021_03_20_190113.jpg,car,9,211,640,8,360,195,1,220,203,LTAdatasets/2702/annotate/2702-2021_03_20_190113.jpg,215.5,199.0,0.33671875,0.5527777777777778,0.0140625,0.022222222222222223
2702-2021_03_20_190113.jpg,car,12,200,640,10,360,155,1,212,165,LTAdatasets/2702/annotate/2702-2021_03_20_190113.jpg,206.0,160.0,0.321875,0.4444444444444444,0.01875,0.027777777777777776
2702-2021_03_20_202437.jpg,car,13,204,640,12,360,156,1,217,168,LTAdatasets/2702/annotate/2702-2021_03_20_202437.jpg,210.5,162.0,0.32890625,0.45,0.0203125,0.03333333333333333
2702-2021_03_20_202437.jpg,car,12,198,640,11,360,143,1,210,154,LTAdatasets/2702/annotate/2702-2021_03_20_202437.jpg,204.0,148.5,0.31875,0.4125,0.01875,0.030555555555555555
2702-2021_03_20_201317.jpg,lorry_truck,12,214,640,16,360,177,2,226,193,LTAdatasets/2702/annotate/2702-2021_03_20_201317.jpg,220.0,185.0,0.34375,0.5138888888888888,0.01875,0.044444444444444446
2702-2021_03_20_201317.jpg,lorry_truck,16,223,640,20,360,188,2,239,208,LTAdatasets/2702/annotate/2702-2021_03_20_201317.jpg,231.0,198.0,0.3609375,0.55,0.025,0.05555555555555555
2702-2021_03_20_201317.jpg,lorry_truck,9,206,640,14,360,155,2,215,169,LTAdatasets/2702/annotate/2702-2021_03_20_201317.jpg,210.5,162.0,0.32890625,0.45,0.0140625,0.03888888888888889
2702-2021_03_20_192515.jpg,lorry_truck,16,240,640,21,360,246,2,256,267,LTAdatasets/2702/annotate/2702-2021_03_20_192515.jpg,248.0,256.5,0.3875,0.7125,0.025,0.058333333333333334
2702-2021_03_20_192515.jpg,lorry_truck,21,263,640,24,360,252,2,284,276,LTAdatasets/2702/annotate/2702-2021_03_20_192515.jpg,273.5,264.0,0.42734375,0.7333333333333333,0.0328125,0.06666666666666667
2702-2021_03_20_192515.jpg,bus,14,224,640,16,360,184,5,238,200,LTAdatasets/2702/annotate/2702-2021_03_20_192515.jpg,231.0,192.0,0.3609375,0.5333333333333333,0.021875,0.044444444444444446
2702-2021_03_20_192515.jpg,car,11,211,640,10,360,192,1,222,202,LTAdatasets/2702/annotate/2702-2021_03_20_192515.jpg,216.5,197.0,0.33828125,0.5472222222222223,0.0171875,0.027777777777777776
2702-2021_03_20_192515.jpg,car,12,206,640,9,360,187,1,218,196,LTAdatasets/2702/annotate/2702-2021_03_20_192515.jpg,212.0,191.5,0.33125,0.5319444444444444,0.01875,0.025
2702-2021_03_20_181011.jpg,van,14,237,640,11,360,188,3,251,199,LTAdatasets/2702/annotate/2702-2021_03_20_181011.jpg,244.0,193.5,0.38125,0.5375,0.021875,0.030555555555555555
2702-2021_03_20_181011.jpg,car,10,213,640,10,360,191,1,223,201,LTAdatasets/2702/annotate/2702-2021_03_20_181011.jpg,218.0,196.0,0.340625,0.5444444444444444,0.015625,0.027777777777777776
2702-2021_03_20_181011.jpg,lorry_truck,11,223,640,21,360,179,2,234,200,LTAdatasets/2702/annotate/2702-2021_03_20_181011.jpg,228.5,189.5,0.35703125,0.5263888888888889,0.0171875,0.058333333333333334
2702-2021_03_20_181011.jpg,car,8,206,640,8,360,170,1,214,178,LTAdatasets/2702/annotate/2702-2021_03_20_181011.jpg,210.0,174.0,0.328125,0.48333333333333334,0.0125,0.022222222222222223
2702-2021_03_20_181011.jpg,car,15,204,640,8,360,160,1,219,168,LTAdatasets/2702/annotate/2702-2021_03_20_181011.jpg,211.5,164.0,0.33046875,0.45555555555555555,0.0234375,0.022222222222222223
2702-2021_03_20_181011.jpg,car,10,196,640,13,360,142,1,206,155,LTAdatasets/2702/annotate/2702-2021_03_20_181011.jpg,201.0,148.5,0.3140625,0.4125,0.015625,0.03611111111111111
2702-2021_03_20_091002.jpg,car,11,221,640,12,360,189,1,232,201,LTAdatasets/2702/annotate/2702-2021_03_20_091002.jpg,226.5,195.0,0.35390625,0.5416666666666666,0.0171875,0.03333333333333333
2702-2021_03_20_091002.jpg,van,7,219,640,10,360,181,3,226,191,LTAdatasets/2702/annotate/2702-2021_03_20_091002.jpg,222.5,186.0,0.34765625,0.5166666666666667,0.0109375,0.027777777777777776
2702-2021_03_20_192735.jpg,lorry_truck,14,228,640,19,360,188,2,242,207,LTAdatasets/2702/annotate/2702-2021_03_20_192735.jpg,235.0,197.5,0.3671875,0.5486111111111112,0.021875,0.05277777777777778
2702-2021_03_20_192735.jpg,car,15,211,640,10,360,202,1,226,212,LTAdatasets/2702/annotate/2702-2021_03_20_192735.jpg,218.5,207.0,0.34140625,0.575,0.0234375,0.027777777777777776
2702-2021_03_20_192735.jpg,car,16,201,640,7,360,194,1,217,201,LTAdatasets/2702/annotate/2702-2021_03_20_192735.jpg,209.0,197.5,0.3265625,0.5486111111111112,0.025,0.019444444444444445
2702-2021_03_20_192735.jpg,car,16,214,640,8,360,179,1,230,187,LTAdatasets/2702/annotate/2702-2021_03_20_192735.jpg,222.0,183.0,0.346875,0.5083333333333333,0.025,0.022222222222222223
2702-2021_03_20_192735.jpg,car,15,201,640,11,360,181,1,216,192,LTAdatasets/2702/annotate/2702-2021_03_20_192735.jpg,208.5,186.5,0.32578125,0.5180555555555556,0.0234375,0.030555555555555555
2702-2021_03_20_192735.jpg,car,13,203,640,8,360,165,1,216,173,LTAdatasets/2702/annotate/2702-2021_03_20_192735.jpg,209.5,169.0,0.32734375,0.46944444444444444,0.0203125,0.022222222222222223
2702-2021_03_20_192735.jpg,car,14,201,640,13,360,151,1,215,164,LTAdatasets/2702/annotate/2702-2021_03_20_192735.jpg,208.0,157.5,0.325,0.4375,0.021875,0.03611111111111111
2702-2021_03_20_192735.jpg,car,11,199,640,12,360,142,1,210,154,LTAdatasets/2702/annotate/2702-2021_03_20_192735.jpg,204.5,148.0,0.31953125,0.4111111111111111,0.0171875,0.03333333333333333
2702-2021_03_20_073417.jpg,lorry_truck,17,241,640,22,360,161,2,258,183,LTAdatasets/2702/annotate/2702-2021_03_20_073417.jpg,249.5,172.0,0.38984375,0.4777777777777778,0.0265625,0.06111111111111111
2702-2021_03_20_073417.jpg,car,12,223,640,10,360,192,1,235,202,LTAdatasets/2702/annotate/2702-2021_03_20_073417.jpg,229.0,197.0,0.3578125,0.5472222222222223,0.01875,0.027777777777777776
2702-2021_03_20_073417.jpg,car,11,205,640,12,360,179,1,216,191,LTAdatasets/2702/annotate/2702-2021_03_20_073417.jpg,210.5,185.0,0.32890625,0.5138888888888888,0.0171875,0.03333333333333333
2702-2021_03_20_180710.jpg,lorry_truck,16,248,640,18,360,197,2,264,215,LTAdatasets/2702/annotate/2702-2021_03_20_180710.jpg,256.0,206.0,0.4,0.5722222222222222,0.025,0.05
2702-2021_03_20_180710.jpg,van,21,252,640,18,360,177,3,273,195,LTAdatasets/2702/annotate/2702-2021_03_20_180710.jpg,262.5,186.0,0.41015625,0.5166666666666667,0.0328125,0.05
2702-2021_03_20_180710.jpg,lorry_truck,17,232,640,21,360,157,2,249,178,LTAdatasets/2702/annotate/2702-2021_03_20_180710.jpg,240.5,167.5,0.37578125,0.4652777777777778,0.0265625,0.058333333333333334
2702-2021_03_20_180710.jpg,lorry_truck,12,219,640,14,360,147,2,231,161,LTAdatasets/2702/annotate/2702-2021_03_20_180710.jpg,225.0,154.0,0.3515625,0.42777777777777776,0.01875,0.03888888888888889
2702-2021_03_20_180710.jpg,lorry_truck,20,220,640,15,360,176,2,240,191,LTAdatasets/2702/annotate/2702-2021_03_20_180710.jpg,230.0,183.5,0.359375,0.5097222222222222,0.03125,0.041666666666666664
2702-2021_03_20_180710.jpg,car,10,225,640,10,360,190,1,235,200,LTAdatasets/2702/annotate/2702-2021_03_20_180710.jpg,230.0,195.0,0.359375,0.5416666666666666,0.015625,0.027777777777777776
2702-2021_03_20_180710.jpg,car,11,210,640,14,360,191,1,221,205,LTAdatasets/2702/annotate/2702-2021_03_20_180710.jpg,215.5,198.0,0.33671875,0.55,0.0171875,0.03888888888888889
2702-2021_03_20_180710.jpg,car,13,205,640,12,360,171,1,218,183,LTAdatasets/2702/annotate/2702-2021_03_20_180710.jpg,211.5,177.0,0.33046875,0.49166666666666664,0.0203125,0.03333333333333333
2702-2021_03_20_180710.jpg,lorry_truck,12,206,640,15,360,156,2,218,171,LTAdatasets/2702/annotate/2702-2021_03_20_180710.jpg,212.0,163.5,0.33125,0.45416666666666666,0.01875,0.041666666666666664
2702-2021_03_20_203358.jpg,bus,18,202,640,18,360,161,5,220,179,LTAdatasets/2702/annotate/2702-2021_03_20_203358.jpg,211.0,170.0,0.3296875,0.4722222222222222,0.028125,0.05
2702-2021_03_20_203058.jpg,lorry_truck,23,199,640,22,360,157,2,222,179,LTAdatasets/2702/annotate/2702-2021_03_20_203058.jpg,210.5,168.0,0.32890625,0.4666666666666667,0.0359375,0.06111111111111111
2702-2021_03_20_190413.jpg,car,16,208,640,13,360,189,1,224,202,LTAdatasets/2702/annotate/2702-2021_03_20_190413.jpg,216.0,195.5,0.3375,0.5430555555555555,0.025,0.03611111111111111
2702-2021_03_20_190413.jpg,lorry_truck,12,226,640,21,360,183,2,238,204,LTAdatasets/2702/annotate/2702-2021_03_20_190413.jpg,232.0,193.5,0.3625,0.5375,0.01875,0.058333333333333334
2702-2021_03_20_084901.jpg,lorry_truck,16,370,640,29,360,261,2,386,290,LTAdatasets/2702/annotate/2702-2021_03_20_084901.jpg,378.0,275.5,0.590625,0.7652777777777777,0.025,0.08055555555555556
2702-2021_03_20_084901.jpg,lorry_truck,15,342,640,22,360,239,2,357,261,LTAdatasets/2702/annotate/2702-2021_03_20_084901.jpg,349.5,250.0,0.54609375,0.6944444444444444,0.0234375,0.06111111111111111
2702-2021_03_20_084901.jpg,lorry_truck,18,324,640,21,360,226,2,342,247,LTAdatasets/2702/annotate/2702-2021_03_20_084901.jpg,333.0,236.5,0.5203125,0.6569444444444444,0.028125,0.058333333333333334
2702-2021_03_20_084901.jpg,van,16,224,640,15,360,191,3,240,206,LTAdatasets/2702/annotate/2702-2021_03_20_084901.jpg,232.0,198.5,0.3625,0.5513888888888889,0.025,0.041666666666666664
2702-2021_03_20_185753.jpg,lorry_truck,28,266,640,25,360,237,2,294,262,LTAdatasets/2702/annotate/2702-2021_03_20_185753.jpg,280.0,249.5,0.4375,0.6930555555555555,0.04375,0.06944444444444445
2702-2021_03_20_185753.jpg,van,14,222,640,9,360,191,3,236,200,LTAdatasets/2702/annotate/2702-2021_03_20_185753.jpg,229.0,195.5,0.3578125,0.5430555555555555,0.021875,0.025
2702-2021_03_20_185753.jpg,lorry_truck,16,205,640,17,360,161,2,221,178,LTAdatasets/2702/annotate/2702-2021_03_20_185753.jpg,213.0,169.5,0.3328125,0.4708333333333333,0.025,0.04722222222222222
2702-2021_03_20_090402.jpg,bike,15,305,640,9,360,214,4,320,223,LTAdatasets/2702/annotate/2702-2021_03_20_090402.jpg,312.5,218.5,0.48828125,0.6069444444444444,0.0234375,0.025
2702-2021_03_20_100105.jpg,lorry_truck,18,234,640,22,360,181,2,252,203,LTAdatasets/2702/annotate/2702-2021_03_20_100105.jpg,243.0,192.0,0.3796875,0.5333333333333333,0.028125,0.06111111111111111
2702-2021_03_20_100105.jpg,lorry_truck,19,248,640,27,360,171,2,267,198,LTAdatasets/2702/annotate/2702-2021_03_20_100105.jpg,257.5,184.5,0.40234375,0.5125,0.0296875,0.075
2702-2021_03_20_095505.jpg,van,17,224,640,11,360,195,3,241,206,LTAdatasets/2702/annotate/2702-2021_03_20_095505.jpg,232.5,200.5,0.36328125,0.5569444444444445,0.0265625,0.030555555555555555
2702-2021_03_20_095505.jpg,lorry_truck,11,222,640,16,360,175,2,233,191,LTAdatasets/2702/annotate/2702-2021_03_20_095505.jpg,227.5,183.0,0.35546875,0.5083333333333333,0.0171875,0.044444444444444446
2702-2021_03_20_095505.jpg,lorry_truck,16,200,640,10,360,146,2,216,156,LTAdatasets/2702/annotate/2702-2021_03_20_095505.jpg,208.0,151.0,0.325,0.41944444444444445,0.025,0.027777777777777776
2702-2021_03_20_095505.jpg,lorry_truck,13,205,640,9,360,162,2,218,171,LTAdatasets/2702/annotate/2702-2021_03_20_095505.jpg,211.5,166.5,0.33046875,0.4625,0.0203125,0.025
2702-2021_03_20_191234.jpg,bus,48,232,640,21,360,170,5,280,191,LTAdatasets/2702/annotate/2702-2021_03_20_191234.jpg,256.0,180.5,0.4,0.5013888888888889,0.075,0.058333333333333334
2702-2021_03_20_191234.jpg,car,6,226,640,9,360,190,1,232,199,LTAdatasets/2702/annotate/2702-2021_03_20_191234.jpg,229.0,194.5,0.3578125,0.5402777777777777,0.009375,0.025
2702-2021_03_20_191234.jpg,car,22,224,640,8,360,207,1,246,215,LTAdatasets/2702/annotate/2702-2021_03_20_191234.jpg,235.0,211.0,0.3671875,0.5861111111111111,0.034375,0.022222222222222223
2702-2021_03_20_191614.jpg,lorry_truck,31,239,640,22,360,169,2,270,191,LTAdatasets/2702/annotate/2702-2021_03_20_191614.jpg,254.5,180.0,0.39765625,0.5,0.0484375,0.06111111111111111
2702-2021_03_20_191614.jpg,car,13,208,640,12,360,169,1,221,181,LTAdatasets/2702/annotate/2702-2021_03_20_191614.jpg,214.5,175.0,0.33515625,0.4861111111111111,0.0203125,0.03333333333333333
2702-2021_03_20_093103.jpg,car,12,248,640,12,360,186,1,260,198,LTAdatasets/2702/annotate/2702-2021_03_20_093103.jpg,254.0,192.0,0.396875,0.5333333333333333,0.01875,0.03333333333333333
2702-2021_03_20_093103.jpg,lorry_truck,15,244,640,18,360,172,2,259,190,LTAdatasets/2702/annotate/2702-2021_03_20_093103.jpg,251.5,181.0,0.39296875,0.5027777777777778,0.0234375,0.05
2702-2021_03_20_093103.jpg,lorry_truck,17,230,640,18,360,160,2,247,178,LTAdatasets/2702/annotate/2702-2021_03_20_093103.jpg,238.5,169.0,0.37265625,0.46944444444444444,0.0265625,0.05
2702-2021_03_20_093103.jpg,lorry_truck,16,271,640,25,360,194,2,287,219,LTAdatasets/2702/annotate/2702-2021_03_20_093103.jpg,279.0,206.5,0.4359375,0.5736111111111111,0.025,0.06944444444444445
2702-2021_03_20_203658.jpg,car,12,219,640,10,360,185,1,231,195,LTAdatasets/2702/annotate/2702-2021_03_20_203658.jpg,225.0,190.0,0.3515625,0.5277777777777778,0.01875,0.027777777777777776
2702-2021_03_20_203658.jpg,car,13,207,640,11,360,176,1,220,187,LTAdatasets/2702/annotate/2702-2021_03_20_203658.jpg,213.5,181.5,0.33359375,0.5041666666666667,0.0203125,0.030555555555555555
2702-2021_03_20_203658.jpg,van,12,206,640,11,360,161,3,218,172,LTAdatasets/2702/annotate/2702-2021_03_20_203658.jpg,212.0,166.5,0.33125,0.4625,0.01875,0.030555555555555555
2702-2021_03_20_085822.jpg,van,15,338,640,17,360,242,3,353,259,LTAdatasets/2702/annotate/2702-2021_03_20_085822.jpg,345.5,250.5,0.53984375,0.6958333333333333,0.0234375,0.04722222222222222
2702-2021_03_20_184613.jpg,lorry_truck,13,223,640,18,360,184,2,236,202,LTAdatasets/2702/annotate/2702-2021_03_20_184613.jpg,229.5,193.0,0.35859375,0.5361111111111111,0.0203125,0.05
2702-2021_03_20_184613.jpg,car,18,207,640,11,360,190,1,225,201,LTAdatasets/2702/annotate/2702-2021_03_20_184613.jpg,216.0,195.5,0.3375,0.5430555555555555,0.028125,0.030555555555555555
2702-2021_03_20_184613.jpg,lorry_truck,10,207,640,10,360,169,2,217,179,LTAdatasets/2702/annotate/2702-2021_03_20_184613.jpg,212.0,174.0,0.33125,0.48333333333333334,0.015625,0.027777777777777776
2702-2021_03_20_184613.jpg,van,25,245,640,14,360,200,3,270,214,LTAdatasets/2702/annotate/2702-2021_03_20_184613.jpg,257.5,207.0,0.40234375,0.575,0.0390625,0.03888888888888889
2702-2021_03_20_200416.jpg,car,10,223,640,14,360,187,1,233,201,LTAdatasets/2702/annotate/2702-2021_03_20_200416.jpg,228.0,194.0,0.35625,0.5388888888888889,0.015625,0.03888888888888889
2702-2021_03_20_200416.jpg,car,12,207,640,9,360,188,1,219,197,LTAdatasets/2702/annotate/2702-2021_03_20_200416.jpg,213.0,192.5,0.3328125,0.5347222222222222,0.01875,0.025
2702-2021_03_20_200416.jpg,car,12,209,640,12,360,174,1,221,186,LTAdatasets/2702/annotate/2702-2021_03_20_200416.jpg,215.0,180.0,0.3359375,0.5,0.01875,0.03333333333333333
2702-2021_03_20_200416.jpg,car,8,210,640,12,360,155,1,218,167,LTAdatasets/2702/annotate/2702-2021_03_20_200416.jpg,214.0,161.0,0.334375,0.44722222222222224,0.0125,0.03333333333333333
2702-2021_03_20_193415.jpg,bike,12,117,640,14,360,289,4,129,303,LTAdatasets/2702/annotate/2702-2021_03_20_193415.jpg,123.0,296.0,0.1921875,0.8222222222222222,0.01875,0.03888888888888889
2702-2021_03_20_193415.jpg,car,15,205,640,16,360,164,1,220,180,LTAdatasets/2702/annotate/2702-2021_03_20_193415.jpg,212.5,172.0,0.33203125,0.4777777777777778,0.0234375,0.044444444444444446
2702-2021_03_20_193415.jpg,car,13,199,640,11,360,149,1,212,160,LTAdatasets/2702/annotate/2702-2021_03_20_193415.jpg,205.5,154.5,0.32109375,0.42916666666666664,0.0203125,0.030555555555555555
2702-2021_03_20_193635.jpg,lorry_truck,15,224,640,21,360,185,2,239,206,LTAdatasets/2702/annotate/2702-2021_03_20_193635.jpg,231.5,195.5,0.36171875,0.5430555555555555,0.0234375,0.058333333333333334
2702-2021_03_20_193635.jpg,car,10,204,640,13,360,175,1,214,188,LTAdatasets/2702/annotate/2702-2021_03_20_193635.jpg,209.0,181.5,0.3265625,0.5041666666666667,0.015625,0.03611111111111111
2702-2021_03_20_193635.jpg,car,13,204,640,16,360,163,1,217,179,LTAdatasets/2702/annotate/2702-2021_03_20_193635.jpg,210.5,171.0,0.32890625,0.475,0.0203125,0.044444444444444446
2702-2021_03_20_193635.jpg,car,9,216,640,14,360,173,1,225,187,LTAdatasets/2702/annotate/2702-2021_03_20_193635.jpg,220.5,180.0,0.34453125,0.5,0.0140625,0.03888888888888889
2702-2021_03_20_202758.jpg,car,19,245,640,14,360,169,1,264,183,LTAdatasets/2702/annotate/2702-2021_03_20_202758.jpg,254.5,176.0,0.39765625,0.4888888888888889,0.0296875,0.03888888888888889
2702-2021_03_20_202758.jpg,car,11,203,640,7,360,172,1,214,179,LTAdatasets/2702/annotate/2702-2021_03_20_202758.jpg,208.5,175.5,0.32578125,0.4875,0.0171875,0.019444444444444445
2702-2021_03_20_192214.jpg,car,10,224,640,12,360,190,1,234,202,LTAdatasets/2702/annotate/2702-2021_03_20_192214.jpg,229.0,196.0,0.3578125,0.5444444444444444,0.015625,0.03333333333333333
2702-2021_03_20_192214.jpg,car,10,207,640,10,360,188,1,217,198,LTAdatasets/2702/annotate/2702-2021_03_20_192214.jpg,212.0,193.0,0.33125,0.5361111111111111,0.015625,0.027777777777777776
2702-2021_03_20_192214.jpg,car,15,203,640,11,360,176,1,218,187,LTAdatasets/2702/annotate/2702-2021_03_20_192214.jpg,210.5,181.5,0.32890625,0.5041666666666667,0.0234375,0.030555555555555555
2702-2021_03_20_192214.jpg,bus,14,219,640,21,360,173,5,233,194,LTAdatasets/2702/annotate/2702-2021_03_20_192214.jpg,226.0,183.5,0.353125,0.5097222222222222,0.021875,0.058333333333333334
2702-2021_03_20_192214.jpg,lorry_truck,17,202,640,15,360,159,2,219,174,LTAdatasets/2702/annotate/2702-2021_03_20_192214.jpg,210.5,166.5,0.32890625,0.4625,0.0265625,0.041666666666666664
2702-2021_03_20_192214.jpg,lorry_truck,21,263,640,29,360,269,2,284,298,LTAdatasets/2702/annotate/2702-2021_03_20_192214.jpg,273.5,283.5,0.42734375,0.7875,0.0328125,0.08055555555555556
2702-2021_03_20_073937.jpg,lorry_truck,15,248,640,12,360,185,2,263,197,LTAdatasets/2702/annotate/2702-2021_03_20_073937.jpg,255.5,191.0,0.39921875,0.5305555555555556,0.0234375,0.03333333333333333
2702-2021_03_20_073937.jpg,lorry_truck,10,206,640,14,360,166,2,216,180,LTAdatasets/2702/annotate/2702-2021_03_20_073937.jpg,211.0,173.0,0.3296875,0.48055555555555557,0.015625,0.03888888888888889
2702-2021_03_20_091903.jpg,lorry_truck,32,340,640,34,360,236,2,372,270,LTAdatasets/2702/annotate/2702-2021_03_20_091903.jpg,356.0,253.0,0.55625,0.7027777777777777,0.05,0.09444444444444444
2702-2021_03_20_091903.jpg,lorry_truck,34,291,640,39,360,321,2,325,360,LTAdatasets/2702/annotate/2702-2021_03_20_091903.jpg,308.0,340.5,0.48125,0.9458333333333333,0.053125,0.10833333333333334
2702-2021_03_20_081319.jpg,lorry_truck,19,370,640,29,360,259,2,389,288,LTAdatasets/2702/annotate/2702-2021_03_20_081319.jpg,379.5,273.5,0.59296875,0.7597222222222222,0.0296875,0.08055555555555556
2702-2021_03_20_081319.jpg,lorry_truck,18,354,640,17,360,256,2,372,273,LTAdatasets/2702/annotate/2702-2021_03_20_081319.jpg,363.0,264.5,0.5671875,0.7347222222222223,0.028125,0.04722222222222222
2702-2021_03_20_081319.jpg,lorry_truck,24,279,640,30,360,250,2,303,280,LTAdatasets/2702/annotate/2702-2021_03_20_081319.jpg,291.0,265.0,0.4546875,0.7361111111111112,0.0375,0.08333333333333333
2702-2021_03_20_081319.jpg,lorry_truck,18,236,640,21,360,250,2,254,271,LTAdatasets/2702/annotate/2702-2021_03_20_081319.jpg,245.0,260.5,0.3828125,0.7236111111111111,0.028125,0.058333333333333334
2702-2021_03_20_081319.jpg,lorry_truck,14,221,640,14,360,186,2,235,200,LTAdatasets/2702/annotate/2702-2021_03_20_081319.jpg,228.0,193.0,0.35625,0.5361111111111111,0.021875,0.03888888888888889
2702-2021_03_20_081319.jpg,lorry_truck,12,208,640,12,360,191,2,220,203,LTAdatasets/2702/annotate/2702-2021_03_20_081319.jpg,214.0,197.0,0.334375,0.5472222222222223,0.01875,0.03333333333333333
2702-2021_03_20_094904.jpg,lorry_truck,27,304,640,24,360,336,2,331,360,LTAdatasets/2702/annotate/2702-2021_03_20_094904.jpg,317.5,348.0,0.49609375,0.9666666666666667,0.0421875,0.06666666666666667
2702-2021_03_20_094904.jpg,lorry_truck,19,230,640,18,360,162,2,249,180,LTAdatasets/2702/annotate/2702-2021_03_20_094904.jpg,239.5,171.0,0.37421875,0.475,0.0296875,0.05
2702-2021_03_20_094904.jpg,lorry_truck,19,221,640,21,360,147,2,240,168,LTAdatasets/2702/annotate/2702-2021_03_20_094904.jpg,230.5,157.5,0.36015625,0.4375,0.0296875,0.058333333333333334
2702-2021_03_20_094904.jpg,car,17,295,640,8,360,204,1,312,212,LTAdatasets/2702/annotate/2702-2021_03_20_094904.jpg,303.5,208.0,0.47421875,0.5777777777777777,0.0265625,0.022222222222222223
2702-2021_03_20_094904.jpg,lorry_truck,30,312,640,15,360,199,2,342,214,LTAdatasets/2702/annotate/2702-2021_03_20_094904.jpg,327.0,206.5,0.5109375,0.5736111111111111,0.046875,0.041666666666666664
2702-2021_03_20_094904.jpg,car,12,206,640,10,360,173,1,218,183,LTAdatasets/2702/annotate/2702-2021_03_20_094904.jpg,212.0,178.0,0.33125,0.49444444444444446,0.01875,0.027777777777777776
2702-2021_03_20_185153.jpg,lorry_truck,21,218,640,15,360,185,2,239,200,LTAdatasets/2702/annotate/2702-2021_03_20_185153.jpg,228.5,192.5,0.35703125,0.5347222222222222,0.0328125,0.041666666666666664
2702-2021_03_20_185153.jpg,lorry_truck,15,216,640,18,360,170,2,231,188,LTAdatasets/2702/annotate/2702-2021_03_20_185153.jpg,223.5,179.0,0.34921875,0.49722222222222223,0.0234375,0.05
2702-2021_03_20_185153.jpg,lorry_truck,21,214,640,16,360,206,2,235,222,LTAdatasets/2702/annotate/2702-2021_03_20_185153.jpg,224.5,214.0,0.35078125,0.5944444444444444,0.0328125,0.044444444444444446
2702-2021_03_20_191014.jpg,lorry_truck,16,226,640,25,360,214,2,242,239,LTAdatasets/2702/annotate/2702-2021_03_20_191014.jpg,234.0,226.5,0.365625,0.6291666666666667,0.025,0.06944444444444445
2702-2021_03_20_191014.jpg,lorry_truck,17,244,640,23,360,162,2,261,185,LTAdatasets/2702/annotate/2702-2021_03_20_191014.jpg,252.5,173.5,0.39453125,0.48194444444444445,0.0265625,0.06388888888888888
2702-2021_03_20_191014.jpg,car,16,216,640,15,360,185,1,232,200,LTAdatasets/2702/annotate/2702-2021_03_20_191014.jpg,224.0,192.5,0.35,0.5347222222222222,0.025,0.041666666666666664
2702-2021_03_20_084301.jpg,lorry_truck,15,248,640,18,360,182,2,263,200,LTAdatasets/2702/annotate/2702-2021_03_20_084301.jpg,255.5,191.0,0.39921875,0.5305555555555556,0.0234375,0.05
2702-2021_03_20_084301.jpg,lorry_truck,22,216,640,22,360,178,2,238,200,LTAdatasets/2702/annotate/2702-2021_03_20_084301.jpg,227.0,189.0,0.3546875,0.525,0.034375,0.06111111111111111
2702-2021_03_20_083340.jpg,van,18,410,640,17,360,321,3,428,338,LTAdatasets/2702/annotate/2702-2021_03_20_083340.jpg,419.0,329.5,0.6546875,0.9152777777777777,0.028125,0.04722222222222222
2702-2021_03_20_083340.jpg,lorry_truck,35,290,640,49,360,311,2,325,360,LTAdatasets/2702/annotate/2702-2021_03_20_083340.jpg,307.5,335.5,0.48046875,0.9319444444444445,0.0546875,0.1361111111111111
2702-2021_03_20_201617.jpg,van,21,276,640,17,360,201,3,297,218,LTAdatasets/2702/annotate/2702-2021_03_20_201617.jpg,286.5,209.5,0.44765625,0.5819444444444445,0.0328125,0.04722222222222222
2702-2021_03_20_201617.jpg,car,12,221,640,7,360,191,1,233,198,LTAdatasets/2702/annotate/2702-2021_03_20_201617.jpg,227.0,194.5,0.3546875,0.5402777777777777,0.01875,0.019444444444444445
2702-2021_03_20_201617.jpg,car,18,199,640,12,360,148,1,217,160,LTAdatasets/2702/annotate/2702-2021_03_20_201617.jpg,208.0,154.0,0.325,0.42777777777777776,0.028125,0.03333333333333333
2702-2021_03_20_181851.jpg,lorry_truck,17,330,640,21,360,235,2,347,256,LTAdatasets/2702/annotate/2702-2021_03_20_181851.jpg,338.5,245.5,0.52890625,0.6819444444444445,0.0265625,0.058333333333333334
2702-2021_03_20_181851.jpg,lorry_truck,18,310,640,18,360,222,2,328,240,LTAdatasets/2702/annotate/2702-2021_03_20_181851.jpg,319.0,231.0,0.4984375,0.6416666666666667,0.028125,0.05
2702-2021_03_20_181851.jpg,car,12,219,640,8,360,188,1,231,196,LTAdatasets/2702/annotate/2702-2021_03_20_181851.jpg,225.0,192.0,0.3515625,0.5333333333333333,0.01875,0.022222222222222223
2702-2021_03_20_181851.jpg,car,9,212,640,10,360,180,1,221,190,LTAdatasets/2702/annotate/2702-2021_03_20_181851.jpg,216.5,185.0,0.33828125,0.5138888888888888,0.0140625,0.027777777777777776
2702-2021_03_20_181851.jpg,car,12,205,640,6,360,173,1,217,179,LTAdatasets/2702/annotate/2702-2021_03_20_181851.jpg,211.0,176.0,0.3296875,0.4888888888888889,0.01875,0.016666666666666666
2702-2021_03_20_181851.jpg,car,8,210,640,7,360,164,1,218,171,LTAdatasets/2702/annotate/2702-2021_03_20_181851.jpg,214.0,167.5,0.334375,0.4652777777777778,0.0125,0.019444444444444445
2702-2021_03_20_075818.jpg,car,23,236,640,16,360,200,1,259,216,LTAdatasets/2702/annotate/2702-2021_03_20_075818.jpg,247.5,208.0,0.38671875,0.5777777777777777,0.0359375,0.044444444444444446
2702-2021_03_20_075818.jpg,bus,12,234,640,21,360,178,5,246,199,LTAdatasets/2702/annotate/2702-2021_03_20_075818.jpg,240.0,188.5,0.375,0.5236111111111111,0.01875,0.058333333333333334
2702-2021_03_20_075818.jpg,bus,19,199,640,20,360,159,5,218,179,LTAdatasets/2702/annotate/2702-2021_03_20_075818.jpg,208.5,169.0,0.32578125,0.46944444444444444,0.0296875,0.05555555555555555
2702-2021_03_20_080939.jpg,lorry_truck,17,235,640,29,360,206,2,252,235,LTAdatasets/2702/annotate/2702-2021_03_20_080939.jpg,243.5,220.5,0.38046875,0.6125,0.0265625,0.08055555555555556
2702-2021_03_20_080939.jpg,lorry_truck,16,255,640,19,360,183,2,271,202,LTAdatasets/2702/annotate/2702-2021_03_20_080939.jpg,263.0,192.5,0.4109375,0.5347222222222222,0.025,0.05277777777777778
2702-2021_03_20_080939.jpg,lorry_truck,14,236,640,23,360,165,2,250,188,LTAdatasets/2702/annotate/2702-2021_03_20_080939.jpg,243.0,176.5,0.3796875,0.49027777777777776,0.021875,0.06388888888888888
2702-2021_03_20_080939.jpg,van,9,204,640,12,360,160,3,213,172,LTAdatasets/2702/annotate/2702-2021_03_20_080939.jpg,208.5,166.0,0.32578125,0.46111111111111114,0.0140625,0.03333333333333333
2702-2021_03_20_080939.jpg,van,16,278,640,10,360,210,3,294,220,LTAdatasets/2702/annotate/2702-2021_03_20_080939.jpg,286.0,215.0,0.446875,0.5972222222222222,0.025,0.027777777777777776
2702-2021_03_20_090102.jpg,bike,11,351,640,11,360,256,4,362,267,LTAdatasets/2702/annotate/2702-2021_03_20_090102.jpg,356.5,261.5,0.55703125,0.7263888888888889,0.0171875,0.030555555555555555
2702-2021_03_20_090102.jpg,van,8,302,640,19,360,224,3,310,243,LTAdatasets/2702/annotate/2702-2021_03_20_090102.jpg,306.0,233.5,0.478125,0.6486111111111111,0.0125,0.05277777777777778
2702-2021_03_20_090102.jpg,bike,7,251,640,14,360,194,4,258,208,LTAdatasets/2702/annotate/2702-2021_03_20_090102.jpg,254.5,201.0,0.39765625,0.5583333333333333,0.0109375,0.03888888888888889
2702-2021_03_20_090102.jpg,lorry_truck,10,222,640,16,360,183,2,232,199,LTAdatasets/2702/annotate/2702-2021_03_20_090102.jpg,227.0,191.0,0.3546875,0.5305555555555556,0.015625,0.044444444444444446
3704-2021_03_20_100105.jpg,car,23,301,640,22,360,137,1,324,159,LTAdatasets/3704/annotate/3704-2021_03_20_100105.jpg,312.5,148.0,0.48828125,0.4111111111111111,0.0359375,0.06111111111111111
3704-2021_03_20_100105.jpg,car,14,254,640,9,360,90,1,268,99,LTAdatasets/3704/annotate/3704-2021_03_20_100105.jpg,261.0,94.5,0.4078125,0.2625,0.021875,0.025
3704-2021_03_20_100105.jpg,car,8,397,640,12,360,74,1,405,86,LTAdatasets/3704/annotate/3704-2021_03_20_100105.jpg,401.0,80.0,0.6265625,0.2222222222222222,0.0125,0.03333333333333333
3704-2021_03_20_100105.jpg,car,8,352,640,8,360,72,1,360,80,LTAdatasets/3704/annotate/3704-2021_03_20_100105.jpg,356.0,76.0,0.55625,0.2111111111111111,0.0125,0.022222222222222223
3704-2021_03_20_183952.jpg,car,40,267,640,32,360,206,1,307,238,LTAdatasets/3704/annotate/3704-2021_03_20_183952.jpg,287.0,222.0,0.4484375,0.6166666666666667,0.0625,0.08888888888888889
3704-2021_03_20_183952.jpg,car,32,232,640,25,360,168,1,264,193,LTAdatasets/3704/annotate/3704-2021_03_20_183952.jpg,248.0,180.5,0.3875,0.5013888888888889,0.05,0.06944444444444445
3704-2021_03_20_183952.jpg,car,22,359,640,18,360,106,1,381,124,LTAdatasets/3704/annotate/3704-2021_03_20_183952.jpg,370.0,115.0,0.578125,0.3194444444444444,0.034375,0.05
3704-2021_03_20_183952.jpg,car,25,125,640,21,360,162,1,150,183,LTAdatasets/3704/annotate/3704-2021_03_20_183952.jpg,137.5,172.5,0.21484375,0.4791666666666667,0.0390625,0.058333333333333334
3704-2021_03_20_183952.jpg,car,25,134,640,14,360,146,1,159,160,LTAdatasets/3704/annotate/3704-2021_03_20_183952.jpg,146.5,153.0,0.22890625,0.425,0.0390625,0.03888888888888889
3704-2021_03_20_183952.jpg,car,30,61,640,17,360,152,1,91,169,LTAdatasets/3704/annotate/3704-2021_03_20_183952.jpg,76.0,160.5,0.11875,0.44583333333333336,0.046875,0.04722222222222222
3704-2021_03_20_183952.jpg,car,41,42,640,21,360,185,1,83,206,LTAdatasets/3704/annotate/3704-2021_03_20_183952.jpg,62.5,195.5,0.09765625,0.5430555555555555,0.0640625,0.058333333333333334
3704-2021_03_20_183952.jpg,car,28,11,640,21,360,189,1,39,210,LTAdatasets/3704/annotate/3704-2021_03_20_183952.jpg,25.0,199.5,0.0390625,0.5541666666666667,0.04375,0.058333333333333334
3704-2021_03_20_183952.jpg,car,18,215,640,10,360,123,1,233,133,LTAdatasets/3704/annotate/3704-2021_03_20_183952.jpg,224.0,128.0,0.35,0.35555555555555557,0.028125,0.027777777777777776
3704-2021_03_20_182752.jpg,car,60,94,640,44,360,264,1,154,308,LTAdatasets/3704/annotate/3704-2021_03_20_182752.jpg,124.0,286.0,0.19375,0.7944444444444444,0.09375,0.12222222222222222
3704-2021_03_20_182752.jpg,car,37,44,640,22,360,181,1,81,203,LTAdatasets/3704/annotate/3704-2021_03_20_182752.jpg,62.5,192.0,0.09765625,0.5333333333333333,0.0578125,0.06111111111111111
3704-2021_03_20_182752.jpg,car,29,132,640,14,360,132,1,161,146,LTAdatasets/3704/annotate/3704-2021_03_20_182752.jpg,146.5,139.0,0.22890625,0.3861111111111111,0.0453125,0.03888888888888889
3704-2021_03_20_182752.jpg,car,22,183,640,16,360,134,1,205,150,LTAdatasets/3704/annotate/3704-2021_03_20_182752.jpg,194.0,142.0,0.303125,0.39444444444444443,0.034375,0.044444444444444446
3704-2021_03_20_182752.jpg,lorry_truck,21,311,640,21,360,130,2,332,151,LTAdatasets/3704/annotate/3704-2021_03_20_182752.jpg,321.5,140.5,0.50234375,0.3902777777777778,0.0328125,0.058333333333333334
3704-2021_03_20_182752.jpg,lorry_truck,53,74,640,25,360,125,2,127,150,LTAdatasets/3704/annotate/3704-2021_03_20_182752.jpg,100.5,137.5,0.15703125,0.3819444444444444,0.0828125,0.06944444444444445
3704-2021_03_20_084301.jpg,van,34,20,640,19,360,178,3,54,197,LTAdatasets/3704/annotate/3704-2021_03_20_084301.jpg,37.0,187.5,0.0578125,0.5208333333333334,0.053125,0.05277777777777778
3704-2021_03_20_084301.jpg,car,17,165,640,12,360,130,1,182,142,LTAdatasets/3704/annotate/3704-2021_03_20_084301.jpg,173.5,136.0,0.27109375,0.37777777777777777,0.0265625,0.03333333333333333
3704-2021_03_20_084301.jpg,car,12,372,640,14,360,86,1,384,100,LTAdatasets/3704/annotate/3704-2021_03_20_084301.jpg,378.0,93.0,0.590625,0.25833333333333336,0.01875,0.03888888888888889
3704-2021_03_20_204018.jpg,car,39,278,640,44,360,229,1,317,273,LTAdatasets/3704/annotate/3704-2021_03_20_204018.jpg,297.5,251.0,0.46484375,0.6972222222222222,0.0609375,0.12222222222222222
3704-2021_03_20_204018.jpg,car,26,558,640,30,360,185,1,584,215,LTAdatasets/3704/annotate/3704-2021_03_20_204018.jpg,571.0,200.0,0.8921875,0.5555555555555556,0.040625,0.08333333333333333
3704-2021_03_20_204018.jpg,car,37,207,640,39,360,177,1,244,216,LTAdatasets/3704/annotate/3704-2021_03_20_204018.jpg,225.5,196.5,0.35234375,0.5458333333333333,0.0578125,0.10833333333333334
3704-2021_03_20_204018.jpg,car,24,327,640,24,360,151,1,351,175,LTAdatasets/3704/annotate/3704-2021_03_20_204018.jpg,339.0,163.0,0.5296875,0.4527777777777778,0.0375,0.06666666666666667
3704-2021_03_20_204018.jpg,car,16,300,640,16,360,114,1,316,130,LTAdatasets/3704/annotate/3704-2021_03_20_204018.jpg,308.0,122.0,0.48125,0.3388888888888889,0.025,0.044444444444444446
3704-2021_03_20_204018.jpg,car,23,184,640,19,360,133,1,207,152,LTAdatasets/3704/annotate/3704-2021_03_20_204018.jpg,195.5,142.5,0.30546875,0.3958333333333333,0.0359375,0.05277777777777778
3704-2021_03_20_204018.jpg,car,16,356,640,14,360,110,1,372,124,LTAdatasets/3704/annotate/3704-2021_03_20_204018.jpg,364.0,117.0,0.56875,0.325,0.025,0.03888888888888889
3704-2021_03_20_204018.jpg,bus,25,329,640,25,360,93,5,354,118,LTAdatasets/3704/annotate/3704-2021_03_20_204018.jpg,341.5,105.5,0.53359375,0.29305555555555557,0.0390625,0.06944444444444445
3704-2021_03_20_204018.jpg,bus,16,373,640,12,360,85,5,389,97,LTAdatasets/3704/annotate/3704-2021_03_20_204018.jpg,381.0,91.0,0.5953125,0.25277777777777777,0.025,0.03333333333333333
3704-2021_03_20_204018.jpg,bus,15,343,640,9,360,81,5,358,90,LTAdatasets/3704/annotate/3704-2021_03_20_204018.jpg,350.5,85.5,0.54765625,0.2375,0.0234375,0.025
3704-2021_03_20_191614.jpg,bus,47,197,640,43,360,251,5,244,294,LTAdatasets/3704/annotate/3704-2021_03_20_191614.jpg,220.5,272.5,0.34453125,0.7569444444444444,0.0734375,0.11944444444444445
3704-2021_03_20_191614.jpg,bus,24,104,640,16,360,134,5,128,150,LTAdatasets/3704/annotate/3704-2021_03_20_191614.jpg,116.0,142.0,0.18125,0.39444444444444443,0.0375,0.044444444444444446
3704-2021_03_20_191614.jpg,bus,25,162,640,20,360,129,5,187,149,LTAdatasets/3704/annotate/3704-2021_03_20_191614.jpg,174.5,139.0,0.27265625,0.3861111111111111,0.0390625,0.05555555555555555
3704-2021_03_20_191614.jpg,bus,11,318,640,12,360,97,5,329,109,LTAdatasets/3704/annotate/3704-2021_03_20_191614.jpg,323.5,103.0,0.50546875,0.2861111111111111,0.0171875,0.03333333333333333
3704-2021_03_20_191614.jpg,bus,10,350,640,13,360,95,5,360,108,LTAdatasets/3704/annotate/3704-2021_03_20_191614.jpg,355.0,101.5,0.5546875,0.28194444444444444,0.015625,0.03611111111111111
3704-2021_03_20_191614.jpg,bus,16,219,640,15,360,105,5,235,120,LTAdatasets/3704/annotate/3704-2021_03_20_191614.jpg,227.0,112.5,0.3546875,0.3125,0.025,0.041666666666666664
3704-2021_03_20_191614.jpg,bus,32,3,640,17,360,195,5,35,212,LTAdatasets/3704/annotate/3704-2021_03_20_191614.jpg,19.0,203.5,0.0296875,0.5652777777777778,0.05,0.04722222222222222
3704-2021_03_20_083640.jpg,bus,39,22,640,23,360,207,5,61,230,LTAdatasets/3704/annotate/3704-2021_03_20_083640.jpg,41.5,218.5,0.06484375,0.6069444444444444,0.0609375,0.06388888888888888
3704-2021_03_20_083640.jpg,lorry_truck,34,118,640,24,360,123,2,152,147,LTAdatasets/3704/annotate/3704-2021_03_20_083640.jpg,135.0,135.0,0.2109375,0.375,0.053125,0.06666666666666667
3704-2021_03_20_083640.jpg,car,16,365,640,10,360,89,1,381,99,LTAdatasets/3704/annotate/3704-2021_03_20_083640.jpg,373.0,94.0,0.5828125,0.2611111111111111,0.025,0.027777777777777776
3704-2021_03_20_094904.jpg,lorry_truck,46,274,640,55,360,178,2,320,233,LTAdatasets/3704/annotate/3704-2021_03_20_094904.jpg,297.0,205.5,0.4640625,0.5708333333333333,0.071875,0.1527777777777778
3704-2021_03_20_094904.jpg,lorry_truck,25,365,640,30,360,163,2,390,193,LTAdatasets/3704/annotate/3704-2021_03_20_094904.jpg,377.5,178.0,0.58984375,0.49444444444444446,0.0390625,0.08333333333333333
3704-2021_03_20_094904.jpg,lorry_truck,34,606,640,89,360,252,2,640,341,LTAdatasets/3704/annotate/3704-2021_03_20_094904.jpg,623.0,296.5,0.9734375,0.8236111111111111,0.053125,0.24722222222222223
3704-2021_03_20_094904.jpg,lorry_truck,36,74,640,29,360,151,2,110,180,LTAdatasets/3704/annotate/3704-2021_03_20_094904.jpg,92.0,165.5,0.14375,0.4597222222222222,0.05625,0.08055555555555556
3704-2021_03_20_094904.jpg,car,23,116,640,14,360,136,1,139,150,LTAdatasets/3704/annotate/3704-2021_03_20_094904.jpg,127.5,143.0,0.19921875,0.3972222222222222,0.0359375,0.03888888888888889
3704-2021_03_20_094904.jpg,car,29,17,640,23,360,177,1,46,200,LTAdatasets/3704/annotate/3704-2021_03_20_094904.jpg,31.5,188.5,0.04921875,0.5236111111111111,0.0453125,0.06388888888888888
3704-2021_03_20_092543.jpg,car,29,101,640,13,360,156,1,130,169,LTAdatasets/3704/annotate/3704-2021_03_20_092543.jpg,115.5,162.5,0.18046875,0.4513888888888889,0.0453125,0.03611111111111111
3704-2021_03_20_092543.jpg,car,22,162,640,18,360,141,1,184,159,LTAdatasets/3704/annotate/3704-2021_03_20_092543.jpg,173.0,150.0,0.2703125,0.4166666666666667,0.034375,0.05
3704-2021_03_20_092543.jpg,car,24,61,640,14,360,151,1,85,165,LTAdatasets/3704/annotate/3704-2021_03_20_092543.jpg,73.0,158.0,0.1140625,0.4388888888888889,0.0375,0.03888888888888889
3704-2021_03_20_092543.jpg,van,23,325,640,31,360,161,3,348,192,LTAdatasets/3704/annotate/3704-2021_03_20_092543.jpg,336.5,176.5,0.52578125,0.49027777777777776,0.0359375,0.08611111111111111
3704-2021_03_20_092543.jpg,car,16,346,640,30,360,118,1,362,148,LTAdatasets/3704/annotate/3704-2021_03_20_092543.jpg,354.0,133.0,0.553125,0.36944444444444446,0.025,0.08333333333333333
3704-2021_03_20_092543.jpg,van,17,309,640,23,360,114,3,326,137,LTAdatasets/3704/annotate/3704-2021_03_20_092543.jpg,317.5,125.5,0.49609375,0.3486111111111111,0.0265625,0.06388888888888888
3704-2021_03_20_092543.jpg,lorry_truck,26,118,640,20,360,130,2,144,150,LTAdatasets/3704/annotate/3704-2021_03_20_092543.jpg,131.0,140.0,0.2046875,0.3888888888888889,0.040625,0.05555555555555555
3704-2021_03_20_092543.jpg,bike,20,22,640,24,360,218,4,42,242,LTAdatasets/3704/annotate/3704-2021_03_20_092543.jpg,32.0,230.0,0.05,0.6388888888888888,0.03125,0.06666666666666667
3704-2021_03_20_092543.jpg,lorry_truck,76,284,640,82,360,278,2,360,360,LTAdatasets/3704/annotate/3704-2021_03_20_092543.jpg,322.0,319.0,0.503125,0.8861111111111111,0.11875,0.22777777777777777
3704-2021_03_20_081920.jpg,lorry_truck,37,45,640,23,360,147,2,82,170,LTAdatasets/3704/annotate/3704-2021_03_20_081920.jpg,63.5,158.5,0.09921875,0.44027777777777777,0.0578125,0.06388888888888888
3704-2021_03_20_193415.jpg,car,34,318,640,51,360,254,1,352,305,LTAdatasets/3704/annotate/3704-2021_03_20_193415.jpg,335.0,279.5,0.5234375,0.7763888888888889,0.053125,0.14166666666666666
3704-2021_03_20_193415.jpg,car,20,326,640,23,360,160,1,346,183,LTAdatasets/3704/annotate/3704-2021_03_20_193415.jpg,336.0,171.5,0.525,0.47638888888888886,0.03125,0.06388888888888888
3704-2021_03_20_193415.jpg,car,20,302,640,20,360,133,1,322,153,LTAdatasets/3704/annotate/3704-2021_03_20_193415.jpg,312.0,143.0,0.4875,0.3972222222222222,0.03125,0.05555555555555555
3704-2021_03_20_193415.jpg,car,17,354,640,18,360,117,1,371,135,LTAdatasets/3704/annotate/3704-2021_03_20_193415.jpg,362.5,126.0,0.56640625,0.35,0.0265625,0.05
3704-2021_03_20_193415.jpg,car,24,135,640,14,360,133,1,159,147,LTAdatasets/3704/annotate/3704-2021_03_20_193415.jpg,147.0,140.0,0.2296875,0.3888888888888889,0.0375,0.03888888888888889
3704-2021_03_20_193415.jpg,car,33,71,640,17,360,166,1,104,183,LTAdatasets/3704/annotate/3704-2021_03_20_193415.jpg,87.5,174.5,0.13671875,0.4847222222222222,0.0515625,0.04722222222222222
3704-2021_03_20_203058.jpg,lorry_truck,32,349,640,54,360,175,2,381,229,LTAdatasets/3704/annotate/3704-2021_03_20_203058.jpg,365.0,202.0,0.5703125,0.5611111111111111,0.05,0.15
3704-2021_03_20_203058.jpg,car,36,198,640,31,360,184,1,234,215,LTAdatasets/3704/annotate/3704-2021_03_20_203058.jpg,216.0,199.5,0.3375,0.5541666666666667,0.05625,0.08611111111111111
3704-2021_03_20_203058.jpg,car,24,284,640,26,360,149,1,308,175,LTAdatasets/3704/annotate/3704-2021_03_20_203058.jpg,296.0,162.0,0.4625,0.45,0.0375,0.07222222222222222
3704-2021_03_20_203058.jpg,car,20,287,640,23,360,116,1,307,139,LTAdatasets/3704/annotate/3704-2021_03_20_203058.jpg,297.0,127.5,0.4640625,0.3541666666666667,0.03125,0.06388888888888888
3704-2021_03_20_203058.jpg,car,22,107,640,11,360,136,1,129,147,LTAdatasets/3704/annotate/3704-2021_03_20_203058.jpg,118.0,141.5,0.184375,0.39305555555555555,0.034375,0.030555555555555555
3704-2021_03_20_203058.jpg,car,17,322,640,16,360,104,1,339,120,LTAdatasets/3704/annotate/3704-2021_03_20_203058.jpg,330.5,112.0,0.51640625,0.3111111111111111,0.0265625,0.044444444444444446
3704-2021_03_20_084001.jpg,car,23,289,640,27,360,163,1,312,190,LTAdatasets/3704/annotate/3704-2021_03_20_084001.jpg,300.5,176.5,0.46953125,0.49027777777777776,0.0359375,0.075
3704-2021_03_20_084001.jpg,car,23,342,640,23,360,123,1,365,146,LTAdatasets/3704/annotate/3704-2021_03_20_084001.jpg,353.5,134.5,0.55234375,0.3736111111111111,0.0359375,0.06388888888888888
3704-2021_03_20_084001.jpg,car,16,344,640,14,360,100,1,360,114,LTAdatasets/3704/annotate/3704-2021_03_20_084001.jpg,352.0,107.0,0.55,0.2972222222222222,0.025,0.03888888888888889
3704-2021_03_20_182451.jpg,car,43,294,640,52,360,233,1,337,285,LTAdatasets/3704/annotate/3704-2021_03_20_182451.jpg,315.5,259.0,0.49296875,0.7194444444444444,0.0671875,0.14444444444444443
3704-2021_03_20_182451.jpg,car,32,4,640,21,360,211,1,36,232,LTAdatasets/3704/annotate/3704-2021_03_20_182451.jpg,20.0,221.5,0.03125,0.6152777777777778,0.05,0.058333333333333334
3704-2021_03_20_182451.jpg,bike,35,89,640,38,360,302,4,124,340,LTAdatasets/3704/annotate/3704-2021_03_20_182451.jpg,106.5,321.0,0.16640625,0.8916666666666667,0.0546875,0.10555555555555556
3704-2021_03_20_182451.jpg,bike,14,376,640,12,360,84,4,390,96,LTAdatasets/3704/annotate/3704-2021_03_20_182451.jpg,383.0,90.0,0.5984375,0.25,0.021875,0.03333333333333333
3704-2021_03_20_182451.jpg,bike,12,398,640,10,360,79,4,410,89,LTAdatasets/3704/annotate/3704-2021_03_20_182451.jpg,404.0,84.0,0.63125,0.23333333333333334,0.01875,0.027777777777777776
3704-2021_03_20_182451.jpg,bike,10,363,640,8,360,80,4,373,88,LTAdatasets/3704/annotate/3704-2021_03_20_182451.jpg,368.0,84.0,0.575,0.23333333333333334,0.015625,0.022222222222222223
3704-2021_03_20_082220.jpg,lorry_truck,51,263,640,64,360,201,2,314,265,LTAdatasets/3704/annotate/3704-2021_03_20_082220.jpg,288.5,233.0,0.45078125,0.6472222222222223,0.0796875,0.17777777777777778
3704-2021_03_20_082220.jpg,lorry_truck,40,274,640,48,360,145,2,314,193,LTAdatasets/3704/annotate/3704-2021_03_20_082220.jpg,294.0,169.0,0.459375,0.46944444444444444,0.0625,0.13333333333333333
3704-2021_03_20_082220.jpg,car,28,222,640,25,360,173,1,250,198,LTAdatasets/3704/annotate/3704-2021_03_20_082220.jpg,236.0,185.5,0.36875,0.5152777777777777,0.04375,0.06944444444444445
3704-2021_03_20_082220.jpg,lorry_truck,14,338,640,16,360,96,2,352,112,LTAdatasets/3704/annotate/3704-2021_03_20_082220.jpg,345.0,104.0,0.5390625,0.28888888888888886,0.021875,0.044444444444444446
3704-2021_03_20_082220.jpg,lorry_truck,13,379,640,18,360,75,2,392,93,LTAdatasets/3704/annotate/3704-2021_03_20_082220.jpg,385.5,84.0,0.60234375,0.23333333333333334,0.0203125,0.05
3704-2021_03_20_082220.jpg,van,12,388,640,15,360,102,3,400,117,LTAdatasets/3704/annotate/3704-2021_03_20_082220.jpg,394.0,109.5,0.615625,0.30416666666666664,0.01875,0.041666666666666664
3704-2021_03_20_082220.jpg,car,29,43,640,13,360,166,1,72,179,LTAdatasets/3704/annotate/3704-2021_03_20_082220.jpg,57.5,172.5,0.08984375,0.4791666666666667,0.0453125,0.03611111111111111
3704-2021_03_20_082220.jpg,car,37,603,640,52,360,262,1,640,314,LTAdatasets/3704/annotate/3704-2021_03_20_082220.jpg,621.5,288.0,0.97109375,0.8,0.0578125,0.14444444444444443
3704-2021_03_20_082440.jpg,car,18,302,640,14,360,107,1,320,121,LTAdatasets/3704/annotate/3704-2021_03_20_082440.jpg,311.0,114.0,0.4859375,0.31666666666666665,0.028125,0.03888888888888889
3704-2021_03_20_082440.jpg,lorry_truck,15,363,640,18,360,96,2,378,114,LTAdatasets/3704/annotate/3704-2021_03_20_082440.jpg,370.5,105.0,0.57890625,0.2916666666666667,0.0234375,0.05
3704-2021_03_20_082440.jpg,bus,20,354,640,16,360,76,5,374,92,LTAdatasets/3704/annotate/3704-2021_03_20_082440.jpg,364.0,84.0,0.56875,0.23333333333333334,0.03125,0.044444444444444446
3704-2021_03_20_082440.jpg,car,19,331,640,13,360,81,1,350,94,LTAdatasets/3704/annotate/3704-2021_03_20_082440.jpg,340.5,87.5,0.53203125,0.24305555555555555,0.0296875,0.03611111111111111
3704-2021_03_20_190634.jpg,car,18,304,640,19,360,134,1,322,153,LTAdatasets/3704/annotate/3704-2021_03_20_190634.jpg,313.0,143.5,0.4890625,0.39861111111111114,0.028125,0.05277777777777778
3704-2021_03_20_190634.jpg,car,31,566,640,30,360,197,1,597,227,LTAdatasets/3704/annotate/3704-2021_03_20_190634.jpg,581.5,212.0,0.90859375,0.5888888888888889,0.0484375,0.08333333333333333
3704-2021_03_20_190634.jpg,car,35,88,640,23,360,168,1,123,191,LTAdatasets/3704/annotate/3704-2021_03_20_190634.jpg,105.5,179.5,0.16484375,0.4986111111111111,0.0546875,0.06388888888888888
3704-2021_03_20_190634.jpg,car,18,225,640,12,360,116,1,243,128,LTAdatasets/3704/annotate/3704-2021_03_20_190634.jpg,234.0,122.0,0.365625,0.3388888888888889,0.028125,0.03333333333333333
3704-2021_03_20_190634.jpg,car,12,370,640,14,360,70,1,382,84,LTAdatasets/3704/annotate/3704-2021_03_20_190634.jpg,376.0,77.0,0.5875,0.21388888888888888,0.01875,0.03888888888888889
3704-2021_03_20_090702.jpg,car,36,564,640,45,360,205,1,600,250,LTAdatasets/3704/annotate/3704-2021_03_20_090702.jpg,582.0,227.5,0.909375,0.6319444444444444,0.05625,0.125
3704-2021_03_20_090702.jpg,car,39,285,640,43,360,222,1,324,265,LTAdatasets/3704/annotate/3704-2021_03_20_090702.jpg,304.5,243.5,0.47578125,0.6763888888888889,0.0609375,0.11944444444444445
3704-2021_03_20_090702.jpg,car,27,92,640,15,360,146,1,119,161,LTAdatasets/3704/annotate/3704-2021_03_20_090702.jpg,105.5,153.5,0.16484375,0.4263888888888889,0.0421875,0.041666666666666664
3704-2021_03_20_090702.jpg,car,18,210,640,17,360,117,1,228,134,LTAdatasets/3704/annotate/3704-2021_03_20_090702.jpg,219.0,125.5,0.3421875,0.3486111111111111,0.028125,0.04722222222222222
3704-2021_03_20_090702.jpg,car,12,370,640,6,360,89,1,382,95,LTAdatasets/3704/annotate/3704-2021_03_20_090702.jpg,376.0,92.0,0.5875,0.25555555555555554,0.01875,0.016666666666666666
3704-2021_03_20_090702.jpg,lorry_truck,20,385,640,29,360,86,2,405,115,LTAdatasets/3704/annotate/3704-2021_03_20_090702.jpg,395.0,100.5,0.6171875,0.2791666666666667,0.03125,0.08055555555555556
3704-2021_03_20_090702.jpg,bike,10,354,640,19,360,117,4,364,136,LTAdatasets/3704/annotate/3704-2021_03_20_090702.jpg,359.0,126.5,0.5609375,0.35138888888888886,0.015625,0.05277777777777778
3704-2021_03_20_200637.jpg,car,39,8,640,27,360,204,1,47,231,LTAdatasets/3704/annotate/3704-2021_03_20_200637.jpg,27.5,217.5,0.04296875,0.6041666666666666,0.0609375,0.075
3704-2021_03_20_200637.jpg,car,34,233,640,31,360,158,1,267,189,LTAdatasets/3704/annotate/3704-2021_03_20_200637.jpg,250.0,173.5,0.390625,0.48194444444444445,0.053125,0.08611111111111111
3704-2021_03_20_200637.jpg,car,34,101,640,21,360,175,1,135,196,LTAdatasets/3704/annotate/3704-2021_03_20_200637.jpg,118.0,185.5,0.184375,0.5152777777777777,0.053125,0.058333333333333334
3704-2021_03_20_200637.jpg,car,26,184,640,17,360,123,1,210,140,LTAdatasets/3704/annotate/3704-2021_03_20_200637.jpg,197.0,131.5,0.3078125,0.36527777777777776,0.040625,0.04722222222222222
3704-2021_03_20_200637.jpg,car,24,322,640,14,360,106,1,346,120,LTAdatasets/3704/annotate/3704-2021_03_20_200637.jpg,334.0,113.0,0.521875,0.3138888888888889,0.0375,0.03888888888888889
3704-2021_03_20_201617.jpg,car,25,264,640,31,360,165,1,289,196,LTAdatasets/3704/annotate/3704-2021_03_20_201617.jpg,276.5,180.5,0.43203125,0.5013888888888889,0.0390625,0.08611111111111111
3704-2021_03_20_201617.jpg,car,27,166,640,19,360,139,1,193,158,LTAdatasets/3704/annotate/3704-2021_03_20_201617.jpg,179.5,148.5,0.28046875,0.4125,0.0421875,0.05277777777777778
3704-2021_03_20_201617.jpg,car,26,336,640,11,360,104,1,362,115,LTAdatasets/3704/annotate/3704-2021_03_20_201617.jpg,349.0,109.5,0.5453125,0.30416666666666664,0.040625,0.030555555555555555
3704-2021_03_20_201617.jpg,car,20,232,640,16,360,101,1,252,117,LTAdatasets/3704/annotate/3704-2021_03_20_201617.jpg,242.0,109.0,0.378125,0.30277777777777776,0.03125,0.044444444444444446
3704-2021_03_20_201617.jpg,car,20,312,640,16,360,93,1,332,109,LTAdatasets/3704/annotate/3704-2021_03_20_201617.jpg,322.0,101.0,0.503125,0.28055555555555556,0.03125,0.044444444444444446
3704-2021_03_20_073417.jpg,car,42,317,640,38,360,319,1,359,357,LTAdatasets/3704/annotate/3704-2021_03_20_073417.jpg,338.0,338.0,0.528125,0.9388888888888889,0.065625,0.10555555555555556
3704-2021_03_20_073417.jpg,car,18,350,640,19,360,117,1,368,136,LTAdatasets/3704/annotate/3704-2021_03_20_073417.jpg,359.0,126.5,0.5609375,0.35138888888888886,0.028125,0.05277777777777778
3704-2021_03_20_194315.jpg,car,52,182,640,44,360,225,1,234,269,LTAdatasets/3704/annotate/3704-2021_03_20_194315.jpg,208.0,247.0,0.325,0.6861111111111111,0.08125,0.12222222222222222
3704-2021_03_20_194315.jpg,car,23,336,640,30,360,132,1,359,162,LTAdatasets/3704/annotate/3704-2021_03_20_194315.jpg,347.5,147.0,0.54296875,0.4083333333333333,0.0359375,0.08333333333333333
3704-2021_03_20_194315.jpg,car,21,287,640,26,360,122,1,308,148,LTAdatasets/3704/annotate/3704-2021_03_20_194315.jpg,297.5,135.0,0.46484375,0.375,0.0328125,0.07222222222222222
3704-2021_03_20_194315.jpg,car,19,297,640,18,360,157,1,316,175,LTAdatasets/3704/annotate/3704-2021_03_20_194315.jpg,306.5,166.0,0.47890625,0.46111111111111114,0.0296875,0.05
3704-2021_03_20_194315.jpg,car,28,140,640,17,360,128,1,168,145,LTAdatasets/3704/annotate/3704-2021_03_20_194315.jpg,154.0,136.5,0.240625,0.37916666666666665,0.04375,0.04722222222222222
3704-2021_03_20_194315.jpg,car,66,198,640,44,360,316,1,264,360,LTAdatasets/3704/annotate/3704-2021_03_20_194315.jpg,231.0,338.0,0.3609375,0.9388888888888889,0.103125,0.12222222222222222
3704-2021_03_20_192515.jpg,car,41,204,640,48,360,216,1,245,264,LTAdatasets/3704/annotate/3704-2021_03_20_192515.jpg,224.5,240.0,0.35078125,0.6666666666666666,0.0640625,0.13333333333333333
3704-2021_03_20_192515.jpg,car,36,80,640,20,360,170,1,116,190,LTAdatasets/3704/annotate/3704-2021_03_20_192515.jpg,98.0,180.0,0.153125,0.5,0.05625,0.05555555555555555
3704-2021_03_20_192515.jpg,car,22,167,640,9,360,134,1,189,143,LTAdatasets/3704/annotate/3704-2021_03_20_192515.jpg,178.0,138.5,0.278125,0.38472222222222224,0.034375,0.025
3704-2021_03_20_192515.jpg,car,25,138,640,14,360,133,1,163,147,LTAdatasets/3704/annotate/3704-2021_03_20_192515.jpg,150.5,140.0,0.23515625,0.3888888888888889,0.0390625,0.03888888888888889
3704-2021_03_20_192515.jpg,lorry_truck,12,370,640,13,360,99,2,382,112,LTAdatasets/3704/annotate/3704-2021_03_20_192515.jpg,376.0,105.5,0.5875,0.29305555555555557,0.01875,0.03611111111111111
3704-2021_03_20_192515.jpg,car,20,62,640,21,360,164,1,82,185,LTAdatasets/3704/annotate/3704-2021_03_20_192515.jpg,72.0,174.5,0.1125,0.4847222222222222,0.03125,0.058333333333333334
3704-2021_03_20_193115.jpg,car,38,224,640,37,360,211,1,262,248,LTAdatasets/3704/annotate/3704-2021_03_20_193115.jpg,243.0,229.5,0.3796875,0.6375,0.059375,0.10277777777777777
3704-2021_03_20_193115.jpg,lorry_truck,67,311,640,95,360,169,2,378,264,LTAdatasets/3704/annotate/3704-2021_03_20_193115.jpg,344.5,216.5,0.53828125,0.6013888888888889,0.1046875,0.2638888888888889
3704-2021_03_20_081539.jpg,lorry_truck,18,354,640,16,360,109,2,372,125,LTAdatasets/3704/annotate/3704-2021_03_20_081539.jpg,363.0,117.0,0.5671875,0.325,0.028125,0.044444444444444446
3704-2021_03_20_081539.jpg,lorry_truck,18,386,640,23,360,95,2,404,118,LTAdatasets/3704/annotate/3704-2021_03_20_081539.jpg,395.0,106.5,0.6171875,0.29583333333333334,0.028125,0.06388888888888888
3704-2021_03_20_081539.jpg,van,34,65,640,20,360,142,3,99,162,LTAdatasets/3704/annotate/3704-2021_03_20_081539.jpg,82.0,152.0,0.128125,0.4222222222222222,0.053125,0.05555555555555555
3704-2021_03_20_081539.jpg,car,31,96,640,24,360,157,1,127,181,LTAdatasets/3704/annotate/3704-2021_03_20_081539.jpg,111.5,169.0,0.17421875,0.46944444444444444,0.0484375,0.06666666666666667
3704-2021_03_20_180110.jpg,car,45,327,640,53,360,237,1,372,290,LTAdatasets/3704/annotate/3704-2021_03_20_180110.jpg,349.5,263.5,0.54609375,0.7319444444444444,0.0703125,0.14722222222222223
3704-2021_03_20_180110.jpg,car,39,209,640,36,360,192,1,248,228,LTAdatasets/3704/annotate/3704-2021_03_20_180110.jpg,228.5,210.0,0.35703125,0.5833333333333334,0.0609375,0.1
3704-2021_03_20_180110.jpg,car,40,59,640,22,360,198,1,99,220,LTAdatasets/3704/annotate/3704-2021_03_20_180110.jpg,79.0,209.0,0.1234375,0.5805555555555556,0.0625,0.06111111111111111
3704-2021_03_20_180110.jpg,car,17,145,640,17,360,129,1,162,146,LTAdatasets/3704/annotate/3704-2021_03_20_180110.jpg,153.5,137.5,0.23984375,0.3819444444444444,0.0265625,0.04722222222222222
3704-2021_03_20_180110.jpg,bike,8,325,640,20,360,138,4,333,158,LTAdatasets/3704/annotate/3704-2021_03_20_180110.jpg,329.0,148.0,0.5140625,0.4111111111111111,0.0125,0.05555555555555555
3704-2021_03_20_180110.jpg,car,15,359,640,19,360,101,1,374,120,LTAdatasets/3704/annotate/3704-2021_03_20_180110.jpg,366.5,110.5,0.57265625,0.30694444444444446,0.0234375,0.05277777777777778
3704-2021_03_20_180110.jpg,car,25,11,640,24,360,191,1,36,215,LTAdatasets/3704/annotate/3704-2021_03_20_180110.jpg,23.5,203.0,0.03671875,0.5638888888888889,0.0390625,0.06666666666666667
3704-2021_03_20_203658.jpg,car,41,215,640,45,360,200,1,256,245,LTAdatasets/3704/annotate/3704-2021_03_20_203658.jpg,235.5,222.5,0.36796875,0.6180555555555556,0.0640625,0.125
3704-2021_03_20_203658.jpg,car,23,308,640,22,360,128,1,331,150,LTAdatasets/3704/annotate/3704-2021_03_20_203658.jpg,319.5,139.0,0.49921875,0.3861111111111111,0.0359375,0.06111111111111111
3704-2021_03_20_203658.jpg,car,30,163,640,16,360,140,1,193,156,LTAdatasets/3704/annotate/3704-2021_03_20_203658.jpg,178.0,148.0,0.278125,0.4111111111111111,0.046875,0.044444444444444446
3704-2021_03_20_203658.jpg,bus,16,391,640,23,360,88,5,407,111,LTAdatasets/3704/annotate/3704-2021_03_20_203658.jpg,399.0,99.5,0.6234375,0.2763888888888889,0.025,0.06388888888888888
3704-2021_03_20_075138.jpg,car,49,158,640,44,360,246,1,207,290,LTAdatasets/3704/annotate/3704-2021_03_20_075138.jpg,182.5,268.0,0.28515625,0.7444444444444445,0.0765625,0.12222222222222222
3704-2021_03_20_075138.jpg,car,20,315,640,21,360,122,1,335,143,LTAdatasets/3704/annotate/3704-2021_03_20_075138.jpg,325.0,132.5,0.5078125,0.3680555555555556,0.03125,0.058333333333333334
3704-2021_03_20_075138.jpg,car,28,108,640,17,360,158,1,136,175,LTAdatasets/3704/annotate/3704-2021_03_20_075138.jpg,122.0,166.5,0.190625,0.4625,0.04375,0.04722222222222222
3704-2021_03_20_075138.jpg,car,14,351,640,15,360,103,1,365,118,LTAdatasets/3704/annotate/3704-2021_03_20_075138.jpg,358.0,110.5,0.559375,0.30694444444444446,0.021875,0.041666666666666664
3704-2021_03_20_075138.jpg,lorry_truck,11,389,640,16,360,97,2,400,113,LTAdatasets/3704/annotate/3704-2021_03_20_075138.jpg,394.5,105.0,0.61640625,0.2916666666666667,0.0171875,0.044444444444444446
3704-2021_03_20_075138.jpg,lorry_truck,18,381,640,16,360,116,2,399,132,LTAdatasets/3704/annotate/3704-2021_03_20_075138.jpg,390.0,124.0,0.609375,0.34444444444444444,0.028125,0.044444444444444446
3704-2021_03_20_195736.jpg,van,31,264,640,39,360,169,3,295,208,LTAdatasets/3704/annotate/3704-2021_03_20_195736.jpg,279.5,188.5,0.43671875,0.5236111111111111,0.0484375,0.10833333333333334
3704-2021_03_20_195736.jpg,car,14,375,640,16,360,128,1,389,144,LTAdatasets/3704/annotate/3704-2021_03_20_195736.jpg,382.0,136.0,0.596875,0.37777777777777777,0.021875,0.044444444444444446
3704-2021_03_20_195736.jpg,car,31,28,640,17,360,179,1,59,196,LTAdatasets/3704/annotate/3704-2021_03_20_195736.jpg,43.5,187.5,0.06796875,0.5208333333333334,0.0484375,0.04722222222222222
3704-2021_03_20_195736.jpg,car,17,349,640,15,360,117,1,366,132,LTAdatasets/3704/annotate/3704-2021_03_20_195736.jpg,357.5,124.5,0.55859375,0.3458333333333333,0.0265625,0.041666666666666664
3704-2021_03_20_195736.jpg,car,16,338,640,16,360,99,1,354,115,LTAdatasets/3704/annotate/3704-2021_03_20_195736.jpg,346.0,107.0,0.540625,0.2972222222222222,0.025,0.044444444444444446
3704-2021_03_20_195736.jpg,car,13,361,640,12,360,97,1,374,109,LTAdatasets/3704/annotate/3704-2021_03_20_195736.jpg,367.5,103.0,0.57421875,0.2861111111111111,0.0203125,0.03333333333333333
3704-2021_03_20_195736.jpg,lorry_truck,24,383,640,23,360,91,2,407,114,LTAdatasets/3704/annotate/3704-2021_03_20_195736.jpg,395.0,102.5,0.6171875,0.2847222222222222,0.0375,0.06388888888888888
3704-2021_03_20_195736.jpg,car,16,142,640,16,360,128,1,158,144,LTAdatasets/3704/annotate/3704-2021_03_20_195736.jpg,150.0,136.0,0.234375,0.37777777777777777,0.025,0.044444444444444446
3704-2021_03_20_084601.jpg,car,18,310,640,16,360,126,1,328,142,LTAdatasets/3704/annotate/3704-2021_03_20_084601.jpg,319.0,134.0,0.4984375,0.37222222222222223,0.028125,0.044444444444444446
3704-2021_03_20_084601.jpg,car,31,102,640,22,360,152,1,133,174,LTAdatasets/3704/annotate/3704-2021_03_20_084601.jpg,117.5,163.0,0.18359375,0.4527777777777778,0.0484375,0.06111111111111111
3704-2021_03_20_084601.jpg,car,28,66,640,20,360,154,1,94,174,LTAdatasets/3704/annotate/3704-2021_03_20_084601.jpg,80.0,164.0,0.125,0.45555555555555555,0.04375,0.05555555555555555
3704-2021_03_20_200116.jpg,car,25,229,640,24,360,162,1,254,186,LTAdatasets/3704/annotate/3704-2021_03_20_200116.jpg,241.5,174.0,0.37734375,0.48333333333333334,0.0390625,0.06666666666666667
3704-2021_03_20_200116.jpg,van,20,342,640,28,360,132,3,362,160,LTAdatasets/3704/annotate/3704-2021_03_20_200116.jpg,352.0,146.0,0.55,0.40555555555555556,0.03125,0.07777777777777778
3704-2021_03_20_200116.jpg,car,21,171,640,12,360,119,1,192,131,LTAdatasets/3704/annotate/3704-2021_03_20_200116.jpg,181.5,125.0,0.28359375,0.3472222222222222,0.0328125,0.03333333333333333
3704-2021_03_20_200116.jpg,car,12,125,640,19,360,140,1,137,159,LTAdatasets/3704/annotate/3704-2021_03_20_200116.jpg,131.0,149.5,0.2046875,0.4152777777777778,0.01875,0.05277777777777778
3704-2021_03_20_074918.jpg,bus,12,400,640,17,360,70,5,412,87,LTAdatasets/3704/annotate/3704-2021_03_20_074918.jpg,406.0,78.5,0.634375,0.21805555555555556,0.01875,0.04722222222222222
3704-2021_03_20_183112.jpg,car,26,302,640,37,360,199,1,328,236,LTAdatasets/3704/annotate/3704-2021_03_20_183112.jpg,315.0,217.5,0.4921875,0.6041666666666666,0.040625,0.10277777777777777
3704-2021_03_20_183112.jpg,car,21,271,640,25,360,156,1,292,181,LTAdatasets/3704/annotate/3704-2021_03_20_183112.jpg,281.5,168.5,0.43984375,0.46805555555555556,0.0328125,0.06944444444444445
3704-2021_03_20_183112.jpg,car,27,203,640,30,360,179,1,230,209,LTAdatasets/3704/annotate/3704-2021_03_20_183112.jpg,216.5,194.0,0.33828125,0.5388888888888889,0.0421875,0.08333333333333333
3704-2021_03_20_183112.jpg,car,38,12,640,27,360,204,1,50,231,LTAdatasets/3704/annotate/3704-2021_03_20_183112.jpg,31.0,217.5,0.0484375,0.6041666666666666,0.059375,0.075
3704-2021_03_20_183112.jpg,car,28,170,640,13,360,143,1,198,156,LTAdatasets/3704/annotate/3704-2021_03_20_183112.jpg,184.0,149.5,0.2875,0.4152777777777778,0.04375,0.03611111111111111
3704-2021_03_20_183112.jpg,car,17,379,640,17,360,114,1,396,131,LTAdatasets/3704/annotate/3704-2021_03_20_183112.jpg,387.5,122.5,0.60546875,0.3402777777777778,0.0265625,0.04722222222222222
3704-2021_03_20_183112.jpg,car,10,369,640,13,360,94,1,379,107,LTAdatasets/3704/annotate/3704-2021_03_20_183112.jpg,374.0,100.5,0.584375,0.2791666666666667,0.015625,0.03611111111111111
3704-2021_03_20_183112.jpg,car,12,364,640,18,360,85,1,376,103,LTAdatasets/3704/annotate/3704-2021_03_20_183112.jpg,370.0,94.0,0.578125,0.2611111111111111,0.01875,0.05
3704-2021_03_20_183112.jpg,car,28,612,640,58,360,288,1,640,346,LTAdatasets/3704/annotate/3704-2021_03_20_183112.jpg,626.0,317.0,0.978125,0.8805555555555555,0.04375,0.16111111111111112
3704-2021_03_20_202437.jpg,car,30,318,640,56,360,210,1,348,266,LTAdatasets/3704/annotate/3704-2021_03_20_202437.jpg,333.0,238.0,0.5203125,0.6611111111111111,0.046875,0.15555555555555556
3704-2021_03_20_202437.jpg,car,37,201,640,33,360,179,1,238,212,LTAdatasets/3704/annotate/3704-2021_03_20_202437.jpg,219.5,195.5,0.34296875,0.5430555555555555,0.0578125,0.09166666666666666
3704-2021_03_20_202437.jpg,car,17,299,640,29,360,141,1,316,170,LTAdatasets/3704/annotate/3704-2021_03_20_202437.jpg,307.5,155.5,0.48046875,0.43194444444444446,0.0265625,0.08055555555555556
3704-2021_03_20_202437.jpg,car,21,264,640,23,360,133,1,285,156,LTAdatasets/3704/annotate/3704-2021_03_20_202437.jpg,274.5,144.5,0.42890625,0.4013888888888889,0.0328125,0.06388888888888888
3704-2021_03_20_202437.jpg,car,43,1,640,26,360,208,1,44,234,LTAdatasets/3704/annotate/3704-2021_03_20_202437.jpg,22.5,221.0,0.03515625,0.6138888888888889,0.0671875,0.07222222222222222
3704-2021_03_20_202437.jpg,car,19,308,640,14,360,105,1,327,119,LTAdatasets/3704/annotate/3704-2021_03_20_202437.jpg,317.5,112.0,0.49609375,0.3111111111111111,0.0296875,0.03888888888888889
3704-2021_03_20_202437.jpg,car,12,363,640,11,360,110,1,375,121,LTAdatasets/3704/annotate/3704-2021_03_20_202437.jpg,369.0,115.5,0.5765625,0.32083333333333336,0.01875,0.030555555555555555
3704-2021_03_20_202437.jpg,car,20,142,640,16,360,131,1,162,147,LTAdatasets/3704/annotate/3704-2021_03_20_202437.jpg,152.0,139.0,0.2375,0.3861111111111111,0.03125,0.044444444444444446
3704-2021_03_20_194616.jpg,lorry_truck,63,225,640,75,360,252,2,288,327,LTAdatasets/3704/annotate/3704-2021_03_20_194616.jpg,256.5,289.5,0.40078125,0.8041666666666667,0.0984375,0.20833333333333334
3704-2021_03_20_194616.jpg,car,39,583,640,38,360,225,1,622,263,LTAdatasets/3704/annotate/3704-2021_03_20_194616.jpg,602.5,244.0,0.94140625,0.6777777777777778,0.0609375,0.10555555555555556
3704-2021_03_20_194616.jpg,car,23,373,640,20,360,126,1,396,146,LTAdatasets/3704/annotate/3704-2021_03_20_194616.jpg,384.5,136.0,0.60078125,0.37777777777777777,0.0359375,0.05555555555555555
3704-2021_03_20_194616.jpg,car,16,287,640,15,360,124,1,303,139,LTAdatasets/3704/annotate/3704-2021_03_20_194616.jpg,295.0,131.5,0.4609375,0.36527777777777776,0.025,0.041666666666666664
3704-2021_03_20_194616.jpg,car,19,345,640,16,360,105,1,364,121,LTAdatasets/3704/annotate/3704-2021_03_20_194616.jpg,354.5,113.0,0.55390625,0.3138888888888889,0.0296875,0.044444444444444446
3704-2021_03_20_194616.jpg,car,25,119,640,11,360,141,1,144,152,LTAdatasets/3704/annotate/3704-2021_03_20_194616.jpg,131.5,146.5,0.20546875,0.40694444444444444,0.0390625,0.030555555555555555
3704-2021_03_20_194616.jpg,car,14,244,640,10,360,109,1,258,119,LTAdatasets/3704/annotate/3704-2021_03_20_194616.jpg,251.0,114.0,0.3921875,0.31666666666666665,0.021875,0.027777777777777776
3704-2021_03_20_194616.jpg,car,25,152,640,12,360,139,1,177,151,LTAdatasets/3704/annotate/3704-2021_03_20_194616.jpg,164.5,145.0,0.25703125,0.4027777777777778,0.0390625,0.03333333333333333
3704-2021_03_20_073037.jpg,car,39,2,640,29,360,207,1,41,236,LTAdatasets/3704/annotate/3704-2021_03_20_073037.jpg,21.5,221.5,0.03359375,0.6152777777777778,0.0609375,0.08055555555555556
3704-2021_03_20_073037.jpg,lorry_truck,16,367,640,24,360,95,2,383,119,LTAdatasets/3704/annotate/3704-2021_03_20_073037.jpg,375.0,107.0,0.5859375,0.2972222222222222,0.025,0.06666666666666667
3704-2021_03_20_185153.jpg,car,33,234,640,28,360,156,1,267,184,LTAdatasets/3704/annotate/3704-2021_03_20_185153.jpg,250.5,170.0,0.39140625,0.4722222222222222,0.0515625,0.07777777777777778
3704-2021_03_20_185153.jpg,car,22,141,640,23,360,137,1,163,160,LTAdatasets/3704/annotate/3704-2021_03_20_185153.jpg,152.0,148.5,0.2375,0.4125,0.034375,0.06388888888888888
3704-2021_03_20_185153.jpg,car,19,193,640,18,360,108,1,212,126,LTAdatasets/3704/annotate/3704-2021_03_20_185153.jpg,202.5,117.0,0.31640625,0.325,0.0296875,0.05
3704-2021_03_20_083340.jpg,lorry_truck,59,234,640,116,360,201,2,293,317,LTAdatasets/3704/annotate/3704-2021_03_20_083340.jpg,263.5,259.0,0.41171875,0.7194444444444444,0.0921875,0.32222222222222224
3704-2021_03_20_083340.jpg,van,22,349,640,25,360,112,3,371,137,LTAdatasets/3704/annotate/3704-2021_03_20_083340.jpg,360.0,124.5,0.5625,0.3458333333333333,0.034375,0.06944444444444445
3704-2021_03_20_083340.jpg,van,18,385,640,19,360,105,3,403,124,LTAdatasets/3704/annotate/3704-2021_03_20_083340.jpg,394.0,114.5,0.615625,0.31805555555555554,0.028125,0.05277777777777778
3704-2021_03_20_072817.jpg,lorry_truck,21,355,640,33,360,93,2,376,126,LTAdatasets/3704/annotate/3704-2021_03_20_072817.jpg,365.5,109.5,0.57109375,0.30416666666666664,0.0328125,0.09166666666666666
3704-2021_03_20_072817.jpg,lorry_truck,20,337,640,31,360,82,2,357,113,LTAdatasets/3704/annotate/3704-2021_03_20_072817.jpg,347.0,97.5,0.5421875,0.2708333333333333,0.03125,0.08611111111111111
3704-2021_03_20_072817.jpg,van,23,151,640,21,360,122,3,174,143,LTAdatasets/3704/annotate/3704-2021_03_20_072817.jpg,162.5,132.5,0.25390625,0.3680555555555556,0.0359375,0.058333333333333334
3704-2021_03_20_095505.jpg,van,19,381,640,23,360,128,3,400,151,LTAdatasets/3704/annotate/3704-2021_03_20_095505.jpg,390.5,139.5,0.61015625,0.3875,0.0296875,0.06388888888888888
3704-2021_03_20_095505.jpg,car,26,325,640,21,360,144,1,351,165,LTAdatasets/3704/annotate/3704-2021_03_20_095505.jpg,338.0,154.5,0.528125,0.42916666666666664,0.040625,0.058333333333333334
3704-2021_03_20_095505.jpg,car,37,94,640,24,360,166,1,131,190,LTAdatasets/3704/annotate/3704-2021_03_20_095505.jpg,112.5,178.0,0.17578125,0.49444444444444446,0.0578125,0.06666666666666667
3704-2021_03_20_095505.jpg,car,25,179,640,21,360,118,1,204,139,LTAdatasets/3704/annotate/3704-2021_03_20_095505.jpg,191.5,128.5,0.29921875,0.35694444444444445,0.0390625,0.058333333333333334
3704-2021_03_20_081319.jpg,car,45,42,640,29,360,200,1,87,229,LTAdatasets/3704/annotate/3704-2021_03_20_081319.jpg,64.5,214.5,0.10078125,0.5958333333333333,0.0703125,0.08055555555555556
3704-2021_03_20_081319.jpg,car,25,150,640,15,360,136,1,175,151,LTAdatasets/3704/annotate/3704-2021_03_20_081319.jpg,162.5,143.5,0.25390625,0.39861111111111114,0.0390625,0.041666666666666664
3704-2021_03_20_072517.jpg,lorry_truck,25,356,640,25,360,95,2,381,120,LTAdatasets/3704/annotate/3704-2021_03_20_072517.jpg,368.5,107.5,0.57578125,0.2986111111111111,0.0390625,0.06944444444444445
3704-2021_03_20_072517.jpg,lorry_truck,17,390,640,17,360,83,2,407,100,LTAdatasets/3704/annotate/3704-2021_03_20_072517.jpg,398.5,91.5,0.62265625,0.25416666666666665,0.0265625,0.04722222222222222
3704-2021_03_20_072517.jpg,car,30,63,640,15,360,164,1,93,179,LTAdatasets/3704/annotate/3704-2021_03_20_072517.jpg,78.0,171.5,0.121875,0.47638888888888886,0.046875,0.041666666666666664
3704-2021_03_20_072517.jpg,bike,8,371,640,12,360,85,4,379,97,LTAdatasets/3704/annotate/3704-2021_03_20_072517.jpg,375.0,91.0,0.5859375,0.25277777777777777,0.0125,0.03333333333333333
3704-2021_03_20_200937.jpg,car,31,287,640,26,360,140,1,318,166,LTAdatasets/3704/annotate/3704-2021_03_20_200937.jpg,302.5,153.0,0.47265625,0.425,0.0484375,0.07222222222222222
3704-2021_03_20_200937.jpg,car,26,293,640,17,360,112,1,319,129,LTAdatasets/3704/annotate/3704-2021_03_20_200937.jpg,306.0,120.5,0.478125,0.3347222222222222,0.040625,0.04722222222222222
3704-2021_03_20_200937.jpg,car,19,331,640,14,360,97,1,350,111,LTAdatasets/3704/annotate/3704-2021_03_20_200937.jpg,340.5,104.0,0.53203125,0.28888888888888886,0.0296875,0.03888888888888889
3704-2021_03_20_200937.jpg,car,18,363,640,12,360,107,1,381,119,LTAdatasets/3704/annotate/3704-2021_03_20_200937.jpg,372.0,113.0,0.58125,0.3138888888888889,0.028125,0.03333333333333333
3704-2021_03_20_200937.jpg,car,39,102,640,21,360,155,1,141,176,LTAdatasets/3704/annotate/3704-2021_03_20_200937.jpg,121.5,165.5,0.18984375,0.4597222222222222,0.0609375,0.058333333333333334
3704-2021_03_20_200937.jpg,car,17,216,640,15,360,107,1,233,122,LTAdatasets/3704/annotate/3704-2021_03_20_200937.jpg,224.5,114.5,0.35078125,0.31805555555555554,0.0265625,0.041666666666666664
3704-2021_03_20_090102.jpg,car,29,323,640,23,360,150,1,352,173,LTAdatasets/3704/annotate/3704-2021_03_20_090102.jpg,337.5,161.5,0.52734375,0.4486111111111111,0.0453125,0.06388888888888888
3704-2021_03_20_090102.jpg,lorry_truck,38,69,640,26,360,132,2,107,158,LTAdatasets/3704/annotate/3704-2021_03_20_090102.jpg,88.0,145.0,0.1375,0.4027777777777778,0.059375,0.07222222222222222
3704-2021_03_20_090102.jpg,car,20,323,640,12,360,107,1,343,119,LTAdatasets/3704/annotate/3704-2021_03_20_090102.jpg,333.0,113.0,0.5203125,0.3138888888888889,0.03125,0.03333333333333333
3704-2021_03_20_090102.jpg,lorry_truck,16,366,640,20,360,83,2,382,103,LTAdatasets/3704/annotate/3704-2021_03_20_090102.jpg,374.0,93.0,0.584375,0.25833333333333336,0.025,0.05555555555555555
3704-2021_03_20_090102.jpg,bike,15,386,640,12,360,93,4,401,105,LTAdatasets/3704/annotate/3704-2021_03_20_090102.jpg,393.5,99.0,0.61484375,0.275,0.0234375,0.03333333333333333
3704-2021_03_20_193635.jpg,car,23,327,640,24,360,143,1,350,167,LTAdatasets/3704/annotate/3704-2021_03_20_193635.jpg,338.5,155.0,0.52890625,0.4305555555555556,0.0359375,0.06666666666666667
3704-2021_03_20_193635.jpg,car,16,318,640,20,360,114,1,334,134,LTAdatasets/3704/annotate/3704-2021_03_20_193635.jpg,326.0,124.0,0.509375,0.34444444444444444,0.025,0.05555555555555555
3704-2021_03_20_193635.jpg,car,16,368,640,12,360,98,1,384,110,LTAdatasets/3704/annotate/3704-2021_03_20_193635.jpg,376.0,104.0,0.5875,0.28888888888888886,0.025,0.03333333333333333
3704-2021_03_20_193635.jpg,bike,14,67,640,16,360,161,4,81,177,LTAdatasets/3704/annotate/3704-2021_03_20_193635.jpg,74.0,169.0,0.115625,0.46944444444444444,0.021875,0.044444444444444446
3704-2021_03_20_091623.jpg,car,22,292,640,27,360,140,1,314,167,LTAdatasets/3704/annotate/3704-2021_03_20_091623.jpg,303.0,153.5,0.4734375,0.4263888888888889,0.034375,0.075
3704-2021_03_20_091623.jpg,lorry_truck,48,25,640,43,360,153,2,73,196,LTAdatasets/3704/annotate/3704-2021_03_20_091623.jpg,49.0,174.5,0.0765625,0.4847222222222222,0.075,0.11944444444444445
3704-2021_03_20_091623.jpg,car,23,617,640,73,360,287,1,640,360,LTAdatasets/3704/annotate/3704-2021_03_20_091623.jpg,628.5,323.5,0.98203125,0.8986111111111111,0.0359375,0.20277777777777778
3704-2021_03_20_180410.jpg,car,22,561,640,26,360,186,1,583,212,LTAdatasets/3704/annotate/3704-2021_03_20_180410.jpg,572.0,199.0,0.89375,0.5527777777777778,0.034375,0.07222222222222222
3704-2021_03_20_180410.jpg,car,27,233,640,36,360,196,1,260,232,LTAdatasets/3704/annotate/3704-2021_03_20_180410.jpg,246.5,214.0,0.38515625,0.5944444444444444,0.0421875,0.1
3704-2021_03_20_180410.jpg,car,32,241,640,22,360,147,1,273,169,LTAdatasets/3704/annotate/3704-2021_03_20_180410.jpg,257.0,158.0,0.4015625,0.4388888888888889,0.05,0.06111111111111111
3704-2021_03_20_180410.jpg,car,19,322,640,17,360,124,1,341,141,LTAdatasets/3704/annotate/3704-2021_03_20_180410.jpg,331.5,132.5,0.51796875,0.3680555555555556,0.0296875,0.04722222222222222
3704-2021_03_20_180410.jpg,car,24,106,640,18,360,145,1,130,163,LTAdatasets/3704/annotate/3704-2021_03_20_180410.jpg,118.0,154.0,0.184375,0.42777777777777776,0.0375,0.05
3704-2021_03_20_180410.jpg,car,35,80,640,19,360,174,1,115,193,LTAdatasets/3704/annotate/3704-2021_03_20_180410.jpg,97.5,183.5,0.15234375,0.5097222222222222,0.0546875,0.05277777777777778
3704-2021_03_20_180410.jpg,car,19,196,640,12,360,131,1,215,143,LTAdatasets/3704/annotate/3704-2021_03_20_180410.jpg,205.5,137.0,0.32109375,0.38055555555555554,0.0296875,0.03333333333333333
3704-2021_03_20_092143.jpg,car,45,249,640,55,360,249,1,294,304,LTAdatasets/3704/annotate/3704-2021_03_20_092143.jpg,271.5,276.5,0.42421875,0.7680555555555556,0.0703125,0.1527777777777778
3704-2021_03_20_092143.jpg,car,31,196,640,32,360,178,1,227,210,LTAdatasets/3704/annotate/3704-2021_03_20_092143.jpg,211.5,194.0,0.33046875,0.5388888888888889,0.0484375,0.08888888888888889
3704-2021_03_20_092143.jpg,van,18,338,640,20,360,132,3,356,152,LTAdatasets/3704/annotate/3704-2021_03_20_092143.jpg,347.0,142.0,0.5421875,0.39444444444444443,0.028125,0.05555555555555555
3704-2021_03_20_092143.jpg,car,39,594,640,52,360,235,1,633,287,LTAdatasets/3704/annotate/3704-2021_03_20_092143.jpg,613.5,261.0,0.95859375,0.725,0.0609375,0.14444444444444443
3704-2021_03_20_092143.jpg,lorry_truck,27,106,640,16,360,125,2,133,141,LTAdatasets/3704/annotate/3704-2021_03_20_092143.jpg,119.5,133.0,0.18671875,0.36944444444444446,0.0421875,0.044444444444444446
3704-2021_03_20_092143.jpg,car,16,187,640,15,360,131,1,203,146,LTAdatasets/3704/annotate/3704-2021_03_20_092143.jpg,195.0,138.5,0.3046875,0.38472222222222224,0.025,0.041666666666666664
3704-2021_03_20_092143.jpg,car,19,176,640,13,360,115,1,195,128,LTAdatasets/3704/annotate/3704-2021_03_20_092143.jpg,185.5,121.5,0.28984375,0.3375,0.0296875,0.03611111111111111
3704-2021_03_20_093103.jpg,car,32,46,640,21,360,182,1,78,203,LTAdatasets/3704/annotate/3704-2021_03_20_093103.jpg,62.0,192.5,0.096875,0.5347222222222222,0.05,0.058333333333333334
3704-2021_03_20_093103.jpg,lorry_truck,46,49,640,26,360,143,2,95,169,LTAdatasets/3704/annotate/3704-2021_03_20_093103.jpg,72.0,156.0,0.1125,0.43333333333333335,0.071875,0.07222222222222222
3704-2021_03_20_093103.jpg,lorry_truck,16,190,640,20,360,107,2,206,127,LTAdatasets/3704/annotate/3704-2021_03_20_093103.jpg,198.0,117.0,0.309375,0.325,0.025,0.05555555555555555
3704-2021_03_20_093103.jpg,lorry_truck,18,139,640,19,360,118,2,157,137,LTAdatasets/3704/annotate/3704-2021_03_20_093103.jpg,148.0,127.5,0.23125,0.3541666666666667,0.028125,0.05277777777777778
3704-2021_03_20_093103.jpg,car,12,224,640,14,360,109,1,236,123,LTAdatasets/3704/annotate/3704-2021_03_20_093103.jpg,230.0,116.0,0.359375,0.32222222222222224,0.01875,0.03888888888888889
3704-2021_03_20_093103.jpg,car,14,344,640,9,360,89,1,358,98,LTAdatasets/3704/annotate/3704-2021_03_20_093103.jpg,351.0,93.5,0.5484375,0.25972222222222224,0.021875,0.025
3704-2021_03_20_093103.jpg,car,10,372,640,10,360,88,1,382,98,LTAdatasets/3704/annotate/3704-2021_03_20_093103.jpg,377.0,93.0,0.5890625,0.25833333333333336,0.015625,0.027777777777777776
3704-2021_03_20_190113.jpg,car,45,137,640,44,360,230,1,182,274,LTAdatasets/3704/annotate/3704-2021_03_20_190113.jpg,159.5,252.0,0.24921875,0.7,0.0703125,0.12222222222222222
3704-2021_03_20_190113.jpg,car,12,324,640,19,360,118,1,336,137,LTAdatasets/3704/annotate/3704-2021_03_20_190113.jpg,330.0,127.5,0.515625,0.3541666666666667,0.01875,0.05277777777777778
3704-2021_03_20_190113.jpg,car,12,349,640,11,360,98,1,361,109,LTAdatasets/3704/annotate/3704-2021_03_20_190113.jpg,355.0,103.5,0.5546875,0.2875,0.01875,0.030555555555555555
3704-2021_03_20_190113.jpg,car,13,386,640,17,360,104,1,399,121,LTAdatasets/3704/annotate/3704-2021_03_20_190113.jpg,392.5,112.5,0.61328125,0.3125,0.0203125,0.04722222222222222
3704-2021_03_20_190113.jpg,car,12,374,640,10,360,84,1,386,94,LTAdatasets/3704/annotate/3704-2021_03_20_190113.jpg,380.0,89.0,0.59375,0.24722222222222223,0.01875,0.027777777777777776
3704-2021_03_20_190113.jpg,car,26,64,640,17,360,152,1,90,169,LTAdatasets/3704/annotate/3704-2021_03_20_190113.jpg,77.0,160.5,0.1203125,0.44583333333333336,0.040625,0.04722222222222222
3704-2021_03_20_200416.jpg,car,26,135,640,20,360,151,1,161,171,LTAdatasets/3704/annotate/3704-2021_03_20_200416.jpg,148.0,161.0,0.23125,0.44722222222222224,0.040625,0.05555555555555555
3704-2021_03_20_200416.jpg,car,20,176,640,18,360,126,1,196,144,LTAdatasets/3704/annotate/3704-2021_03_20_200416.jpg,186.0,135.0,0.290625,0.375,0.03125,0.05
3704-2021_03_20_200416.jpg,car,21,322,640,10,360,93,1,343,103,LTAdatasets/3704/annotate/3704-2021_03_20_200416.jpg,332.5,98.0,0.51953125,0.2722222222222222,0.0328125,0.027777777777777776
3704-2021_03_20_200416.jpg,car,14,353,640,11,360,86,1,367,97,LTAdatasets/3704/annotate/3704-2021_03_20_200416.jpg,360.0,91.5,0.5625,0.25416666666666665,0.021875,0.030555555555555555
3704-2021_03_20_200416.jpg,car,14,371,640,10,360,95,1,385,105,LTAdatasets/3704/annotate/3704-2021_03_20_200416.jpg,378.0,100.0,0.590625,0.2777777777777778,0.021875,0.027777777777777776
3704-2021_03_20_191914.jpg,van,63,229,640,86,360,258,3,292,344,LTAdatasets/3704/annotate/3704-2021_03_20_191914.jpg,260.5,301.0,0.40703125,0.8361111111111111,0.0984375,0.2388888888888889
3704-2021_03_20_191914.jpg,car,29,259,640,24,360,185,1,288,209,LTAdatasets/3704/annotate/3704-2021_03_20_191914.jpg,273.5,197.0,0.42734375,0.5472222222222223,0.0453125,0.06666666666666667
3704-2021_03_20_191914.jpg,car,22,327,640,23,360,135,1,349,158,LTAdatasets/3704/annotate/3704-2021_03_20_191914.jpg,338.0,146.5,0.528125,0.40694444444444444,0.034375,0.06388888888888888
3704-2021_03_20_191914.jpg,car,16,374,640,16,360,133,1,390,149,LTAdatasets/3704/annotate/3704-2021_03_20_191914.jpg,382.0,141.0,0.596875,0.39166666666666666,0.025,0.044444444444444446
3704-2021_03_20_191914.jpg,car,18,284,640,14,360,124,1,302,138,LTAdatasets/3704/annotate/3704-2021_03_20_191914.jpg,293.0,131.0,0.4578125,0.3638888888888889,0.028125,0.03888888888888889
3704-2021_03_20_191914.jpg,car,13,338,640,16,360,112,1,351,128,LTAdatasets/3704/annotate/3704-2021_03_20_191914.jpg,344.5,120.0,0.53828125,0.3333333333333333,0.0203125,0.044444444444444446
3704-2021_03_20_191914.jpg,car,15,387,640,10,360,93,1,402,103,LTAdatasets/3704/annotate/3704-2021_03_20_191914.jpg,394.5,98.0,0.61640625,0.2722222222222222,0.0234375,0.027777777777777776
3704-2021_03_20_191914.jpg,car,13,328,640,10,360,90,1,341,100,LTAdatasets/3704/annotate/3704-2021_03_20_191914.jpg,334.5,95.0,0.52265625,0.2638888888888889,0.0203125,0.027777777777777776
3704-2021_03_20_191914.jpg,car,37,21,640,23,360,224,1,58,247,LTAdatasets/3704/annotate/3704-2021_03_20_191914.jpg,39.5,235.5,0.06171875,0.6541666666666667,0.0578125,0.06388888888888888
3704-2021_03_20_191914.jpg,bike,14,378,640,24,360,150,4,392,174,LTAdatasets/3704/annotate/3704-2021_03_20_191914.jpg,385.0,162.0,0.6015625,0.45,0.021875,0.06666666666666667
3704-2021_03_20_191914.jpg,car,18,167,640,17,360,144,1,185,161,LTAdatasets/3704/annotate/3704-2021_03_20_191914.jpg,176.0,152.5,0.275,0.4236111111111111,0.028125,0.04722222222222222
3704-2021_03_20_201317.jpg,car,43,181,640,44,360,241,1,224,285,LTAdatasets/3704/annotate/3704-2021_03_20_201317.jpg,202.5,263.0,0.31640625,0.7305555555555555,0.0671875,0.12222222222222222
3704-2021_03_20_201317.jpg,car,21,332,640,28,360,143,1,353,171,LTAdatasets/3704/annotate/3704-2021_03_20_201317.jpg,342.5,157.0,0.53515625,0.4361111111111111,0.0328125,0.07777777777777778
3704-2021_03_20_201317.jpg,van,15,146,640,18,360,141,3,161,159,LTAdatasets/3704/annotate/3704-2021_03_20_201317.jpg,153.5,150.0,0.23984375,0.4166666666666667,0.0234375,0.05
3704-2021_03_20_201317.jpg,car,33,98,640,19,360,147,1,131,166,LTAdatasets/3704/annotate/3704-2021_03_20_201317.jpg,114.5,156.5,0.17890625,0.43472222222222223,0.0515625,0.05277777777777778
3704-2021_03_20_184613.jpg,car,29,564,640,34,360,188,1,593,222,LTAdatasets/3704/annotate/3704-2021_03_20_184613.jpg,578.5,205.0,0.90390625,0.5694444444444444,0.0453125,0.09444444444444444
3704-2021_03_20_184613.jpg,car,25,100,640,18,360,161,1,125,179,LTAdatasets/3704/annotate/3704-2021_03_20_184613.jpg,112.5,170.0,0.17578125,0.4722222222222222,0.0390625,0.05
3704-2021_03_20_184613.jpg,car,32,32,640,16,360,179,1,64,195,LTAdatasets/3704/annotate/3704-2021_03_20_184613.jpg,48.0,187.0,0.075,0.5194444444444445,0.05,0.044444444444444446
3704-2021_03_20_184613.jpg,car,14,198,640,17,360,129,1,212,146,LTAdatasets/3704/annotate/3704-2021_03_20_184613.jpg,205.0,137.5,0.3203125,0.3819444444444444,0.021875,0.04722222222222222
3704-2021_03_20_184613.jpg,car,19,136,640,19,360,129,1,155,148,LTAdatasets/3704/annotate/3704-2021_03_20_184613.jpg,145.5,138.5,0.22734375,0.38472222222222224,0.0296875,0.05277777777777778
3704-2021_03_20_184613.jpg,car,16,338,640,13,360,108,1,354,121,LTAdatasets/3704/annotate/3704-2021_03_20_184613.jpg,346.0,114.5,0.540625,0.31805555555555554,0.025,0.03611111111111111
3704-2021_03_20_184613.jpg,bike,9,386,640,18,360,135,4,395,153,LTAdatasets/3704/annotate/3704-2021_03_20_184613.jpg,390.5,144.0,0.61015625,0.4,0.0140625,0.05
3704-2021_03_20_184613.jpg,van,20,352,640,18,360,116,3,372,134,LTAdatasets/3704/annotate/3704-2021_03_20_184613.jpg,362.0,125.0,0.565625,0.3472222222222222,0.03125,0.05
3704-2021_03_20_073937.jpg,car,19,358,640,17,360,106,1,377,123,LTAdatasets/3704/annotate/3704-2021_03_20_073937.jpg,367.5,114.5,0.57421875,0.31805555555555554,0.0296875,0.04722222222222222
3704-2021_03_20_092803.jpg,car,32,31,640,24,360,189,1,63,213,LTAdatasets/3704/annotate/3704-2021_03_20_092803.jpg,47.0,201.0,0.0734375,0.5583333333333333,0.05,0.06666666666666667
3704-2021_03_20_092803.jpg,van,33,46,640,22,360,161,3,79,183,LTAdatasets/3704/annotate/3704-2021_03_20_092803.jpg,62.5,172.0,0.09765625,0.4777777777777778,0.0515625,0.06111111111111111
3704-2021_03_20_092803.jpg,lorry_truck,23,306,640,23,360,118,2,329,141,LTAdatasets/3704/annotate/3704-2021_03_20_092803.jpg,317.5,129.5,0.49609375,0.3597222222222222,0.0359375,0.06388888888888888
3704-2021_03_20_092803.jpg,car,34,74,640,21,360,187,1,108,208,LTAdatasets/3704/annotate/3704-2021_03_20_092803.jpg,91.0,197.5,0.1421875,0.5486111111111112,0.053125,0.058333333333333334
3704-2021_03_20_194916.jpg,car,25,301,640,38,360,211,1,326,249,LTAdatasets/3704/annotate/3704-2021_03_20_194916.jpg,313.5,230.0,0.48984375,0.6388888888888888,0.0390625,0.10555555555555556
3704-2021_03_20_194916.jpg,van,21,303,640,28,360,132,3,324,160,LTAdatasets/3704/annotate/3704-2021_03_20_194916.jpg,313.5,146.0,0.48984375,0.40555555555555556,0.0328125,0.07777777777777778
3704-2021_03_20_194916.jpg,car,23,150,640,17,360,149,1,173,166,LTAdatasets/3704/annotate/3704-2021_03_20_194916.jpg,161.5,157.5,0.25234375,0.4375,0.0359375,0.04722222222222222
3704-2021_03_20_194916.jpg,car,22,561,640,26,360,183,1,583,209,LTAdatasets/3704/annotate/3704-2021_03_20_194916.jpg,572.0,196.0,0.89375,0.5444444444444444,0.034375,0.07222222222222222
3704-2021_03_20_091903.jpg,car,27,258,640,30,360,169,1,285,199,LTAdatasets/3704/annotate/3704-2021_03_20_091903.jpg,271.5,184.0,0.42421875,0.5111111111111111,0.0421875,0.08333333333333333
3704-2021_03_20_091903.jpg,car,17,362,640,15,360,110,1,379,125,LTAdatasets/3704/annotate/3704-2021_03_20_091903.jpg,370.5,117.5,0.57890625,0.3263888888888889,0.0265625,0.041666666666666664
3704-2021_03_20_091903.jpg,car,25,173,640,17,360,121,1,198,138,LTAdatasets/3704/annotate/3704-2021_03_20_091903.jpg,185.5,129.5,0.28984375,0.3597222222222222,0.0390625,0.04722222222222222
3704-2021_03_20_091903.jpg,car,29,49,640,18,360,151,1,78,169,LTAdatasets/3704/annotate/3704-2021_03_20_091903.jpg,63.5,160.0,0.09921875,0.4444444444444444,0.0453125,0.05
3704-2021_03_20_091903.jpg,car,20,191,640,15,360,105,1,211,120,LTAdatasets/3704/annotate/3704-2021_03_20_091903.jpg,201.0,112.5,0.3140625,0.3125,0.03125,0.041666666666666664
3704-2021_03_20_091903.jpg,van,12,341,640,11,360,95,3,353,106,LTAdatasets/3704/annotate/3704-2021_03_20_091903.jpg,347.0,100.5,0.5421875,0.2791666666666667,0.01875,0.030555555555555555
3704-2021_03_20_191014.jpg,car,47,146,640,62,360,284,1,193,346,LTAdatasets/3704/annotate/3704-2021_03_20_191014.jpg,169.5,315.0,0.26484375,0.875,0.0734375,0.17222222222222222
3704-2021_03_20_191014.jpg,car,38,30,640,20,360,215,1,68,235,LTAdatasets/3704/annotate/3704-2021_03_20_191014.jpg,49.0,225.0,0.0765625,0.625,0.059375,0.05555555555555555
3704-2021_03_20_191014.jpg,car,23,129,640,17,360,134,1,152,151,LTAdatasets/3704/annotate/3704-2021_03_20_191014.jpg,140.5,142.5,0.21953125,0.3958333333333333,0.0359375,0.04722222222222222
3704-2021_03_20_191014.jpg,car,13,357,640,14,360,113,1,370,127,LTAdatasets/3704/annotate/3704-2021_03_20_191014.jpg,363.5,120.0,0.56796875,0.3333333333333333,0.0203125,0.03888888888888889
3704-2021_03_20_191014.jpg,car,20,377,640,21,360,121,1,397,142,LTAdatasets/3704/annotate/3704-2021_03_20_191014.jpg,387.0,131.5,0.6046875,0.36527777777777776,0.03125,0.058333333333333334
3704-2021_03_20_191014.jpg,car,20,304,640,15,360,111,1,324,126,LTAdatasets/3704/annotate/3704-2021_03_20_191014.jpg,314.0,118.5,0.490625,0.32916666666666666,0.03125,0.041666666666666664
3704-2021_03_20_191014.jpg,lorry_truck,20,331,640,29,360,96,2,351,125,LTAdatasets/3704/annotate/3704-2021_03_20_191014.jpg,341.0,110.5,0.5328125,0.30694444444444446,0.03125,0.08055555555555556
3704-2021_03_20_091002.jpg,car,42,207,640,44,360,236,1,249,280,LTAdatasets/3704/annotate/3704-2021_03_20_091002.jpg,228.0,258.0,0.35625,0.7166666666666667,0.065625,0.12222222222222222
3704-2021_03_20_091002.jpg,car,31,94,640,28,360,170,1,125,198,LTAdatasets/3704/annotate/3704-2021_03_20_091002.jpg,109.5,184.0,0.17109375,0.5111111111111111,0.0484375,0.07777777777777778
3704-2021_03_20_091002.jpg,car,18,145,640,13,360,135,1,163,148,LTAdatasets/3704/annotate/3704-2021_03_20_091002.jpg,154.0,141.5,0.240625,0.39305555555555555,0.028125,0.03611111111111111
3704-2021_03_20_074318.jpg,bike,13,355,640,22,360,111,4,368,133,LTAdatasets/3704/annotate/3704-2021_03_20_074318.jpg,361.5,122.0,0.56484375,0.3388888888888889,0.0203125,0.06111111111111111
3704-2021_03_20_074318.jpg,lorry_truck,17,383,640,18,360,102,2,400,120,LTAdatasets/3704/annotate/3704-2021_03_20_074318.jpg,391.5,111.0,0.61171875,0.30833333333333335,0.0265625,0.05
3704-2021_03_20_074318.jpg,car,15,358,640,14,360,94,1,373,108,LTAdatasets/3704/annotate/3704-2021_03_20_074318.jpg,365.5,101.0,0.57109375,0.28055555555555556,0.0234375,0.03888888888888889
3704-2021_03_20_074318.jpg,bike,24,128,640,19,360,150,4,152,169,LTAdatasets/3704/annotate/3704-2021_03_20_074318.jpg,140.0,159.5,0.21875,0.44305555555555554,0.0375,0.05277777777777778
3704-2021_03_20_202217.jpg,car,57,73,640,61,360,266,1,130,327,LTAdatasets/3704/annotate/3704-2021_03_20_202217.jpg,101.5,296.5,0.15859375,0.8236111111111111,0.0890625,0.16944444444444445
3704-2021_03_20_202217.jpg,car,30,305,640,41,360,193,1,335,234,LTAdatasets/3704/annotate/3704-2021_03_20_202217.jpg,320.0,213.5,0.5,0.5930555555555556,0.046875,0.11388888888888889
3704-2021_03_20_202217.jpg,car,24,314,640,23,360,130,1,338,153,LTAdatasets/3704/annotate/3704-2021_03_20_202217.jpg,326.0,141.5,0.509375,0.39305555555555555,0.0375,0.06388888888888888
3704-2021_03_20_202217.jpg,car,30,138,640,20,360,154,1,168,174,LTAdatasets/3704/annotate/3704-2021_03_20_202217.jpg,153.0,164.0,0.2390625,0.45555555555555555,0.046875,0.05555555555555555
3704-2021_03_20_080939.jpg,lorry_truck,64,261,640,91,360,174,2,325,265,LTAdatasets/3704/annotate/3704-2021_03_20_080939.jpg,293.0,219.5,0.4578125,0.6097222222222223,0.1,0.25277777777777777
3704-2021_03_20_074618.jpg,car,59,51,640,49,360,308,1,110,357,LTAdatasets/3704/annotate/3704-2021_03_20_074618.jpg,80.5,332.5,0.12578125,0.9236111111111112,0.0921875,0.1361111111111111
3704-2021_03_20_083120.jpg,car,25,359,640,22,360,154,1,384,176,LTAdatasets/3704/annotate/3704-2021_03_20_083120.jpg,371.5,165.0,0.58046875,0.4583333333333333,0.0390625,0.06111111111111111
3704-2021_03_20_083120.jpg,bike,8,383,640,18,360,114,4,391,132,LTAdatasets/3704/annotate/3704-2021_03_20_083120.jpg,387.0,123.0,0.6046875,0.3416666666666667,0.0125,0.05
3704-2021_03_20_083120.jpg,bike,9,337,640,17,360,101,4,346,118,LTAdatasets/3704/annotate/3704-2021_03_20_083120.jpg,341.5,109.5,0.53359375,0.30416666666666664,0.0140625,0.04722222222222222
3704-2021_03_20_083120.jpg,car,26,85,640,14,360,151,1,111,165,LTAdatasets/3704/annotate/3704-2021_03_20_083120.jpg,98.0,158.0,0.153125,0.4388888888888889,0.040625,0.03888888888888889
3704-2021_03_20_191234.jpg,car,40,324,640,50,360,256,1,364,306,LTAdatasets/3704/annotate/3704-2021_03_20_191234.jpg,344.0,281.0,0.5375,0.7805555555555556,0.0625,0.1388888888888889
3704-2021_03_20_191234.jpg,car,37,196,640,48,360,241,1,233,289,LTAdatasets/3704/annotate/3704-2021_03_20_191234.jpg,214.5,265.0,0.33515625,0.7361111111111112,0.0578125,0.13333333333333333
3704-2021_03_20_191234.jpg,car,25,300,640,39,360,187,1,325,226,LTAdatasets/3704/annotate/3704-2021_03_20_191234.jpg,312.5,206.5,0.48828125,0.5736111111111111,0.0390625,0.10833333333333334
3704-2021_03_20_191234.jpg,car,18,276,640,19,360,132,1,294,151,LTAdatasets/3704/annotate/3704-2021_03_20_191234.jpg,285.0,141.5,0.4453125,0.39305555555555555,0.028125,0.05277777777777778
3704-2021_03_20_191234.jpg,car,19,354,640,18,360,122,1,373,140,LTAdatasets/3704/annotate/3704-2021_03_20_191234.jpg,363.5,131.0,0.56796875,0.3638888888888889,0.0296875,0.05
3704-2021_03_20_191234.jpg,car,41,73,640,21,360,190,1,114,211,LTAdatasets/3704/annotate/3704-2021_03_20_191234.jpg,93.5,200.5,0.14609375,0.5569444444444445,0.0640625,0.058333333333333334
3704-2021_03_20_094024.jpg,car,44,185,640,52,360,239,1,229,291,LTAdatasets/3704/annotate/3704-2021_03_20_094024.jpg,207.0,265.0,0.3234375,0.7361111111111112,0.06875,0.14444444444444443
3704-2021_03_20_094024.jpg,car,49,24,640,18,360,189,1,73,207,LTAdatasets/3704/annotate/3704-2021_03_20_094024.jpg,48.5,198.0,0.07578125,0.55,0.0765625,0.05
3704-2021_03_20_094024.jpg,car,30,279,640,20,360,139,1,309,159,LTAdatasets/3704/annotate/3704-2021_03_20_094024.jpg,294.0,149.0,0.459375,0.41388888888888886,0.046875,0.05555555555555555
3704-2021_03_20_094024.jpg,lorry_truck,17,350,640,26,360,69,2,367,95,LTAdatasets/3704/annotate/3704-2021_03_20_094024.jpg,358.5,82.0,0.56015625,0.22777777777777777,0.0265625,0.07222222222222222
3704-2021_03_20_085141.jpg,car,41,180,640,50,360,242,1,221,292,LTAdatasets/3704/annotate/3704-2021_03_20_085141.jpg,200.5,267.0,0.31328125,0.7416666666666667,0.0640625,0.1388888888888889
3704-2021_03_20_085141.jpg,car,12,352,640,19,360,80,1,364,99,LTAdatasets/3704/annotate/3704-2021_03_20_085141.jpg,358.0,89.5,0.559375,0.24861111111111112,0.01875,0.05277777777777778
3704-2021_03_20_095205.jpg,van,42,588,640,64,360,230,3,630,294,LTAdatasets/3704/annotate/3704-2021_03_20_095205.jpg,609.0,262.0,0.9515625,0.7277777777777777,0.065625,0.17777777777777778
3704-2021_03_20_095205.jpg,car,41,3,640,33,360,216,1,44,249,LTAdatasets/3704/annotate/3704-2021_03_20_095205.jpg,23.5,232.5,0.03671875,0.6458333333333334,0.0640625,0.09166666666666666
3704-2021_03_20_095205.jpg,lorry_truck,50,71,640,33,360,135,2,121,168,LTAdatasets/3704/annotate/3704-2021_03_20_095205.jpg,96.0,151.5,0.15,0.42083333333333334,0.078125,0.09166666666666666
3704-2021_03_20_181011.jpg,car,50,142,640,60,360,292,1,192,352,LTAdatasets/3704/annotate/3704-2021_03_20_181011.jpg,167.0,322.0,0.2609375,0.8944444444444445,0.078125,0.16666666666666666
3704-2021_03_20_181011.jpg,bus,28,331,640,39,360,107,5,359,146,LTAdatasets/3704/annotate/3704-2021_03_20_181011.jpg,345.0,126.5,0.5390625,0.35138888888888886,0.04375,0.10833333333333334
3704-2021_03_20_181011.jpg,car,21,149,640,15,360,141,1,170,156,LTAdatasets/3704/annotate/3704-2021_03_20_181011.jpg,159.5,148.5,0.24921875,0.4125,0.0328125,0.041666666666666664
3704-2021_03_20_181011.jpg,car,40,9,640,17,360,185,1,49,202,LTAdatasets/3704/annotate/3704-2021_03_20_181011.jpg,29.0,193.5,0.0453125,0.5375,0.0625,0.04722222222222222
3704-2021_03_20_181011.jpg,car,15,223,640,18,360,112,1,238,130,LTAdatasets/3704/annotate/3704-2021_03_20_181011.jpg,230.5,121.0,0.36015625,0.33611111111111114,0.0234375,0.05
3704-2021_03_20_181011.jpg,car,16,367,640,17,360,108,1,383,125,LTAdatasets/3704/annotate/3704-2021_03_20_181011.jpg,375.0,116.5,0.5859375,0.3236111111111111,0.025,0.04722222222222222
3704-2021_03_20_183712.jpg,car,45,312,640,48,360,243,1,357,291,LTAdatasets/3704/annotate/3704-2021_03_20_183712.jpg,334.5,267.0,0.52265625,0.7416666666666667,0.0703125,0.13333333333333333
3704-2021_03_20_183712.jpg,car,21,351,640,31,360,141,1,372,172,LTAdatasets/3704/annotate/3704-2021_03_20_183712.jpg,361.5,156.5,0.56484375,0.43472222222222223,0.0328125,0.08611111111111111
3704-2021_03_20_183712.jpg,car,19,256,640,26,360,146,1,275,172,LTAdatasets/3704/annotate/3704-2021_03_20_183712.jpg,265.5,159.0,0.41484375,0.44166666666666665,0.0296875,0.07222222222222222
3704-2021_03_20_183712.jpg,car,22,119,640,20,360,138,1,141,158,LTAdatasets/3704/annotate/3704-2021_03_20_183712.jpg,130.0,148.0,0.203125,0.4111111111111111,0.034375,0.05555555555555555
3704-2021_03_20_182151.jpg,car,37,565,640,35,360,203,1,602,238,LTAdatasets/3704/annotate/3704-2021_03_20_182151.jpg,583.5,220.5,0.91171875,0.6125,0.0578125,0.09722222222222222
3704-2021_03_20_182151.jpg,car,20,329,640,23,360,158,1,349,181,LTAdatasets/3704/annotate/3704-2021_03_20_182151.jpg,339.0,169.5,0.5296875,0.4708333333333333,0.03125,0.06388888888888888
3704-2021_03_20_182151.jpg,car,38,252,640,35,360,170,1,290,205,LTAdatasets/3704/annotate/3704-2021_03_20_182151.jpg,271.0,187.5,0.4234375,0.5208333333333334,0.059375,0.09722222222222222
3704-2021_03_20_182151.jpg,car,18,316,640,23,360,126,1,334,149,LTAdatasets/3704/annotate/3704-2021_03_20_182151.jpg,325.0,137.5,0.5078125,0.3819444444444444,0.028125,0.06388888888888888
3704-2021_03_20_182151.jpg,car,20,334,640,20,360,98,1,354,118,LTAdatasets/3704/annotate/3704-2021_03_20_182151.jpg,344.0,108.0,0.5375,0.3,0.03125,0.05555555555555555
3704-2021_03_20_182151.jpg,lorry_truck,29,372,640,29,360,105,2,401,134,LTAdatasets/3704/annotate/3704-2021_03_20_182151.jpg,386.5,119.5,0.60390625,0.33194444444444443,0.0453125,0.08055555555555556
3704-2021_03_20_182151.jpg,van,23,146,640,14,360,142,3,169,156,LTAdatasets/3704/annotate/3704-2021_03_20_182151.jpg,157.5,149.0,0.24609375,0.41388888888888886,0.0359375,0.03888888888888889
3704-2021_03_20_093724.jpg,car,35,275,640,55,360,256,1,310,311,LTAdatasets/3704/annotate/3704-2021_03_20_093724.jpg,292.5,283.5,0.45703125,0.7875,0.0546875,0.1527777777777778
3704-2021_03_20_093724.jpg,car,33,46,640,19,360,181,1,79,200,LTAdatasets/3704/annotate/3704-2021_03_20_093724.jpg,62.5,190.5,0.09765625,0.5291666666666667,0.0515625,0.05277777777777778
3704-2021_03_20_093724.jpg,car,30,177,640,22,360,130,1,207,152,LTAdatasets/3704/annotate/3704-2021_03_20_093724.jpg,192.0,141.0,0.3,0.39166666666666666,0.046875,0.06111111111111111
3704-2021_03_20_093724.jpg,car,17,338,640,23,360,131,1,355,154,LTAdatasets/3704/annotate/3704-2021_03_20_093724.jpg,346.5,142.5,0.54140625,0.3958333333333333,0.0265625,0.06388888888888888
3704-2021_03_20_093724.jpg,car,14,353,640,17,360,108,1,367,125,LTAdatasets/3704/annotate/3704-2021_03_20_093724.jpg,360.0,116.5,0.5625,0.3236111111111111,0.021875,0.04722222222222222
3704-2021_03_20_093724.jpg,lorry_truck,17,384,640,17,360,96,2,401,113,LTAdatasets/3704/annotate/3704-2021_03_20_093724.jpg,392.5,104.5,0.61328125,0.2902777777777778,0.0265625,0.04722222222222222
3704-2021_03_20_093724.jpg,car,12,312,640,14,360,99,1,324,113,LTAdatasets/3704/annotate/3704-2021_03_20_093724.jpg,318.0,106.0,0.496875,0.29444444444444445,0.01875,0.03888888888888889
3704-2021_03_20_091302.jpg,car,61,106,640,50,360,242,1,167,292,LTAdatasets/3704/annotate/3704-2021_03_20_091302.jpg,136.5,267.0,0.21328125,0.7416666666666667,0.0953125,0.1388888888888889
3704-2021_03_20_091302.jpg,car,22,350,640,30,360,146,1,372,176,LTAdatasets/3704/annotate/3704-2021_03_20_091302.jpg,361.0,161.0,0.5640625,0.44722222222222224,0.034375,0.08333333333333333
3704-2021_03_20_091302.jpg,car,37,207,640,26,360,176,1,244,202,LTAdatasets/3704/annotate/3704-2021_03_20_091302.jpg,225.5,189.0,0.35234375,0.525,0.0578125,0.07222222222222222
3704-2021_03_20_091302.jpg,car,14,324,640,18,360,111,1,338,129,LTAdatasets/3704/annotate/3704-2021_03_20_091302.jpg,331.0,120.0,0.5171875,0.3333333333333333,0.021875,0.05
3704-2021_03_20_091302.jpg,car,37,1,640,25,360,201,1,38,226,LTAdatasets/3704/annotate/3704-2021_03_20_091302.jpg,19.5,213.5,0.03046875,0.5930555555555556,0.0578125,0.06944444444444445
3704-2021_03_20_195136.jpg,car,31,287,640,35,360,214,1,318,249,LTAdatasets/3704/annotate/3704-2021_03_20_195136.jpg,302.5,231.5,0.47265625,0.6430555555555556,0.0484375,0.09722222222222222
3704-2021_03_20_195136.jpg,car,41,223,640,43,360,200,1,264,243,LTAdatasets/3704/annotate/3704-2021_03_20_195136.jpg,243.5,221.5,0.38046875,0.6152777777777778,0.0640625,0.11944444444444445
3704-2021_03_20_195136.jpg,car,37,23,640,19,360,198,1,60,217,LTAdatasets/3704/annotate/3704-2021_03_20_195136.jpg,41.5,207.5,0.06484375,0.5763888888888888,0.0578125,0.05277777777777778
3704-2021_03_20_195136.jpg,car,31,132,640,21,360,160,1,163,181,LTAdatasets/3704/annotate/3704-2021_03_20_195136.jpg,147.5,170.5,0.23046875,0.4736111111111111,0.0484375,0.058333333333333334
3704-2021_03_20_073717.jpg,car,35,298,640,36,360,208,1,333,244,LTAdatasets/3704/annotate/3704-2021_03_20_073717.jpg,315.5,226.0,0.49296875,0.6277777777777778,0.0546875,0.1
3704-2021_03_20_073717.jpg,car,15,361,640,14,360,112,1,376,126,LTAdatasets/3704/annotate/3704-2021_03_20_073717.jpg,368.5,119.0,0.57578125,0.33055555555555555,0.0234375,0.03888888888888889
3704-2021_03_20_073717.jpg,van,15,326,640,17,360,107,3,341,124,LTAdatasets/3704/annotate/3704-2021_03_20_073717.jpg,333.5,115.5,0.52109375,0.32083333333333336,0.0234375,0.04722222222222222
3704-2021_03_20_073717.jpg,car,23,136,640,19,360,134,1,159,153,LTAdatasets/3704/annotate/3704-2021_03_20_073717.jpg,147.5,143.5,0.23046875,0.39861111111111114,0.0359375,0.05277777777777778
3704-2021_03_20_192214.jpg,lorry_truck,98,223,640,149,360,211,2,321,360,LTAdatasets/3704/annotate/3704-2021_03_20_192214.jpg,272.0,285.5,0.425,0.7930555555555555,0.153125,0.41388888888888886
3704-2021_03_20_185453.jpg,van,27,102,640,18,360,143,3,129,161,LTAdatasets/3704/annotate/3704-2021_03_20_185453.jpg,115.5,152.0,0.18046875,0.4222222222222222,0.0421875,0.05
3704-2021_03_20_185453.jpg,car,25,138,640,16,360,149,1,163,165,LTAdatasets/3704/annotate/3704-2021_03_20_185453.jpg,150.5,157.0,0.23515625,0.4361111111111111,0.0390625,0.044444444444444446
3704-2021_03_20_185453.jpg,bike,11,342,640,16,360,99,4,353,115,LTAdatasets/3704/annotate/3704-2021_03_20_185453.jpg,347.5,107.0,0.54296875,0.2972222222222222,0.0171875,0.044444444444444446
3704-2021_03_20_085501.jpg,bike,28,144,640,32,360,327,4,172,359,LTAdatasets/3704/annotate/3704-2021_03_20_085501.jpg,158.0,343.0,0.246875,0.9527777777777777,0.04375,0.08888888888888889
3704-2021_03_20_085501.jpg,car,20,358,640,17,360,107,1,378,124,LTAdatasets/3704/annotate/3704-2021_03_20_085501.jpg,368.0,115.5,0.575,0.32083333333333336,0.03125,0.04722222222222222
3704-2021_03_20_085501.jpg,car,23,328,640,20,360,103,1,351,123,LTAdatasets/3704/annotate/3704-2021_03_20_085501.jpg,339.5,113.0,0.53046875,0.3138888888888889,0.0359375,0.05555555555555555
3704-2021_03_20_085501.jpg,car,17,170,640,12,360,139,1,187,151,LTAdatasets/3704/annotate/3704-2021_03_20_085501.jpg,178.5,145.0,0.27890625,0.4027777777777778,0.0265625,0.03333333333333333
3704-2021_03_20_085501.jpg,car,33,48,640,20,360,165,1,81,185,LTAdatasets/3704/annotate/3704-2021_03_20_085501.jpg,64.5,175.0,0.10078125,0.4861111111111111,0.0515625,0.05555555555555555
3704-2021_03_20_190413.jpg,car,57,190,640,70,360,284,1,247,354,LTAdatasets/3704/annotate/3704-2021_03_20_190413.jpg,218.5,319.0,0.34140625,0.8861111111111111,0.0890625,0.19444444444444445
3704-2021_03_20_190413.jpg,car,34,267,640,29,360,161,1,301,190,LTAdatasets/3704/annotate/3704-2021_03_20_190413.jpg,284.0,175.5,0.44375,0.4875,0.053125,0.08055555555555556
3704-2021_03_20_190413.jpg,car,21,357,640,18,360,111,1,378,129,LTAdatasets/3704/annotate/3704-2021_03_20_190413.jpg,367.5,120.0,0.57421875,0.3333333333333333,0.0328125,0.05
3704-2021_03_20_190413.jpg,car,19,288,640,22,360,114,1,307,136,LTAdatasets/3704/annotate/3704-2021_03_20_190413.jpg,297.5,125.0,0.46484375,0.3472222222222222,0.0296875,0.06111111111111111
3704-2021_03_20_190413.jpg,car,18,324,640,15,360,90,1,342,105,LTAdatasets/3704/annotate/3704-2021_03_20_190413.jpg,333.0,97.5,0.5203125,0.2708333333333333,0.028125,0.041666666666666664
3704-2021_03_20_190413.jpg,car,14,347,640,12,360,93,1,361,105,LTAdatasets/3704/annotate/3704-2021_03_20_190413.jpg,354.0,99.0,0.553125,0.275,0.021875,0.03333333333333333
3704-2021_03_20_190413.jpg,car,31,149,640,10,360,140,1,180,150,LTAdatasets/3704/annotate/3704-2021_03_20_190413.jpg,164.5,145.0,0.25703125,0.4027777777777778,0.0484375,0.027777777777777776
3704-2021_03_20_093424.jpg,lorry_truck,28,279,640,26,360,147,2,307,173,LTAdatasets/3704/annotate/3704-2021_03_20_093424.jpg,293.0,160.0,0.4578125,0.4444444444444444,0.04375,0.07222222222222222
3704-2021_03_20_093424.jpg,lorry_truck,29,353,640,48,360,174,2,382,222,LTAdatasets/3704/annotate/3704-2021_03_20_093424.jpg,367.5,198.0,0.57421875,0.55,0.0453125,0.13333333333333333
3704-2021_03_20_093424.jpg,car,18,296,640,17,360,105,1,314,122,LTAdatasets/3704/annotate/3704-2021_03_20_093424.jpg,305.0,113.5,0.4765625,0.31527777777777777,0.028125,0.04722222222222222
3704-2021_03_20_093424.jpg,car,19,148,640,12,360,126,1,167,138,LTAdatasets/3704/annotate/3704-2021_03_20_093424.jpg,157.5,132.0,0.24609375,0.36666666666666664,0.0296875,0.03333333333333333
3704-2021_03_20_093424.jpg,car,35,34,640,17,360,173,1,69,190,LTAdatasets/3704/annotate/3704-2021_03_20_093424.jpg,51.5,181.5,0.08046875,0.5041666666666667,0.0546875,0.04722222222222222
3704-2021_03_20_080119.jpg,car,20,143,640,19,360,127,1,163,146,LTAdatasets/3704/annotate/3704-2021_03_20_080119.jpg,153.0,136.5,0.2390625,0.37916666666666665,0.03125,0.05277777777777778
3704-2021_03_20_080119.jpg,lorry_truck,17,623,640,40,360,138,2,640,178,LTAdatasets/3704/annotate/3704-2021_03_20_080119.jpg,631.5,158.0,0.98671875,0.4388888888888889,0.0265625,0.1111111111111111
3704-2021_03_20_185753.jpg,car,47,209,640,43,360,225,1,256,268,LTAdatasets/3704/annotate/3704-2021_03_20_185753.jpg,232.5,246.5,0.36328125,0.6847222222222222,0.0734375,0.11944444444444445
3704-2021_03_20_185753.jpg,car,19,357,640,15,360,118,1,376,133,LTAdatasets/3704/annotate/3704-2021_03_20_185753.jpg,366.5,125.5,0.57265625,0.3486111111111111,0.0296875,0.041666666666666664
3704-2021_03_20_185753.jpg,car,21,328,640,12,360,112,1,349,124,LTAdatasets/3704/annotate/3704-2021_03_20_185753.jpg,338.5,118.0,0.52890625,0.3277777777777778,0.0328125,0.03333333333333333
3704-2021_03_20_185753.jpg,car,69,31,640,53,360,307,1,100,360,LTAdatasets/3704/annotate/3704-2021_03_20_185753.jpg,65.5,333.5,0.10234375,0.9263888888888889,0.1078125,0.14722222222222223
3704-2021_03_20_185753.jpg,car,24,102,640,19,360,135,1,126,154,LTAdatasets/3704/annotate/3704-2021_03_20_185753.jpg,114.0,144.5,0.178125,0.4013888888888889,0.0375,0.05277777777777778
3704-2021_03_20_090402.jpg,car,26,311,640,28,360,166,1,337,194,LTAdatasets/3704/annotate/3704-2021_03_20_090402.jpg,324.0,180.0,0.50625,0.5,0.040625,0.07777777777777778
3704-2021_03_20_090402.jpg,lorry_truck,20,364,640,32,360,168,2,384,200,LTAdatasets/3704/annotate/3704-2021_03_20_090402.jpg,374.0,184.0,0.584375,0.5111111111111111,0.03125,0.08888888888888889
3704-2021_03_20_090402.jpg,lorry_truck,21,310,640,26,360,117,2,331,143,LTAdatasets/3704/annotate/3704-2021_03_20_090402.jpg,320.5,130.0,0.50078125,0.3611111111111111,0.0328125,0.07222222222222222
3704-2021_03_20_181851.jpg,car,35,224,640,34,360,214,1,259,248,LTAdatasets/3704/annotate/3704-2021_03_20_181851.jpg,241.5,231.0,0.37734375,0.6416666666666667,0.0546875,0.09444444444444444
3704-2021_03_20_181851.jpg,car,36,269,640,52,360,236,1,305,288,LTAdatasets/3704/annotate/3704-2021_03_20_181851.jpg,287.0,262.0,0.4484375,0.7277777777777777,0.05625,0.14444444444444443
3704-2021_03_20_181851.jpg,car,34,348,640,46,360,212,1,382,258,LTAdatasets/3704/annotate/3704-2021_03_20_181851.jpg,365.0,235.0,0.5703125,0.6527777777777778,0.053125,0.12777777777777777
3704-2021_03_20_181851.jpg,car,29,49,640,22,360,167,1,78,189,LTAdatasets/3704/annotate/3704-2021_03_20_181851.jpg,63.5,178.0,0.09921875,0.49444444444444446,0.0453125,0.06111111111111111
3704-2021_03_20_181851.jpg,car,25,327,640,21,360,142,1,352,163,LTAdatasets/3704/annotate/3704-2021_03_20_181851.jpg,339.5,152.5,0.53046875,0.4236111111111111,0.0390625,0.058333333333333334
3704-2021_03_20_181851.jpg,car,18,379,640,21,360,135,1,397,156,LTAdatasets/3704/annotate/3704-2021_03_20_181851.jpg,388.0,145.5,0.60625,0.4041666666666667,0.028125,0.058333333333333334
3704-2021_03_20_181851.jpg,car,18,350,640,15,360,119,1,368,134,LTAdatasets/3704/annotate/3704-2021_03_20_181851.jpg,359.0,126.5,0.5609375,0.35138888888888886,0.028125,0.041666666666666664
3704-2021_03_20_181851.jpg,car,21,303,640,16,360,133,1,324,149,LTAdatasets/3704/annotate/3704-2021_03_20_181851.jpg,313.5,141.0,0.48984375,0.39166666666666666,0.0328125,0.044444444444444446
3704-2021_03_20_181851.jpg,car,30,127,640,18,360,149,1,157,167,LTAdatasets/3704/annotate/3704-2021_03_20_181851.jpg,142.0,158.0,0.221875,0.4388888888888889,0.046875,0.05
3704-2021_03_20_181851.jpg,bike,15,322,640,13,360,112,4,337,125,LTAdatasets/3704/annotate/3704-2021_03_20_181851.jpg,329.5,118.5,0.51484375,0.32916666666666666,0.0234375,0.03611111111111111
3704-2021_03_20_181851.jpg,bike,17,342,640,12,360,102,4,359,114,LTAdatasets/3704/annotate/3704-2021_03_20_181851.jpg,350.5,108.0,0.54765625,0.3,0.0265625,0.03333333333333333
3704-2021_03_20_181851.jpg,bike,20,169,640,15,360,121,4,189,136,LTAdatasets/3704/annotate/3704-2021_03_20_181851.jpg,179.0,128.5,0.2796875,0.35694444444444445,0.03125,0.041666666666666664
3704-2021_03_20_181851.jpg,bike,27,196,640,16,360,118,4,223,134,LTAdatasets/3704/annotate/3704-2021_03_20_181851.jpg,209.5,126.0,0.32734375,0.35,0.0421875,0.044444444444444446
3704-2021_03_20_084901.jpg,car,31,53,640,22,360,178,1,84,200,LTAdatasets/3704/annotate/3704-2021_03_20_084901.jpg,68.5,189.0,0.10703125,0.525,0.0484375,0.06111111111111111
3704-2021_03_20_084901.jpg,car,32,94,640,15,360,147,1,126,162,LTAdatasets/3704/annotate/3704-2021_03_20_084901.jpg,110.0,154.5,0.171875,0.42916666666666664,0.05,0.041666666666666664
3704-2021_03_20_084901.jpg,car,26,114,640,15,360,125,1,140,140,LTAdatasets/3704/annotate/3704-2021_03_20_084901.jpg,127.0,132.5,0.1984375,0.3680555555555556,0.040625,0.041666666666666664
3704-2021_03_20_084901.jpg,car,20,313,640,16,360,122,1,333,138,LTAdatasets/3704/annotate/3704-2021_03_20_084901.jpg,323.0,130.0,0.5046875,0.3611111111111111,0.03125,0.044444444444444446
3704-2021_03_20_084901.jpg,lorry_truck,23,384,640,28,360,80,2,407,108,LTAdatasets/3704/annotate/3704-2021_03_20_084901.jpg,395.5,94.0,0.61796875,0.2611111111111111,0.0359375,0.07777777777777778
3704-2021_03_20_075518.jpg,van,35,580,640,45,360,197,3,615,242,LTAdatasets/3704/annotate/3704-2021_03_20_075518.jpg,597.5,219.5,0.93359375,0.6097222222222223,0.0546875,0.125
3704-2021_03_20_075518.jpg,car,17,349,640,14,360,116,1,366,130,LTAdatasets/3704/annotate/3704-2021_03_20_075518.jpg,357.5,123.0,0.55859375,0.3416666666666667,0.0265625,0.03888888888888889
3704-2021_03_20_075518.jpg,car,13,349,640,10,360,91,1,362,101,LTAdatasets/3704/annotate/3704-2021_03_20_075518.jpg,355.5,96.0,0.55546875,0.26666666666666666,0.0203125,0.027777777777777776
3704-2021_03_20_203358.jpg,car,37,260,640,26,360,170,1,297,196,LTAdatasets/3704/annotate/3704-2021_03_20_203358.jpg,278.5,183.0,0.43515625,0.5083333333333333,0.0578125,0.07222222222222222
3704-2021_03_20_203358.jpg,lorry_truck,37,353,640,58,360,155,2,390,213,LTAdatasets/3704/annotate/3704-2021_03_20_203358.jpg,371.5,184.0,0.58046875,0.5111111111111111,0.0578125,0.16111111111111112
3704-2021_03_20_183412.jpg,car,42,178,640,69,360,251,1,220,320,LTAdatasets/3704/annotate/3704-2021_03_20_183412.jpg,199.0,285.5,0.3109375,0.7930555555555555,0.065625,0.19166666666666668
3704-2021_03_20_183412.jpg,lorry_truck,55,583,640,59,360,228,2,638,287,LTAdatasets/3704/annotate/3704-2021_03_20_183412.jpg,610.5,257.5,0.95390625,0.7152777777777778,0.0859375,0.1638888888888889
3704-2021_03_20_183412.jpg,car,28,309,640,26,360,151,1,337,177,LTAdatasets/3704/annotate/3704-2021_03_20_183412.jpg,323.0,164.0,0.5046875,0.45555555555555555,0.04375,0.07222222222222222
3704-2021_03_20_183412.jpg,car,25,251,640,20,360,147,1,276,167,LTAdatasets/3704/annotate/3704-2021_03_20_183412.jpg,263.5,157.0,0.41171875,0.4361111111111111,0.0390625,0.05555555555555555
3704-2021_03_20_183412.jpg,car,24,189,640,17,360,133,1,213,150,LTAdatasets/3704/annotate/3704-2021_03_20_183412.jpg,201.0,141.5,0.3140625,0.39305555555555555,0.0375,0.04722222222222222
3704-2021_03_20_183412.jpg,lorry_truck,18,330,640,18,360,106,2,348,124,LTAdatasets/3704/annotate/3704-2021_03_20_183412.jpg,339.0,115.0,0.5296875,0.3194444444444444,0.028125,0.05
3704-2021_03_20_183412.jpg,van,17,366,640,14,360,101,3,383,115,LTAdatasets/3704/annotate/3704-2021_03_20_183412.jpg,374.5,108.0,0.58515625,0.3,0.0265625,0.03888888888888889
3704-2021_03_20_094605.jpg,car,28,102,640,23,360,136,1,130,159,LTAdatasets/3704/annotate/3704-2021_03_20_094605.jpg,116.0,147.5,0.18125,0.4097222222222222,0.04375,0.06388888888888888
3704-2021_03_20_094605.jpg,car,19,314,640,21,360,125,1,333,146,LTAdatasets/3704/annotate/3704-2021_03_20_094605.jpg,323.5,135.5,0.50546875,0.3763888888888889,0.0296875,0.058333333333333334
3704-2021_03_20_201917.jpg,car,32,227,640,32,360,164,1,259,196,LTAdatasets/3704/annotate/3704-2021_03_20_201917.jpg,243.0,180.0,0.3796875,0.5,0.05,0.08888888888888889
3704-2021_03_20_201917.jpg,car,33,313,640,29,360,168,1,346,197,LTAdatasets/3704/annotate/3704-2021_03_20_201917.jpg,329.5,182.5,0.51484375,0.5069444444444444,0.0515625,0.08055555555555556
3704-2021_03_20_201917.jpg,car,21,297,640,18,360,139,1,318,157,LTAdatasets/3704/annotate/3704-2021_03_20_201917.jpg,307.5,148.0,0.48046875,0.4111111111111111,0.0328125,0.05
3704-2021_03_20_201917.jpg,car,33,93,640,26,360,175,1,126,201,LTAdatasets/3704/annotate/3704-2021_03_20_201917.jpg,109.5,188.0,0.17109375,0.5222222222222223,0.0515625,0.07222222222222222
3704-2021_03_20_201917.jpg,car,32,60,640,29,360,171,1,92,200,LTAdatasets/3704/annotate/3704-2021_03_20_201917.jpg,76.0,185.5,0.11875,0.5152777777777777,0.05,0.08055555555555556
3704-2021_03_20_201917.jpg,car,22,130,640,17,360,137,1,152,154,LTAdatasets/3704/annotate/3704-2021_03_20_201917.jpg,141.0,145.5,0.2203125,0.4041666666666667,0.034375,0.04722222222222222
3704-2021_03_20_085822.jpg,car,33,574,640,35,360,206,1,607,241,LTAdatasets/3704/annotate/3704-2021_03_20_085822.jpg,590.5,223.5,0.92265625,0.6208333333333333,0.0515625,0.09722222222222222
3704-2021_03_20_085822.jpg,car,32,275,640,21,360,120,1,307,141,LTAdatasets/3704/annotate/3704-2021_03_20_085822.jpg,291.0,130.5,0.4546875,0.3625,0.05,0.058333333333333334
3704-2021_03_20_085822.jpg,car,31,103,640,20,360,150,1,134,170,LTAdatasets/3704/annotate/3704-2021_03_20_085822.jpg,118.5,160.0,0.18515625,0.4444444444444444,0.0484375,0.05555555555555555
3704-2021_03_20_085822.jpg,car,25,145,640,14,360,124,1,170,138,LTAdatasets/3704/annotate/3704-2021_03_20_085822.jpg,157.5,131.0,0.24609375,0.3638888888888889,0.0390625,0.03888888888888889
3704-2021_03_20_085822.jpg,car,24,174,640,15,360,125,1,198,140,LTAdatasets/3704/annotate/3704-2021_03_20_085822.jpg,186.0,132.5,0.290625,0.3680555555555556,0.0375,0.041666666666666664
3704-2021_03_20_193935.jpg,car,36,284,640,39,360,204,1,320,243,LTAdatasets/3704/annotate/3704-2021_03_20_193935.jpg,302.0,223.5,0.471875,0.6208333333333333,0.05625,0.10833333333333334
3704-2021_03_20_193935.jpg,car,13,191,640,9,360,123,1,204,132,LTAdatasets/3704/annotate/3704-2021_03_20_193935.jpg,197.5,127.5,0.30859375,0.3541666666666667,0.0203125,0.025
3704-2021_03_20_193935.jpg,car,24,110,640,16,360,143,1,134,159,LTAdatasets/3704/annotate/3704-2021_03_20_193935.jpg,122.0,151.0,0.190625,0.41944444444444445,0.0375,0.044444444444444446
3704-2021_03_20_193935.jpg,car,22,313,640,17,360,98,1,335,115,LTAdatasets/3704/annotate/3704-2021_03_20_193935.jpg,324.0,106.5,0.50625,0.29583333333333334,0.034375,0.04722222222222222
3704-2021_03_20_184913.jpg,car,28,571,640,35,360,199,1,599,234,LTAdatasets/3704/annotate/3704-2021_03_20_184913.jpg,585.0,216.5,0.9140625,0.6013888888888889,0.04375,0.09722222222222222
3704-2021_03_20_184913.jpg,van,22,366,640,28,360,130,3,388,158,LTAdatasets/3704/annotate/3704-2021_03_20_184913.jpg,377.0,144.0,0.5890625,0.4,0.034375,0.07777777777777778
3704-2021_03_20_184913.jpg,car,16,364,640,16,360,97,1,380,113,LTAdatasets/3704/annotate/3704-2021_03_20_184913.jpg,372.0,105.0,0.58125,0.2916666666666667,0.025,0.044444444444444446
3704-2021_03_20_184913.jpg,car,14,346,640,12,360,95,1,360,107,LTAdatasets/3704/annotate/3704-2021_03_20_184913.jpg,353.0,101.0,0.5515625,0.28055555555555556,0.021875,0.03333333333333333
3704-2021_03_20_184913.jpg,car,28,52,640,17,360,156,1,80,173,LTAdatasets/3704/annotate/3704-2021_03_20_184913.jpg,66.0,164.5,0.103125,0.45694444444444443,0.04375,0.04722222222222222
3704-2021_03_20_080719.jpg,car,28,142,640,13,360,128,1,170,141,LTAdatasets/3704/annotate/3704-2021_03_20_080719.jpg,156.0,134.5,0.24375,0.3736111111111111,0.04375,0.03611111111111111
3704-2021_03_20_080719.jpg,car,37,35,640,18,360,174,1,72,192,LTAdatasets/3704/annotate/3704-2021_03_20_080719.jpg,53.5,183.0,0.08359375,0.5083333333333333,0.0578125,0.05
3704-2021_03_20_080719.jpg,van,24,298,640,23,360,134,3,322,157,LTAdatasets/3704/annotate/3704-2021_03_20_080719.jpg,310.0,145.5,0.484375,0.4041666666666667,0.0375,0.06388888888888888
3704-2021_03_20_202758.jpg,car,37,269,640,33,360,190,1,306,223,LTAdatasets/3704/annotate/3704-2021_03_20_202758.jpg,287.5,206.5,0.44921875,0.5736111111111111,0.0578125,0.09166666666666666
3704-2021_03_20_202758.jpg,car,31,91,640,17,360,154,1,122,171,LTAdatasets/3704/annotate/3704-2021_03_20_202758.jpg,106.5,162.5,0.16640625,0.4513888888888889,0.0484375,0.04722222222222222
3704-2021_03_20_202758.jpg,car,24,111,640,14,360,137,1,135,151,LTAdatasets/3704/annotate/3704-2021_03_20_202758.jpg,123.0,144.0,0.1921875,0.4,0.0375,0.03888888888888889
3704-2021_03_20_180710.jpg,car,48,338,640,57,360,215,1,386,272,LTAdatasets/3704/annotate/3704-2021_03_20_180710.jpg,362.0,243.5,0.565625,0.6763888888888889,0.075,0.15833333333333333
3704-2021_03_20_180710.jpg,car,37,603,640,59,360,271,1,640,330,LTAdatasets/3704/annotate/3704-2021_03_20_180710.jpg,621.5,300.5,0.97109375,0.8347222222222223,0.0578125,0.1638888888888889
3704-2021_03_20_180710.jpg,car,20,313,640,25,360,128,1,333,153,LTAdatasets/3704/annotate/3704-2021_03_20_180710.jpg,323.0,140.5,0.5046875,0.3902777777777778,0.03125,0.06944444444444445
3704-2021_03_20_180710.jpg,car,29,81,640,16,360,156,1,110,172,LTAdatasets/3704/annotate/3704-2021_03_20_180710.jpg,95.5,164.0,0.14921875,0.45555555555555555,0.0453125,0.044444444444444446
3704-2021_03_20_180710.jpg,car,19,146,640,20,360,138,1,165,158,LTAdatasets/3704/annotate/3704-2021_03_20_180710.jpg,155.5,148.0,0.24296875,0.4111111111111111,0.0296875,0.05555555555555555
3704-2021_03_20_180710.jpg,car,26,171,640,15,360,145,1,197,160,LTAdatasets/3704/annotate/3704-2021_03_20_180710.jpg,184.0,152.5,0.2875,0.4236111111111111,0.040625,0.041666666666666664
3704-2021_03_20_192735.jpg,car,36,300,640,34,360,171,1,336,205,LTAdatasets/3704/annotate/3704-2021_03_20_192735.jpg,318.0,188.0,0.496875,0.5222222222222223,0.05625,0.09444444444444444
3704-2021_03_20_192735.jpg,car,21,269,640,21,360,133,1,290,154,LTAdatasets/3704/annotate/3704-2021_03_20_192735.jpg,279.5,143.5,0.43671875,0.39861111111111114,0.0328125,0.058333333333333334
3704-2021_03_20_192735.jpg,car,15,349,640,17,360,129,1,364,146,LTAdatasets/3704/annotate/3704-2021_03_20_192735.jpg,356.5,137.5,0.55703125,0.3819444444444444,0.0234375,0.04722222222222222
3704-2021_03_20_192735.jpg,car,14,327,640,15,360,114,1,341,129,LTAdatasets/3704/annotate/3704-2021_03_20_192735.jpg,334.0,121.5,0.521875,0.3375,0.021875,0.041666666666666664
3704-2021_03_20_192735.jpg,car,18,388,640,14,360,109,1,406,123,LTAdatasets/3704/annotate/3704-2021_03_20_192735.jpg,397.0,116.0,0.6203125,0.32222222222222224,0.028125,0.03888888888888889
3704-2021_03_20_192735.jpg,car,30,134,640,22,360,141,1,164,163,LTAdatasets/3704/annotate/3704-2021_03_20_192735.jpg,149.0,152.0,0.2328125,0.4222222222222222,0.046875,0.06111111111111111
3704-2021_03_20_192735.jpg,car,29,79,640,16,360,154,1,108,170,LTAdatasets/3704/annotate/3704-2021_03_20_192735.jpg,93.5,162.0,0.14609375,0.45,0.0453125,0.044444444444444446
3704-2021_03_20_192735.jpg,bus,44,129,640,26,360,105,5,173,131,LTAdatasets/3704/annotate/3704-2021_03_20_192735.jpg,151.0,118.0,0.2359375,0.3277777777777778,0.06875,0.07222222222222222
