img_name,label_text,x_diff,x_left,x_pixels,y_diff,y_pixels,y_top,label,x_right,y_btm,img_path,x_center,y_center,x_center_scaled,y_center_scaled,width_scaled,height_scaled
2701-2021_03_20_183112.jpg,lorry_truck,39,2,640,23,480,397,2,41,420,LTAdatasets/2701/annotate/2701-2021_03_20_183112.jpg,21.5,408.5,0.03359375,0.8510416666666667,0.0609375,0.04791666666666667
2701-2021_03_20_090102.jpg,lorry_truck,25,547,640,24,480,129,2,572,153,LTAdatasets/2701/annotate/2701-2021_03_20_090102.jpg,559.5,141.0,0.87421875,0.29375,0.0390625,0.05
2701-2021_03_20_090102.jpg,lorry_truck,44,91,640,26,480,351,2,135,377,LTAdatasets/2701/annotate/2701-2021_03_20_090102.jpg,113.0,364.0,0.1765625,0.7583333333333333,0.06875,0.05416666666666667
2701-2021_03_20_090102.jpg,lorry_truck,30,163,640,18,480,347,2,193,365,LTAdatasets/2701/annotate/2701-2021_03_20_090102.jpg,178.0,356.0,0.278125,0.7416666666666667,0.046875,0.0375
2701-2021_03_20_090102.jpg,lorry_truck,31,162,640,24,480,313,2,193,337,LTAdatasets/2701/annotate/2701-2021_03_20_090102.jpg,177.5,325.0,0.27734375,0.6770833333333334,0.0484375,0.05
2701-2021_03_20_090102.jpg,lorry_truck,32,241,640,32,480,292,2,273,324,LTAdatasets/2701/annotate/2701-2021_03_20_090102.jpg,257.0,308.0,0.4015625,0.6416666666666667,0.05,0.06666666666666667
2701-2021_03_20_090102.jpg,lorry_truck,32,377,640,21,480,226,2,409,247,LTAdatasets/2701/annotate/2701-2021_03_20_090102.jpg,393.0,236.5,0.6140625,0.49270833333333336,0.05,0.04375
2701-2021_03_20_090102.jpg,lorry_truck,31,287,640,14,480,263,2,318,277,LTAdatasets/2701/annotate/2701-2021_03_20_090102.jpg,302.5,270.0,0.47265625,0.5625,0.0484375,0.029166666666666667
2701-2021_03_20_090102.jpg,lorry_truck,32,202,640,22,480,300,2,234,322,LTAdatasets/2701/annotate/2701-2021_03_20_090102.jpg,218.0,311.0,0.340625,0.6479166666666667,0.05,0.04583333333333333
2701-2021_03_20_090102.jpg,lorry_truck,42,79,640,27,480,373,2,121,400,LTAdatasets/2701/annotate/2701-2021_03_20_090102.jpg,100.0,386.5,0.15625,0.8052083333333333,0.065625,0.05625
2701-2021_03_20_090102.jpg,lorry_truck,41,194,640,20,480,325,2,235,345,LTAdatasets/2701/annotate/2701-2021_03_20_090102.jpg,214.5,335.0,0.33515625,0.6979166666666666,0.0640625,0.041666666666666664
2701-2021_03_20_090102.jpg,lorry_truck,38,283,640,25,480,279,2,321,304,LTAdatasets/2701/annotate/2701-2021_03_20_090102.jpg,302.0,291.5,0.471875,0.6072916666666667,0.059375,0.052083333333333336
2701-2021_03_20_090102.jpg,lorry_truck,39,328,640,20,480,248,2,367,268,LTAdatasets/2701/annotate/2701-2021_03_20_090102.jpg,347.5,258.0,0.54296875,0.5375,0.0609375,0.041666666666666664
2701-2021_03_20_090102.jpg,lorry_truck,28,429,640,25,480,198,2,457,223,LTAdatasets/2701/annotate/2701-2021_03_20_090102.jpg,443.0,210.5,0.6921875,0.43854166666666666,0.04375,0.052083333333333336
2701-2021_03_20_090102.jpg,lorry_truck,24,405,640,24,480,195,2,429,219,LTAdatasets/2701/annotate/2701-2021_03_20_090102.jpg,417.0,207.0,0.6515625,0.43125,0.0375,0.05
2701-2021_03_20_090102.jpg,lorry_truck,42,345,640,23,480,217,2,387,240,LTAdatasets/2701/annotate/2701-2021_03_20_090102.jpg,366.0,228.5,0.571875,0.47604166666666664,0.065625,0.04791666666666667
2701-2021_03_20_090102.jpg,lorry_truck,38,467,640,16,480,164,2,505,180,LTAdatasets/2701/annotate/2701-2021_03_20_090102.jpg,486.0,172.0,0.759375,0.35833333333333334,0.059375,0.03333333333333333
2701-2021_03_20_090102.jpg,lorry_truck,28,503,640,20,480,154,2,531,174,LTAdatasets/2701/annotate/2701-2021_03_20_090102.jpg,517.0,164.0,0.8078125,0.3416666666666667,0.04375,0.041666666666666664
2701-2021_03_20_085822.jpg,lorry_truck,59,73,640,30,480,371,2,132,401,LTAdatasets/2701/annotate/2701-2021_03_20_085822.jpg,102.5,386.0,0.16015625,0.8041666666666667,0.0921875,0.0625
2701-2021_03_20_085822.jpg,lorry_truck,52,53,640,32,480,339,2,105,371,LTAdatasets/2701/annotate/2701-2021_03_20_085822.jpg,79.0,355.0,0.1234375,0.7395833333333334,0.08125,0.06666666666666667
2701-2021_03_20_085822.jpg,lorry_truck,44,144,640,20,480,327,2,188,347,LTAdatasets/2701/annotate/2701-2021_03_20_085822.jpg,166.0,337.0,0.259375,0.7020833333333333,0.06875,0.041666666666666664
2701-2021_03_20_085822.jpg,lorry_truck,56,196,640,35,480,310,2,252,345,LTAdatasets/2701/annotate/2701-2021_03_20_085822.jpg,224.0,327.5,0.35,0.6822916666666666,0.0875,0.07291666666666667
2701-2021_03_20_085822.jpg,lorry_truck,45,264,640,37,480,278,2,309,315,LTAdatasets/2701/annotate/2701-2021_03_20_085822.jpg,286.5,296.5,0.44765625,0.6177083333333333,0.0703125,0.07708333333333334
2701-2021_03_20_085822.jpg,lorry_truck,37,309,640,23,480,241,2,346,264,LTAdatasets/2701/annotate/2701-2021_03_20_085822.jpg,327.5,252.5,0.51171875,0.5260416666666666,0.0578125,0.04791666666666667
2701-2021_03_20_085822.jpg,lorry_truck,37,350,640,32,480,231,2,387,263,LTAdatasets/2701/annotate/2701-2021_03_20_085822.jpg,368.5,247.0,0.57578125,0.5145833333333333,0.0578125,0.06666666666666667
2701-2021_03_20_085822.jpg,lorry_truck,28,383,640,28,480,219,2,411,247,LTAdatasets/2701/annotate/2701-2021_03_20_085822.jpg,397.0,233.0,0.6203125,0.48541666666666666,0.04375,0.058333333333333334
2701-2021_03_20_085822.jpg,lorry_truck,35,432,640,28,480,193,2,467,221,LTAdatasets/2701/annotate/2701-2021_03_20_085822.jpg,449.5,207.0,0.70234375,0.43125,0.0546875,0.058333333333333334
2701-2021_03_20_085822.jpg,lorry_truck,21,310,640,25,480,267,2,331,292,LTAdatasets/2701/annotate/2701-2021_03_20_085822.jpg,320.5,279.5,0.50078125,0.5822916666666667,0.0328125,0.052083333333333336
2701-2021_03_20_085822.jpg,lorry_truck,68,124,640,39,480,339,2,192,378,LTAdatasets/2701/annotate/2701-2021_03_20_085822.jpg,158.0,358.5,0.246875,0.746875,0.10625,0.08125
2701-2021_03_20_085822.jpg,lorry_truck,26,403,640,23,480,200,2,429,223,LTAdatasets/2701/annotate/2701-2021_03_20_085822.jpg,416.0,211.5,0.65,0.440625,0.040625,0.04791666666666667
2701-2021_03_20_085822.jpg,lorry_truck,27,458,640,21,480,178,2,485,199,LTAdatasets/2701/annotate/2701-2021_03_20_085822.jpg,471.5,188.5,0.73671875,0.3927083333333333,0.0421875,0.04375
2701-2021_03_20_085822.jpg,lorry_truck,26,236,640,20,480,285,2,262,305,LTAdatasets/2701/annotate/2701-2021_03_20_085822.jpg,249.0,295.0,0.3890625,0.6145833333333334,0.040625,0.041666666666666664
2701-2021_03_20_085822.jpg,lorry_truck,30,476,640,29,480,166,2,506,195,LTAdatasets/2701/annotate/2701-2021_03_20_085822.jpg,491.0,180.5,0.7671875,0.37604166666666666,0.046875,0.06041666666666667
2701-2021_03_20_085822.jpg,lorry_truck,20,507,640,18,480,141,2,527,159,LTAdatasets/2701/annotate/2701-2021_03_20_085822.jpg,517.0,150.0,0.8078125,0.3125,0.03125,0.0375
2701-2021_03_20_085822.jpg,lorry_truck,27,500,640,25,480,157,2,527,182,LTAdatasets/2701/annotate/2701-2021_03_20_085822.jpg,513.5,169.5,0.80234375,0.353125,0.0421875,0.052083333333333336
2701-2021_03_20_085822.jpg,lorry_truck,27,282,640,18,480,261,2,309,279,LTAdatasets/2701/annotate/2701-2021_03_20_085822.jpg,295.5,270.0,0.46171875,0.5625,0.0421875,0.0375
2701-2021_03_20_180410.jpg,lorry_truck,43,149,640,26,480,340,2,192,366,LTAdatasets/2701/annotate/2701-2021_03_20_180410.jpg,170.5,353.0,0.26640625,0.7354166666666667,0.0671875,0.05416666666666667
2701-2021_03_20_085501.jpg,lorry_truck,27,170,640,15,480,343,2,197,358,LTAdatasets/2701/annotate/2701-2021_03_20_085501.jpg,183.5,350.5,0.28671875,0.7302083333333333,0.0421875,0.03125
2701-2021_03_20_085501.jpg,lorry_truck,39,193,640,35,480,310,2,232,345,LTAdatasets/2701/annotate/2701-2021_03_20_085501.jpg,212.5,327.5,0.33203125,0.6822916666666666,0.0609375,0.07291666666666667
2701-2021_03_20_085501.jpg,lorry_truck,39,237,640,29,480,296,2,276,325,LTAdatasets/2701/annotate/2701-2021_03_20_085501.jpg,256.5,310.5,0.40078125,0.646875,0.0609375,0.06041666666666667
2701-2021_03_20_085501.jpg,lorry_truck,47,268,640,25,480,280,2,315,305,LTAdatasets/2701/annotate/2701-2021_03_20_085501.jpg,291.5,292.5,0.45546875,0.609375,0.0734375,0.052083333333333336
2701-2021_03_20_085501.jpg,lorry_truck,42,309,640,23,480,257,2,351,280,LTAdatasets/2701/annotate/2701-2021_03_20_085501.jpg,330.0,268.5,0.515625,0.559375,0.065625,0.04791666666666667
2701-2021_03_20_085501.jpg,lorry_truck,44,113,640,21,480,341,2,157,362,LTAdatasets/2701/annotate/2701-2021_03_20_085501.jpg,135.0,351.5,0.2109375,0.7322916666666667,0.06875,0.04375
2701-2021_03_20_085501.jpg,lorry_truck,35,79,640,20,480,380,2,114,400,LTAdatasets/2701/annotate/2701-2021_03_20_085501.jpg,96.5,390.0,0.15078125,0.8125,0.0546875,0.041666666666666664
2701-2021_03_20_085501.jpg,lorry_truck,33,352,640,18,480,240,2,385,258,LTAdatasets/2701/annotate/2701-2021_03_20_085501.jpg,368.5,249.0,0.57578125,0.51875,0.0515625,0.0375
2701-2021_03_20_085501.jpg,lorry_truck,30,381,640,23,480,227,2,411,250,LTAdatasets/2701/annotate/2701-2021_03_20_085501.jpg,396.0,238.5,0.61875,0.496875,0.046875,0.04791666666666667
2701-2021_03_20_085501.jpg,lorry_truck,43,208,640,20,480,294,2,251,314,LTAdatasets/2701/annotate/2701-2021_03_20_085501.jpg,229.5,304.0,0.35859375,0.6333333333333333,0.0671875,0.041666666666666664
2701-2021_03_20_085501.jpg,lorry_truck,33,368,640,20,480,217,2,401,237,LTAdatasets/2701/annotate/2701-2021_03_20_085501.jpg,384.5,227.0,0.60078125,0.47291666666666665,0.0515625,0.041666666666666664
2701-2021_03_20_085501.jpg,lorry_truck,33,409,640,27,480,207,2,442,234,LTAdatasets/2701/annotate/2701-2021_03_20_085501.jpg,425.5,220.5,0.66484375,0.459375,0.0515625,0.05625
2701-2021_03_20_085501.jpg,lorry_truck,46,272,640,21,480,258,2,318,279,LTAdatasets/2701/annotate/2701-2021_03_20_085501.jpg,295.0,268.5,0.4609375,0.559375,0.071875,0.04375
2701-2021_03_20_085501.jpg,lorry_truck,41,154,640,35,480,315,2,195,350,LTAdatasets/2701/annotate/2701-2021_03_20_085501.jpg,174.5,332.5,0.27265625,0.6927083333333334,0.0640625,0.07291666666666667
2701-2021_03_20_085501.jpg,lorry_truck,30,432,640,21,480,195,2,462,216,LTAdatasets/2701/annotate/2701-2021_03_20_085501.jpg,447.0,205.5,0.6984375,0.428125,0.046875,0.04375
2701-2021_03_20_085501.jpg,van,24,144,640,15,480,359,3,168,374,LTAdatasets/2701/annotate/2701-2021_03_20_085501.jpg,156.0,366.5,0.24375,0.7635416666666667,0.0375,0.03125
2701-2021_03_20_085501.jpg,lorry_truck,37,7,640,19,480,399,2,44,418,LTAdatasets/2701/annotate/2701-2021_03_20_085501.jpg,25.5,408.5,0.03984375,0.8510416666666667,0.0578125,0.03958333333333333
2701-2021_03_20_085501.jpg,lorry_truck,24,103,640,29,480,361,2,127,390,LTAdatasets/2701/annotate/2701-2021_03_20_085501.jpg,115.0,375.5,0.1796875,0.7822916666666667,0.0375,0.06041666666666667
2701-2021_03_20_085501.jpg,lorry_truck,31,241,640,17,480,283,2,272,300,LTAdatasets/2701/annotate/2701-2021_03_20_085501.jpg,256.5,291.5,0.40078125,0.6072916666666667,0.0484375,0.035416666666666666
2701-2021_03_20_081319.jpg,van,56,149,640,48,480,323,3,205,371,LTAdatasets/2701/annotate/2701-2021_03_20_081319.jpg,177.0,347.0,0.2765625,0.7229166666666667,0.0875,0.1
2701-2021_03_20_081319.jpg,van,33,103,640,37,480,345,3,136,382,LTAdatasets/2701/annotate/2701-2021_03_20_081319.jpg,119.5,363.5,0.18671875,0.7572916666666667,0.0515625,0.07708333333333334
2701-2021_03_20_081319.jpg,van,28,206,640,28,480,301,3,234,329,LTAdatasets/2701/annotate/2701-2021_03_20_081319.jpg,220.0,315.0,0.34375,0.65625,0.04375,0.058333333333333334
2701-2021_03_20_081319.jpg,van,52,235,640,40,480,284,3,287,324,LTAdatasets/2701/annotate/2701-2021_03_20_081319.jpg,261.0,304.0,0.4078125,0.6333333333333333,0.08125,0.08333333333333333
2701-2021_03_20_081319.jpg,van,52,277,640,29,480,264,3,329,293,LTAdatasets/2701/annotate/2701-2021_03_20_081319.jpg,303.0,278.5,0.4734375,0.5802083333333333,0.08125,0.06041666666666667
2701-2021_03_20_081319.jpg,van,39,326,640,27,480,249,3,365,276,LTAdatasets/2701/annotate/2701-2021_03_20_081319.jpg,345.5,262.5,0.53984375,0.546875,0.0609375,0.05625
2701-2021_03_20_081319.jpg,van,37,359,640,28,480,223,3,396,251,LTAdatasets/2701/annotate/2701-2021_03_20_081319.jpg,377.5,237.0,0.58984375,0.49375,0.0578125,0.058333333333333334
2701-2021_03_20_081319.jpg,van,40,424,640,32,480,189,3,464,221,LTAdatasets/2701/annotate/2701-2021_03_20_081319.jpg,444.0,205.0,0.69375,0.4270833333333333,0.0625,0.06666666666666667
2701-2021_03_20_081319.jpg,van,33,463,640,30,480,174,3,496,204,LTAdatasets/2701/annotate/2701-2021_03_20_081319.jpg,479.5,189.0,0.74921875,0.39375,0.0515625,0.0625
2701-2021_03_20_081319.jpg,van,35,497,640,25,480,157,3,532,182,LTAdatasets/2701/annotate/2701-2021_03_20_081319.jpg,514.5,169.5,0.80390625,0.353125,0.0546875,0.052083333333333336
2701-2021_03_20_081319.jpg,van,29,458,640,27,480,160,3,487,187,LTAdatasets/2701/annotate/2701-2021_03_20_081319.jpg,472.5,173.5,0.73828125,0.3614583333333333,0.0453125,0.05625
2701-2021_03_20_073937.jpg,lorry_truck,38,102,640,39,480,354,2,140,393,LTAdatasets/2701/annotate/2701-2021_03_20_073937.jpg,121.0,373.5,0.1890625,0.778125,0.059375,0.08125
2701-2021_03_20_073937.jpg,lorry_truck,52,156,640,24,480,335,2,208,359,LTAdatasets/2701/annotate/2701-2021_03_20_073937.jpg,182.0,347.0,0.284375,0.7229166666666667,0.08125,0.05
2701-2021_03_20_073937.jpg,lorry_truck,27,225,640,30,480,306,2,252,336,LTAdatasets/2701/annotate/2701-2021_03_20_073937.jpg,238.5,321.0,0.37265625,0.66875,0.0421875,0.0625
2701-2021_03_20_073937.jpg,lorry_truck,28,251,640,27,480,293,2,279,320,LTAdatasets/2701/annotate/2701-2021_03_20_073937.jpg,265.0,306.5,0.4140625,0.6385416666666667,0.04375,0.05625
2701-2021_03_20_073937.jpg,lorry_truck,30,276,640,32,480,277,2,306,309,LTAdatasets/2701/annotate/2701-2021_03_20_073937.jpg,291.0,293.0,0.4546875,0.6104166666666667,0.046875,0.06666666666666667
2701-2021_03_20_073937.jpg,van,16,308,640,16,480,275,3,324,291,LTAdatasets/2701/annotate/2701-2021_03_20_073937.jpg,316.0,283.0,0.49375,0.5895833333333333,0.025,0.03333333333333333
2701-2021_03_20_093103.jpg,lorry_truck,37,81,640,37,480,362,2,118,399,LTAdatasets/2701/annotate/2701-2021_03_20_093103.jpg,99.5,380.5,0.15546875,0.7927083333333333,0.0578125,0.07708333333333334
2701-2021_03_20_093103.jpg,lorry_truck,31,206,640,23,480,316,2,237,339,LTAdatasets/2701/annotate/2701-2021_03_20_093103.jpg,221.5,327.5,0.34609375,0.6822916666666666,0.0484375,0.04791666666666667
2701-2021_03_20_093103.jpg,lorry_truck,41,302,640,37,480,258,2,343,295,LTAdatasets/2701/annotate/2701-2021_03_20_093103.jpg,322.5,276.5,0.50390625,0.5760416666666667,0.0640625,0.07708333333333334
2701-2021_03_20_093103.jpg,lorry_truck,37,349,640,24,480,240,2,386,264,LTAdatasets/2701/annotate/2701-2021_03_20_093103.jpg,367.5,252.0,0.57421875,0.525,0.0578125,0.05
2701-2021_03_20_093103.jpg,lorry_truck,28,376,640,17,480,212,2,404,229,LTAdatasets/2701/annotate/2701-2021_03_20_093103.jpg,390.0,220.5,0.609375,0.459375,0.04375,0.035416666666666666
2701-2021_03_20_093103.jpg,lorry_truck,27,136,640,13,480,332,2,163,345,LTAdatasets/2701/annotate/2701-2021_03_20_093103.jpg,149.5,338.5,0.23359375,0.7052083333333333,0.0421875,0.027083333333333334
2701-2021_03_20_093103.jpg,lorry_truck,30,131,640,35,480,344,2,161,379,LTAdatasets/2701/annotate/2701-2021_03_20_093103.jpg,146.0,361.5,0.228125,0.753125,0.046875,0.07291666666666667
2701-2021_03_20_093103.jpg,lorry_truck,20,235,640,32,480,272,2,255,304,LTAdatasets/2701/annotate/2701-2021_03_20_093103.jpg,245.0,288.0,0.3828125,0.6,0.03125,0.06666666666666667
2701-2021_03_20_093103.jpg,lorry_truck,30,583,640,21,480,111,2,613,132,LTAdatasets/2701/annotate/2701-2021_03_20_093103.jpg,598.0,121.5,0.934375,0.253125,0.046875,0.04375
2701-2021_03_20_093103.jpg,lorry_truck,15,461,640,15,480,171,2,476,186,LTAdatasets/2701/annotate/2701-2021_03_20_093103.jpg,468.5,178.5,0.73203125,0.371875,0.0234375,0.03125
2701-2021_03_20_093103.jpg,lorry_truck,20,433,640,20,480,196,2,453,216,LTAdatasets/2701/annotate/2701-2021_03_20_093103.jpg,443.0,206.0,0.6921875,0.42916666666666664,0.03125,0.041666666666666664
2701-2021_03_20_093103.jpg,lorry_truck,24,405,640,14,480,198,2,429,212,LTAdatasets/2701/annotate/2701-2021_03_20_093103.jpg,417.0,205.0,0.6515625,0.4270833333333333,0.0375,0.029166666666666667
2701-2021_03_20_093103.jpg,lorry_truck,37,14,640,20,480,396,2,51,416,LTAdatasets/2701/annotate/2701-2021_03_20_093103.jpg,32.5,406.0,0.05078125,0.8458333333333333,0.0578125,0.041666666666666664
2701-2021_03_20_093103.jpg,lorry_truck,18,405,640,16,480,216,2,423,232,LTAdatasets/2701/annotate/2701-2021_03_20_093103.jpg,414.0,224.0,0.646875,0.4666666666666667,0.028125,0.03333333333333333
2701-2021_03_20_093103.jpg,lorry_truck,21,537,640,15,480,143,2,558,158,LTAdatasets/2701/annotate/2701-2021_03_20_093103.jpg,547.5,150.5,0.85546875,0.31354166666666666,0.0328125,0.03125
2701-2021_03_20_093103.jpg,lorry_truck,26,497,640,20,480,160,2,523,180,LTAdatasets/2701/annotate/2701-2021_03_20_093103.jpg,510.0,170.0,0.796875,0.3541666666666667,0.040625,0.041666666666666664
2701-2021_03_20_093103.jpg,lorry_truck,31,257,640,35,480,283,2,288,318,LTAdatasets/2701/annotate/2701-2021_03_20_093103.jpg,272.5,300.5,0.42578125,0.6260416666666667,0.0484375,0.07291666666666667
2701-2021_03_20_093103.jpg,lorry_truck,30,309,640,12,480,244,2,339,256,LTAdatasets/2701/annotate/2701-2021_03_20_093103.jpg,324.0,250.0,0.50625,0.5208333333333334,0.046875,0.025
2701-2021_03_20_094904.jpg,lorry_truck,58,85,640,51,480,344,2,143,395,LTAdatasets/2701/annotate/2701-2021_03_20_094904.jpg,114.0,369.5,0.178125,0.7697916666666667,0.090625,0.10625
2701-2021_03_20_094904.jpg,lorry_truck,59,161,640,45,480,323,2,220,368,LTAdatasets/2701/annotate/2701-2021_03_20_094904.jpg,190.5,345.5,0.29765625,0.7197916666666667,0.0921875,0.09375
2701-2021_03_20_094904.jpg,lorry_truck,50,235,640,29,480,296,2,285,325,LTAdatasets/2701/annotate/2701-2021_03_20_094904.jpg,260.0,310.5,0.40625,0.646875,0.078125,0.06041666666666667
2701-2021_03_20_094904.jpg,lorry_truck,42,278,640,33,480,268,2,320,301,LTAdatasets/2701/annotate/2701-2021_03_20_094904.jpg,299.0,284.5,0.4671875,0.5927083333333333,0.065625,0.06875
2701-2021_03_20_094904.jpg,lorry_truck,42,309,640,28,480,252,2,351,280,LTAdatasets/2701/annotate/2701-2021_03_20_094904.jpg,330.0,266.0,0.515625,0.5541666666666667,0.065625,0.058333333333333334
2701-2021_03_20_094904.jpg,lorry_truck,27,350,640,22,480,243,2,377,265,LTAdatasets/2701/annotate/2701-2021_03_20_094904.jpg,363.5,254.0,0.56796875,0.5291666666666667,0.0421875,0.04583333333333333
2701-2021_03_20_094904.jpg,lorry_truck,21,376,640,20,480,227,2,397,247,LTAdatasets/2701/annotate/2701-2021_03_20_094904.jpg,386.5,237.0,0.60390625,0.49375,0.0328125,0.041666666666666664
2701-2021_03_20_094904.jpg,lorry_truck,15,400,640,21,480,218,2,415,239,LTAdatasets/2701/annotate/2701-2021_03_20_094904.jpg,407.5,228.5,0.63671875,0.47604166666666664,0.0234375,0.04375
2701-2021_03_20_094904.jpg,lorry_truck,33,411,640,21,480,195,2,444,216,LTAdatasets/2701/annotate/2701-2021_03_20_094904.jpg,427.5,205.5,0.66796875,0.428125,0.0515625,0.04375
2701-2021_03_20_094904.jpg,lorry_truck,21,257,640,18,480,271,2,278,289,LTAdatasets/2701/annotate/2701-2021_03_20_094904.jpg,267.5,280.0,0.41796875,0.5833333333333334,0.0328125,0.0375
2701-2021_03_20_094904.jpg,lorry_truck,34,9,640,22,480,395,2,43,417,LTAdatasets/2701/annotate/2701-2021_03_20_094904.jpg,26.0,406.0,0.040625,0.8458333333333333,0.053125,0.04583333333333333
2701-2021_03_20_183412.jpg,lorry_truck,25,389,640,25,480,215,2,414,240,LTAdatasets/2701/annotate/2701-2021_03_20_183412.jpg,401.5,227.5,0.62734375,0.4739583333333333,0.0390625,0.052083333333333336
2701-2021_03_20_183412.jpg,lorry_truck,31,204,640,35,480,284,2,235,319,LTAdatasets/2701/annotate/2701-2021_03_20_183412.jpg,219.5,301.5,0.34296875,0.628125,0.0484375,0.07291666666666667
2701-2021_03_20_094305.jpg,lorry_truck,52,172,640,29,480,328,2,224,357,LTAdatasets/2701/annotate/2701-2021_03_20_094305.jpg,198.0,342.5,0.309375,0.7135416666666666,0.08125,0.06041666666666667
2701-2021_03_20_094305.jpg,lorry_truck,45,88,640,32,480,366,2,133,398,LTAdatasets/2701/annotate/2701-2021_03_20_094305.jpg,110.5,382.0,0.17265625,0.7958333333333333,0.0703125,0.06666666666666667
2701-2021_03_20_080939.jpg,lorry_truck,28,141,640,18,480,351,2,169,369,LTAdatasets/2701/annotate/2701-2021_03_20_080939.jpg,155.0,360.0,0.2421875,0.75,0.04375,0.0375
2701-2021_03_20_080939.jpg,lorry_truck,40,91,640,29,480,360,2,131,389,LTAdatasets/2701/annotate/2701-2021_03_20_080939.jpg,111.0,374.5,0.1734375,0.7802083333333333,0.0625,0.06041666666666667
2701-2021_03_20_080939.jpg,lorry_truck,30,190,640,26,480,318,2,220,344,LTAdatasets/2701/annotate/2701-2021_03_20_080939.jpg,205.0,331.0,0.3203125,0.6895833333333333,0.046875,0.05416666666666667
2701-2021_03_20_080939.jpg,lorry_truck,20,239,640,21,480,306,2,259,327,LTAdatasets/2701/annotate/2701-2021_03_20_080939.jpg,249.0,316.5,0.3890625,0.659375,0.03125,0.04375
2701-2021_03_20_080939.jpg,lorry_truck,25,239,640,17,480,285,2,264,302,LTAdatasets/2701/annotate/2701-2021_03_20_080939.jpg,251.5,293.5,0.39296875,0.6114583333333333,0.0390625,0.035416666666666666
2701-2021_03_20_080939.jpg,lorry_truck,21,277,640,20,480,282,2,298,302,LTAdatasets/2701/annotate/2701-2021_03_20_080939.jpg,287.5,292.0,0.44921875,0.6083333333333333,0.0328125,0.041666666666666664
2701-2021_03_20_080939.jpg,lorry_truck,22,314,640,23,480,246,2,336,269,LTAdatasets/2701/annotate/2701-2021_03_20_080939.jpg,325.0,257.5,0.5078125,0.5364583333333334,0.034375,0.04791666666666667
2701-2021_03_20_080939.jpg,lorry_truck,40,350,640,34,480,231,2,390,265,LTAdatasets/2701/annotate/2701-2021_03_20_080939.jpg,370.0,248.0,0.578125,0.5166666666666667,0.0625,0.07083333333333333
2701-2021_03_20_080939.jpg,lorry_truck,25,451,640,17,480,191,2,476,208,LTAdatasets/2701/annotate/2701-2021_03_20_080939.jpg,463.5,199.5,0.72421875,0.415625,0.0390625,0.035416666666666666
2701-2021_03_20_080939.jpg,lorry_truck,30,500,640,32,480,155,2,530,187,LTAdatasets/2701/annotate/2701-2021_03_20_080939.jpg,515.0,171.0,0.8046875,0.35625,0.046875,0.06666666666666667
2701-2021_03_20_080939.jpg,lorry_truck,8,343,640,26,480,234,2,351,260,LTAdatasets/2701/annotate/2701-2021_03_20_080939.jpg,347.0,247.0,0.5421875,0.5145833333333333,0.0125,0.05416666666666667
2701-2021_03_20_080939.jpg,lorry_truck,28,422,640,17,480,205,2,450,222,LTAdatasets/2701/annotate/2701-2021_03_20_080939.jpg,436.0,213.5,0.68125,0.44479166666666664,0.04375,0.035416666666666666
2701-2021_03_20_080939.jpg,lorry_truck,20,166,640,21,480,327,2,186,348,LTAdatasets/2701/annotate/2701-2021_03_20_080939.jpg,176.0,337.5,0.275,0.703125,0.03125,0.04375
2701-2021_03_20_080939.jpg,lorry_truck,17,132,640,23,480,337,2,149,360,LTAdatasets/2701/annotate/2701-2021_03_20_080939.jpg,140.5,348.5,0.21953125,0.7260416666666667,0.0265625,0.04791666666666667
2701-2021_03_20_080939.jpg,lorry_truck,37,386,640,35,480,211,2,423,246,LTAdatasets/2701/annotate/2701-2021_03_20_080939.jpg,404.5,228.5,0.63203125,0.47604166666666664,0.0578125,0.07291666666666667
2701-2021_03_20_080939.jpg,lorry_truck,30,530,640,23,480,140,2,560,163,LTAdatasets/2701/annotate/2701-2021_03_20_080939.jpg,545.0,151.5,0.8515625,0.315625,0.046875,0.04791666666666667
2701-2021_03_20_080939.jpg,lorry_truck,27,465,640,24,480,173,2,492,197,LTAdatasets/2701/annotate/2701-2021_03_20_080939.jpg,478.5,185.0,0.74765625,0.3854166666666667,0.0421875,0.05
2701-2021_03_20_074918.jpg,lorry_truck,23,274,640,25,480,285,2,297,310,LTAdatasets/2701/annotate/2701-2021_03_20_074918.jpg,285.5,297.5,0.44609375,0.6197916666666666,0.0359375,0.052083333333333336
2701-2021_03_20_074918.jpg,lorry_truck,22,287,640,32,480,252,2,309,284,LTAdatasets/2701/annotate/2701-2021_03_20_074918.jpg,298.0,268.0,0.465625,0.5583333333333333,0.034375,0.06666666666666667
2701-2021_03_20_074918.jpg,lorry_truck,28,386,640,22,480,219,2,414,241,LTAdatasets/2701/annotate/2701-2021_03_20_074918.jpg,400.0,230.0,0.625,0.4791666666666667,0.04375,0.04583333333333333
2701-2021_03_20_074918.jpg,lorry_truck,33,425,640,21,480,184,2,458,205,LTAdatasets/2701/annotate/2701-2021_03_20_074918.jpg,441.5,194.5,0.68984375,0.40520833333333334,0.0515625,0.04375
2701-2021_03_20_074918.jpg,lorry_truck,17,502,640,18,480,164,2,519,182,LTAdatasets/2701/annotate/2701-2021_03_20_074918.jpg,510.5,173.0,0.79765625,0.36041666666666666,0.0265625,0.0375
2701-2021_03_20_074918.jpg,lorry_truck,46,221,640,21,480,306,2,267,327,LTAdatasets/2701/annotate/2701-2021_03_20_074918.jpg,244.0,316.5,0.38125,0.659375,0.071875,0.04375
2701-2021_03_20_074918.jpg,lorry_truck,37,182,640,23,480,330,2,219,353,LTAdatasets/2701/annotate/2701-2021_03_20_074918.jpg,200.5,341.5,0.31328125,0.7114583333333333,0.0578125,0.04791666666666667
2701-2021_03_20_074918.jpg,lorry_truck,35,112,640,30,480,353,2,147,383,LTAdatasets/2701/annotate/2701-2021_03_20_074918.jpg,129.5,368.0,0.20234375,0.7666666666666667,0.0546875,0.0625
2701-2021_03_20_074918.jpg,lorry_truck,16,254,640,18,480,281,2,270,299,LTAdatasets/2701/annotate/2701-2021_03_20_074918.jpg,262.0,290.0,0.409375,0.6041666666666666,0.025,0.0375
2701-2021_03_20_093724.jpg,lorry_truck,48,113,640,23,480,359,2,161,382,LTAdatasets/2701/annotate/2701-2021_03_20_093724.jpg,137.0,370.5,0.2140625,0.771875,0.075,0.04791666666666667
2701-2021_03_20_093724.jpg,lorry_truck,25,238,640,25,480,304,2,263,329,LTAdatasets/2701/annotate/2701-2021_03_20_093724.jpg,250.5,316.5,0.39140625,0.659375,0.0390625,0.052083333333333336
2701-2021_03_20_093724.jpg,lorry_truck,21,280,640,21,480,282,2,301,303,LTAdatasets/2701/annotate/2701-2021_03_20_093724.jpg,290.5,292.5,0.45390625,0.609375,0.0328125,0.04375
2701-2021_03_20_093724.jpg,lorry_truck,20,312,640,25,480,259,2,332,284,LTAdatasets/2701/annotate/2701-2021_03_20_093724.jpg,322.0,271.5,0.503125,0.565625,0.03125,0.052083333333333336
2701-2021_03_20_093724.jpg,lorry_truck,16,374,640,29,480,225,2,390,254,LTAdatasets/2701/annotate/2701-2021_03_20_093724.jpg,382.0,239.5,0.596875,0.49895833333333334,0.025,0.06041666666666667
2701-2021_03_20_093724.jpg,lorry_truck,28,420,640,14,480,208,2,448,222,LTAdatasets/2701/annotate/2701-2021_03_20_093724.jpg,434.0,215.0,0.678125,0.4479166666666667,0.04375,0.029166666666666667
2701-2021_03_20_093724.jpg,lorry_truck,18,400,640,16,480,203,2,418,219,LTAdatasets/2701/annotate/2701-2021_03_20_093724.jpg,409.0,211.0,0.6390625,0.4395833333333333,0.028125,0.03333333333333333
2701-2021_03_20_093724.jpg,lorry_truck,33,174,640,20,480,333,2,207,353,LTAdatasets/2701/annotate/2701-2021_03_20_093724.jpg,190.5,343.0,0.29765625,0.7145833333333333,0.0515625,0.041666666666666664
2701-2021_03_20_093724.jpg,lorry_truck,33,8,640,28,480,393,2,41,421,LTAdatasets/2701/annotate/2701-2021_03_20_093724.jpg,24.5,407.0,0.03828125,0.8479166666666667,0.0515625,0.058333333333333334
2701-2021_03_20_093724.jpg,lorry_truck,27,103,640,16,480,331,2,130,347,LTAdatasets/2701/annotate/2701-2021_03_20_093724.jpg,116.5,339.0,0.18203125,0.70625,0.0421875,0.03333333333333333
2701-2021_03_20_093724.jpg,lorry_truck,21,348,640,15,480,248,2,369,263,LTAdatasets/2701/annotate/2701-2021_03_20_093724.jpg,358.5,255.5,0.56015625,0.5322916666666667,0.0328125,0.03125
2701-2021_03_20_093724.jpg,lorry_truck,17,330,640,16,480,240,2,347,256,LTAdatasets/2701/annotate/2701-2021_03_20_093724.jpg,338.5,248.0,0.52890625,0.5166666666666667,0.0265625,0.03333333333333333
2701-2021_03_20_093724.jpg,lorry_truck,20,296,640,13,480,261,2,316,274,LTAdatasets/2701/annotate/2701-2021_03_20_093724.jpg,306.0,267.5,0.478125,0.5572916666666666,0.03125,0.027083333333333334
2701-2021_03_20_093724.jpg,lorry_truck,28,247,640,25,480,279,2,275,304,LTAdatasets/2701/annotate/2701-2021_03_20_093724.jpg,261.0,291.5,0.4078125,0.6072916666666667,0.04375,0.052083333333333336
2701-2021_03_20_093724.jpg,lorry_truck,30,503,640,23,480,152,2,533,175,LTAdatasets/2701/annotate/2701-2021_03_20_093724.jpg,518.0,163.5,0.809375,0.340625,0.046875,0.04791666666666667
2701-2021_03_20_093724.jpg,lorry_truck,27,446,640,16,480,193,2,473,209,LTAdatasets/2701/annotate/2701-2021_03_20_093724.jpg,459.5,201.0,0.71796875,0.41875,0.0421875,0.03333333333333333
2701-2021_03_20_075518.jpg,lorry_truck,20,404,640,23,480,195,2,424,218,LTAdatasets/2701/annotate/2701-2021_03_20_075518.jpg,414.0,206.5,0.646875,0.43020833333333336,0.03125,0.04791666666666667
2701-2021_03_20_075518.jpg,lorry_truck,17,271,640,24,480,290,2,288,314,LTAdatasets/2701/annotate/2701-2021_03_20_075518.jpg,279.5,302.0,0.43671875,0.6291666666666667,0.0265625,0.05
2701-2021_03_20_075518.jpg,lorry_truck,25,220,640,15,480,315,2,245,330,LTAdatasets/2701/annotate/2701-2021_03_20_075518.jpg,232.5,322.5,0.36328125,0.671875,0.0390625,0.03125
2701-2021_03_20_075518.jpg,lorry_truck,54,172,640,36,480,323,2,226,359,LTAdatasets/2701/annotate/2701-2021_03_20_075518.jpg,199.0,341.0,0.3109375,0.7104166666666667,0.084375,0.075
2701-2021_03_20_075518.jpg,lorry_truck,44,98,640,24,480,360,2,142,384,LTAdatasets/2701/annotate/2701-2021_03_20_075518.jpg,120.0,372.0,0.1875,0.775,0.06875,0.05
2701-2021_03_20_075518.jpg,lorry_truck,30,158,640,31,480,317,2,188,348,LTAdatasets/2701/annotate/2701-2021_03_20_075518.jpg,173.0,332.5,0.2703125,0.6927083333333334,0.046875,0.06458333333333334
2701-2021_03_20_075518.jpg,lorry_truck,37,218,640,30,480,288,2,255,318,LTAdatasets/2701/annotate/2701-2021_03_20_075518.jpg,236.5,303.0,0.36953125,0.63125,0.0578125,0.0625
2701-2021_03_20_181551.jpg,lorry_truck,30,371,640,26,480,227,2,401,253,LTAdatasets/2701/annotate/2701-2021_03_20_181551.jpg,386.0,240.0,0.603125,0.5,0.046875,0.05416666666666667
2701-2021_03_20_181551.jpg,lorry_truck,15,503,640,23,480,148,2,518,171,LTAdatasets/2701/annotate/2701-2021_03_20_181551.jpg,510.5,159.5,0.79765625,0.33229166666666665,0.0234375,0.04791666666666667
2701-2021_03_20_181551.jpg,lorry_truck,29,132,640,23,480,334,2,161,357,LTAdatasets/2701/annotate/2701-2021_03_20_181551.jpg,146.5,345.5,0.22890625,0.7197916666666667,0.0453125,0.04791666666666667
2701-2021_03_20_092803.jpg,lorry_truck,21,137,640,25,480,324,2,158,349,LTAdatasets/2701/annotate/2701-2021_03_20_092803.jpg,147.5,336.5,0.23046875,0.7010416666666667,0.0328125,0.052083333333333336
2701-2021_03_20_092803.jpg,lorry_truck,19,121,640,26,480,359,2,140,385,LTAdatasets/2701/annotate/2701-2021_03_20_092803.jpg,130.5,372.0,0.20390625,0.775,0.0296875,0.05416666666666667
2701-2021_03_20_092803.jpg,lorry_truck,19,196,640,21,480,309,2,215,330,LTAdatasets/2701/annotate/2701-2021_03_20_092803.jpg,205.5,319.5,0.32109375,0.665625,0.0296875,0.04375
2701-2021_03_20_092803.jpg,lorry_truck,39,226,640,34,480,297,2,265,331,LTAdatasets/2701/annotate/2701-2021_03_20_092803.jpg,245.5,314.0,0.38359375,0.6541666666666667,0.0609375,0.07083333333333333
2701-2021_03_20_092803.jpg,lorry_truck,47,293,640,37,480,258,2,340,295,LTAdatasets/2701/annotate/2701-2021_03_20_092803.jpg,316.5,276.5,0.49453125,0.5760416666666667,0.0734375,0.07708333333333334
2701-2021_03_20_092803.jpg,lorry_truck,28,324,640,23,480,243,2,352,266,LTAdatasets/2701/annotate/2701-2021_03_20_092803.jpg,338.0,254.5,0.528125,0.5302083333333333,0.04375,0.04791666666666667
2701-2021_03_20_092803.jpg,lorry_truck,23,256,640,25,480,289,2,279,314,LTAdatasets/2701/annotate/2701-2021_03_20_092803.jpg,267.5,301.5,0.41796875,0.628125,0.0359375,0.052083333333333336
2701-2021_03_20_092803.jpg,lorry_truck,19,407,640,17,480,215,2,426,232,LTAdatasets/2701/annotate/2701-2021_03_20_092803.jpg,416.5,223.5,0.65078125,0.465625,0.0296875,0.035416666666666666
2701-2021_03_20_092803.jpg,lorry_truck,30,377,640,15,480,226,2,407,241,LTAdatasets/2701/annotate/2701-2021_03_20_092803.jpg,392.0,233.5,0.6125,0.4864583333333333,0.046875,0.03125
2701-2021_03_20_092803.jpg,lorry_truck,18,466,640,17,480,184,2,484,201,LTAdatasets/2701/annotate/2701-2021_03_20_092803.jpg,475.0,192.5,0.7421875,0.4010416666666667,0.028125,0.035416666666666666
2701-2021_03_20_092803.jpg,lorry_truck,25,478,640,19,480,174,2,503,193,LTAdatasets/2701/annotate/2701-2021_03_20_092803.jpg,490.5,183.5,0.76640625,0.38229166666666664,0.0390625,0.03958333333333333
2701-2021_03_20_092803.jpg,lorry_truck,18,518,640,15,480,155,2,536,170,LTAdatasets/2701/annotate/2701-2021_03_20_092803.jpg,527.0,162.5,0.8234375,0.3385416666666667,0.028125,0.03125
2701-2021_03_20_092803.jpg,lorry_truck,20,264,640,17,480,270,2,284,287,LTAdatasets/2701/annotate/2701-2021_03_20_092803.jpg,274.0,278.5,0.428125,0.5802083333333333,0.03125,0.035416666666666666
2701-2021_03_20_092803.jpg,lorry_truck,28,150,640,24,480,340,2,178,364,LTAdatasets/2701/annotate/2701-2021_03_20_092803.jpg,164.0,352.0,0.25625,0.7333333333333333,0.04375,0.05
2701-2021_03_20_092803.jpg,lorry_truck,28,442,640,22,480,193,2,470,215,LTAdatasets/2701/annotate/2701-2021_03_20_092803.jpg,456.0,204.0,0.7125,0.425,0.04375,0.04583333333333333
2701-2021_03_20_191014.jpg,lorry_truck,13,567,640,15,480,124,2,580,139,LTAdatasets/2701/annotate/2701-2021_03_20_191014.jpg,573.5,131.5,0.89609375,0.27395833333333336,0.0203125,0.03125
2701-2021_03_20_191014.jpg,lorry_truck,15,621,640,21,480,94,2,636,115,LTAdatasets/2701/annotate/2701-2021_03_20_191014.jpg,628.5,104.5,0.98203125,0.21770833333333334,0.0234375,0.04375
2701-2021_03_20_095505.jpg,lorry_truck,36,164,640,31,480,329,2,200,360,LTAdatasets/2701/annotate/2701-2021_03_20_095505.jpg,182.0,344.5,0.284375,0.7177083333333333,0.05625,0.06458333333333334
2701-2021_03_20_095505.jpg,lorry_truck,55,72,640,24,480,369,2,127,393,LTAdatasets/2701/annotate/2701-2021_03_20_095505.jpg,99.5,381.0,0.15546875,0.79375,0.0859375,0.05
2701-2021_03_20_095505.jpg,lorry_truck,34,208,640,21,480,313,2,242,334,LTAdatasets/2701/annotate/2701-2021_03_20_095505.jpg,225.0,323.5,0.3515625,0.6739583333333333,0.053125,0.04375
2701-2021_03_20_095505.jpg,lorry_truck,37,237,640,20,480,307,2,274,327,LTAdatasets/2701/annotate/2701-2021_03_20_095505.jpg,255.5,317.0,0.39921875,0.6604166666666667,0.0578125,0.041666666666666664
2701-2021_03_20_095505.jpg,lorry_truck,24,307,640,15,480,248,2,331,263,LTAdatasets/2701/annotate/2701-2021_03_20_095505.jpg,319.0,255.5,0.4984375,0.5322916666666667,0.0375,0.03125
2701-2021_03_20_095505.jpg,lorry_truck,27,383,640,23,480,220,2,410,243,LTAdatasets/2701/annotate/2701-2021_03_20_095505.jpg,396.5,231.5,0.61953125,0.4822916666666667,0.0421875,0.04791666666666667
2701-2021_03_20_095505.jpg,lorry_truck,25,430,640,23,480,198,2,455,221,LTAdatasets/2701/annotate/2701-2021_03_20_095505.jpg,442.5,209.5,0.69140625,0.43645833333333334,0.0390625,0.04791666666666667
2701-2021_03_20_095505.jpg,lorry_truck,20,409,640,27,480,193,2,429,220,LTAdatasets/2701/annotate/2701-2021_03_20_095505.jpg,419.0,206.5,0.6546875,0.43020833333333336,0.03125,0.05625
2701-2021_03_20_095505.jpg,lorry_truck,31,453,640,18,480,183,2,484,201,LTAdatasets/2701/annotate/2701-2021_03_20_095505.jpg,468.5,192.0,0.73203125,0.4,0.0484375,0.0375
2701-2021_03_20_095505.jpg,lorry_truck,43,304,640,22,480,260,2,347,282,LTAdatasets/2701/annotate/2701-2021_03_20_095505.jpg,325.5,271.0,0.50859375,0.5645833333333333,0.0671875,0.04583333333333333
2701-2021_03_20_095505.jpg,lorry_truck,20,240,640,24,480,283,2,260,307,LTAdatasets/2701/annotate/2701-2021_03_20_095505.jpg,250.0,295.0,0.390625,0.6145833333333334,0.03125,0.05
2701-2021_03_20_100105.jpg,lorry_truck,22,121,640,18,480,340,2,143,358,LTAdatasets/2701/annotate/2701-2021_03_20_100105.jpg,132.0,349.0,0.20625,0.7270833333333333,0.034375,0.0375
2701-2021_03_20_100105.jpg,lorry_truck,25,137,640,28,480,347,2,162,375,LTAdatasets/2701/annotate/2701-2021_03_20_100105.jpg,149.5,361.0,0.23359375,0.7520833333333333,0.0390625,0.058333333333333334
2701-2021_03_20_100105.jpg,lorry_truck,20,93,640,24,480,373,2,113,397,LTAdatasets/2701/annotate/2701-2021_03_20_100105.jpg,103.0,385.0,0.1609375,0.8020833333333334,0.03125,0.05
2701-2021_03_20_100105.jpg,lorry_truck,22,216,640,21,480,314,2,238,335,LTAdatasets/2701/annotate/2701-2021_03_20_100105.jpg,227.0,324.5,0.3546875,0.6760416666666667,0.034375,0.04375
2701-2021_03_20_100105.jpg,lorry_truck,23,183,640,16,480,318,2,206,334,LTAdatasets/2701/annotate/2701-2021_03_20_100105.jpg,194.5,326.0,0.30390625,0.6791666666666667,0.0359375,0.03333333333333333
2701-2021_03_20_100105.jpg,lorry_truck,30,289,640,26,480,274,2,319,300,LTAdatasets/2701/annotate/2701-2021_03_20_100105.jpg,304.0,287.0,0.475,0.5979166666666667,0.046875,0.05416666666666667
2701-2021_03_20_100105.jpg,lorry_truck,23,226,640,20,480,288,2,249,308,LTAdatasets/2701/annotate/2701-2021_03_20_100105.jpg,237.5,298.0,0.37109375,0.6208333333333333,0.0359375,0.041666666666666664
2701-2021_03_20_100105.jpg,lorry_truck,32,353,640,24,480,239,2,385,263,LTAdatasets/2701/annotate/2701-2021_03_20_100105.jpg,369.0,251.0,0.5765625,0.5229166666666667,0.05,0.05
2701-2021_03_20_100105.jpg,lorry_truck,28,389,640,17,480,224,2,417,241,LTAdatasets/2701/annotate/2701-2021_03_20_100105.jpg,403.0,232.5,0.6296875,0.484375,0.04375,0.035416666666666666
2701-2021_03_20_100105.jpg,lorry_truck,25,367,640,16,480,219,2,392,235,LTAdatasets/2701/annotate/2701-2021_03_20_100105.jpg,379.5,227.0,0.59296875,0.47291666666666665,0.0390625,0.03333333333333333
2701-2021_03_20_100105.jpg,lorry_truck,30,413,640,17,480,212,2,443,229,LTAdatasets/2701/annotate/2701-2021_03_20_100105.jpg,428.0,220.5,0.66875,0.459375,0.046875,0.035416666666666666
2701-2021_03_20_100105.jpg,lorry_truck,19,314,640,30,480,258,2,333,288,LTAdatasets/2701/annotate/2701-2021_03_20_100105.jpg,323.5,273.0,0.50546875,0.56875,0.0296875,0.0625
2701-2021_03_20_100105.jpg,lorry_truck,27,423,640,11,480,190,2,450,201,LTAdatasets/2701/annotate/2701-2021_03_20_100105.jpg,436.5,195.5,0.68203125,0.40729166666666666,0.0421875,0.022916666666666665
2701-2021_03_20_100105.jpg,lorry_truck,16,403,640,16,480,204,2,419,220,LTAdatasets/2701/annotate/2701-2021_03_20_100105.jpg,411.0,212.0,0.6421875,0.44166666666666665,0.025,0.03333333333333333
2701-2021_03_20_100105.jpg,lorry_truck,28,487,640,21,480,166,2,515,187,LTAdatasets/2701/annotate/2701-2021_03_20_100105.jpg,501.0,176.5,0.7828125,0.36770833333333336,0.04375,0.04375
2701-2021_03_20_100105.jpg,lorry_truck,18,262,640,16,480,296,2,280,312,LTAdatasets/2701/annotate/2701-2021_03_20_100105.jpg,271.0,304.0,0.4234375,0.6333333333333333,0.028125,0.03333333333333333
2701-2021_03_20_080119.jpg,lorry_truck,40,150,640,27,480,336,2,190,363,LTAdatasets/2701/annotate/2701-2021_03_20_080119.jpg,170.0,349.5,0.265625,0.728125,0.0625,0.05625
2701-2021_03_20_080119.jpg,lorry_truck,28,212,640,14,480,320,2,240,334,LTAdatasets/2701/annotate/2701-2021_03_20_080119.jpg,226.0,327.0,0.353125,0.68125,0.04375,0.029166666666666667
2701-2021_03_20_080119.jpg,lorry_truck,31,235,640,19,480,304,2,266,323,LTAdatasets/2701/annotate/2701-2021_03_20_080119.jpg,250.5,313.5,0.39140625,0.653125,0.0484375,0.03958333333333333
2701-2021_03_20_080119.jpg,lorry_truck,28,266,640,22,480,287,2,294,309,LTAdatasets/2701/annotate/2701-2021_03_20_080119.jpg,280.0,298.0,0.4375,0.6208333333333333,0.04375,0.04583333333333333
2701-2021_03_20_080119.jpg,lorry_truck,32,325,640,25,480,252,2,357,277,LTAdatasets/2701/annotate/2701-2021_03_20_080119.jpg,341.0,264.5,0.5328125,0.5510416666666667,0.05,0.052083333333333336
2701-2021_03_20_080119.jpg,lorry_truck,21,383,640,22,480,224,2,404,246,LTAdatasets/2701/annotate/2701-2021_03_20_080119.jpg,393.5,235.0,0.61484375,0.4895833333333333,0.0328125,0.04583333333333333
2701-2021_03_20_080119.jpg,lorry_truck,21,412,640,16,480,212,2,433,228,LTAdatasets/2701/annotate/2701-2021_03_20_080119.jpg,422.5,220.0,0.66015625,0.4583333333333333,0.0328125,0.03333333333333333
2701-2021_03_20_080119.jpg,lorry_truck,28,452,640,25,480,186,2,480,211,LTAdatasets/2701/annotate/2701-2021_03_20_080119.jpg,466.0,198.5,0.728125,0.41354166666666664,0.04375,0.052083333333333336
2701-2021_03_20_080119.jpg,lorry_truck,26,477,640,27,480,162,2,503,189,LTAdatasets/2701/annotate/2701-2021_03_20_080119.jpg,490.0,175.5,0.765625,0.365625,0.040625,0.05625
2701-2021_03_20_080119.jpg,lorry_truck,28,540,640,16,480,136,2,568,152,LTAdatasets/2701/annotate/2701-2021_03_20_080119.jpg,554.0,144.0,0.865625,0.3,0.04375,0.03333333333333333
2701-2021_03_20_080119.jpg,lorry_truck,31,512,640,24,480,149,2,543,173,LTAdatasets/2701/annotate/2701-2021_03_20_080119.jpg,527.5,161.0,0.82421875,0.33541666666666664,0.0484375,0.05
2701-2021_03_20_080119.jpg,lorry_truck,35,104,640,23,480,363,2,139,386,LTAdatasets/2701/annotate/2701-2021_03_20_080119.jpg,121.5,374.5,0.18984375,0.7802083333333333,0.0546875,0.04791666666666667
2701-2021_03_20_094605.jpg,lorry_truck,47,86,640,24,480,369,2,133,393,LTAdatasets/2701/annotate/2701-2021_03_20_094605.jpg,109.5,381.0,0.17109375,0.79375,0.0734375,0.05
2701-2021_03_20_094605.jpg,van,18,141,640,16,480,341,3,159,357,LTAdatasets/2701/annotate/2701-2021_03_20_094605.jpg,150.0,349.0,0.234375,0.7270833333333333,0.028125,0.03333333333333333
2701-2021_03_20_094605.jpg,lorry_truck,18,228,640,27,480,308,2,246,335,LTAdatasets/2701/annotate/2701-2021_03_20_094605.jpg,237.0,321.5,0.3703125,0.6697916666666667,0.028125,0.05625
2701-2021_03_20_094605.jpg,lorry_truck,28,309,640,30,480,257,2,337,287,LTAdatasets/2701/annotate/2701-2021_03_20_094605.jpg,323.0,272.0,0.5046875,0.5666666666666667,0.04375,0.0625
2701-2021_03_20_094605.jpg,lorry_truck,29,348,640,28,480,235,2,377,263,LTAdatasets/2701/annotate/2701-2021_03_20_094605.jpg,362.5,249.0,0.56640625,0.51875,0.0453125,0.058333333333333334
2701-2021_03_20_094605.jpg,lorry_truck,30,438,640,32,480,184,2,468,216,LTAdatasets/2701/annotate/2701-2021_03_20_094605.jpg,453.0,200.0,0.7078125,0.4166666666666667,0.046875,0.06666666666666667
2701-2021_03_20_094605.jpg,lorry_truck,17,248,640,19,480,278,2,265,297,LTAdatasets/2701/annotate/2701-2021_03_20_094605.jpg,256.5,287.5,0.40078125,0.5989583333333334,0.0265625,0.03958333333333333
2701-2021_03_20_094605.jpg,lorry_truck,24,277,640,21,480,282,2,301,303,LTAdatasets/2701/annotate/2701-2021_03_20_094605.jpg,289.0,292.5,0.4515625,0.609375,0.0375,0.04375
2701-2021_03_20_094605.jpg,lorry_truck,25,186,640,21,480,306,2,211,327,LTAdatasets/2701/annotate/2701-2021_03_20_094605.jpg,198.5,316.5,0.31015625,0.659375,0.0390625,0.04375
2701-2021_03_20_094605.jpg,lorry_truck,42,2,640,25,480,394,2,44,419,LTAdatasets/2701/annotate/2701-2021_03_20_094605.jpg,23.0,406.5,0.0359375,0.846875,0.065625,0.052083333333333336
2701-2021_03_20_094605.jpg,lorry_truck,30,165,640,23,480,337,2,195,360,LTAdatasets/2701/annotate/2701-2021_03_20_094605.jpg,180.0,348.5,0.28125,0.7260416666666667,0.046875,0.04791666666666667
2701-2021_03_20_094605.jpg,lorry_truck,42,374,640,25,480,220,2,416,245,LTAdatasets/2701/annotate/2701-2021_03_20_094605.jpg,395.0,232.5,0.6171875,0.484375,0.065625,0.052083333333333336
2701-2021_03_20_094605.jpg,lorry_truck,23,467,640,26,480,172,2,490,198,LTAdatasets/2701/annotate/2701-2021_03_20_094605.jpg,478.5,185.0,0.74765625,0.3854166666666667,0.0359375,0.05416666666666667
2701-2021_03_20_090402.jpg,lorry_truck,25,100,640,28,480,361,2,125,389,LTAdatasets/2701/annotate/2701-2021_03_20_090402.jpg,112.5,375.0,0.17578125,0.78125,0.0390625,0.058333333333333334
2701-2021_03_20_090402.jpg,lorry_truck,42,144,640,37,480,334,2,186,371,LTAdatasets/2701/annotate/2701-2021_03_20_090402.jpg,165.0,352.5,0.2578125,0.734375,0.065625,0.07708333333333334
2701-2021_03_20_090402.jpg,lorry_truck,28,213,640,27,480,309,2,241,336,LTAdatasets/2701/annotate/2701-2021_03_20_090402.jpg,227.0,322.5,0.3546875,0.671875,0.04375,0.05625
2701-2021_03_20_090402.jpg,lorry_truck,25,285,640,15,480,282,2,310,297,LTAdatasets/2701/annotate/2701-2021_03_20_090402.jpg,297.5,289.5,0.46484375,0.603125,0.0390625,0.03125
2701-2021_03_20_090402.jpg,lorry_truck,45,332,640,34,480,237,2,377,271,LTAdatasets/2701/annotate/2701-2021_03_20_090402.jpg,354.5,254.0,0.55390625,0.5291666666666667,0.0703125,0.07083333333333333
2701-2021_03_20_090402.jpg,lorry_truck,28,379,640,29,480,224,2,407,253,LTAdatasets/2701/annotate/2701-2021_03_20_090402.jpg,393.0,238.5,0.6140625,0.496875,0.04375,0.06041666666666667
2701-2021_03_20_090402.jpg,lorry_truck,40,402,640,22,480,207,2,442,229,LTAdatasets/2701/annotate/2701-2021_03_20_090402.jpg,422.0,218.0,0.659375,0.45416666666666666,0.0625,0.04583333333333333
2701-2021_03_20_090402.jpg,lorry_truck,18,506,640,16,480,157,2,524,173,LTAdatasets/2701/annotate/2701-2021_03_20_090402.jpg,515.0,165.0,0.8046875,0.34375,0.028125,0.03333333333333333
2701-2021_03_20_090402.jpg,lorry_truck,27,459,640,23,480,181,2,486,204,LTAdatasets/2701/annotate/2701-2021_03_20_090402.jpg,472.5,192.5,0.73828125,0.4010416666666667,0.0421875,0.04791666666666667
2701-2021_03_20_090402.jpg,lorry_truck,23,177,640,16,480,318,2,200,334,LTAdatasets/2701/annotate/2701-2021_03_20_090402.jpg,188.5,326.0,0.29453125,0.6791666666666667,0.0359375,0.03333333333333333
2701-2021_03_20_090402.jpg,lorry_truck,16,273,640,11,480,268,2,289,279,LTAdatasets/2701/annotate/2701-2021_03_20_090402.jpg,281.0,273.5,0.4390625,0.5697916666666667,0.025,0.022916666666666665
2701-2021_03_20_090402.jpg,lorry_truck,21,234,640,19,480,288,2,255,307,LTAdatasets/2701/annotate/2701-2021_03_20_090402.jpg,244.5,297.5,0.38203125,0.6197916666666666,0.0328125,0.03958333333333333
2701-2021_03_20_090402.jpg,lorry_truck,24,349,640,18,480,222,2,373,240,LTAdatasets/2701/annotate/2701-2021_03_20_090402.jpg,361.0,231.0,0.5640625,0.48125,0.0375,0.0375
2701-2021_03_20_090402.jpg,lorry_truck,20,473,640,8,480,169,2,493,177,LTAdatasets/2701/annotate/2701-2021_03_20_090402.jpg,483.0,173.0,0.7546875,0.36041666666666666,0.03125,0.016666666666666666
2701-2021_03_20_090402.jpg,lorry_truck,23,451,640,16,480,171,2,474,187,LTAdatasets/2701/annotate/2701-2021_03_20_090402.jpg,462.5,179.0,0.72265625,0.3729166666666667,0.0359375,0.03333333333333333
2701-2021_03_20_090402.jpg,lorry_truck,28,530,640,16,480,145,2,558,161,LTAdatasets/2701/annotate/2701-2021_03_20_090402.jpg,544.0,153.0,0.85,0.31875,0.04375,0.03333333333333333
2701-2021_03_20_101005.jpg,lorry_truck,21,272,640,18,480,289,2,293,307,LTAdatasets/2701/annotate/2701-2021_03_20_101005.jpg,282.5,298.0,0.44140625,0.6208333333333333,0.0328125,0.0375
2701-2021_03_20_101005.jpg,lorry_truck,16,254,640,23,480,277,2,270,300,LTAdatasets/2701/annotate/2701-2021_03_20_101005.jpg,262.0,288.5,0.409375,0.6010416666666667,0.025,0.04791666666666667
2701-2021_03_20_101005.jpg,lorry_truck,33,206,640,27,480,313,2,239,340,LTAdatasets/2701/annotate/2701-2021_03_20_101005.jpg,222.5,326.5,0.34765625,0.6802083333333333,0.0515625,0.05625
2701-2021_03_20_101005.jpg,lorry_truck,42,163,640,26,480,334,2,205,360,LTAdatasets/2701/annotate/2701-2021_03_20_101005.jpg,184.0,347.0,0.2875,0.7229166666666667,0.065625,0.05416666666666667
2701-2021_03_20_101005.jpg,lorry_truck,45,117,640,29,480,352,2,162,381,LTAdatasets/2701/annotate/2701-2021_03_20_101005.jpg,139.5,366.5,0.21796875,0.7635416666666667,0.0703125,0.06041666666666667
2701-2021_03_20_101005.jpg,lorry_truck,24,215,640,15,480,296,2,239,311,LTAdatasets/2701/annotate/2701-2021_03_20_101005.jpg,227.0,303.5,0.3546875,0.6322916666666667,0.0375,0.03125
2701-2021_03_20_101005.jpg,lorry_truck,50,331,640,35,480,236,2,381,271,LTAdatasets/2701/annotate/2701-2021_03_20_101005.jpg,356.0,253.5,0.55625,0.528125,0.078125,0.07291666666666667
2701-2021_03_20_101005.jpg,lorry_truck,20,417,640,15,480,192,2,437,207,LTAdatasets/2701/annotate/2701-2021_03_20_101005.jpg,427.0,199.5,0.6671875,0.415625,0.03125,0.03125
2701-2021_03_20_101005.jpg,lorry_truck,25,452,640,13,480,192,2,477,205,LTAdatasets/2701/annotate/2701-2021_03_20_101005.jpg,464.5,198.5,0.72578125,0.41354166666666664,0.0390625,0.027083333333333334
2701-2021_03_20_101005.jpg,lorry_truck,24,465,640,13,480,170,2,489,183,LTAdatasets/2701/annotate/2701-2021_03_20_101005.jpg,477.0,176.5,0.7453125,0.36770833333333336,0.0375,0.027083333333333334
2701-2021_03_20_101005.jpg,lorry_truck,21,494,640,20,480,165,2,515,185,LTAdatasets/2701/annotate/2701-2021_03_20_101005.jpg,504.5,175.0,0.78828125,0.3645833333333333,0.0328125,0.041666666666666664
2701-2021_03_20_101005.jpg,lorry_truck,29,506,640,19,480,154,2,535,173,LTAdatasets/2701/annotate/2701-2021_03_20_101005.jpg,520.5,163.5,0.81328125,0.340625,0.0453125,0.03958333333333333
2701-2021_03_20_101005.jpg,lorry_truck,28,3,640,28,480,394,2,31,422,LTAdatasets/2701/annotate/2701-2021_03_20_101005.jpg,17.0,408.0,0.0265625,0.85,0.04375,0.058333333333333334
2701-2021_03_20_081920.jpg,lorry_truck,25,288,640,20,480,269,2,313,289,LTAdatasets/2701/annotate/2701-2021_03_20_081920.jpg,300.5,279.0,0.46953125,0.58125,0.0390625,0.041666666666666664
2701-2021_03_20_081920.jpg,lorry_truck,18,328,640,23,480,255,2,346,278,LTAdatasets/2701/annotate/2701-2021_03_20_081920.jpg,337.0,266.5,0.5265625,0.5552083333333333,0.028125,0.04791666666666667
2701-2021_03_20_081920.jpg,lorry_truck,21,397,640,20,480,221,2,418,241,LTAdatasets/2701/annotate/2701-2021_03_20_081920.jpg,407.5,231.0,0.63671875,0.48125,0.0328125,0.041666666666666664
2701-2021_03_20_081920.jpg,lorry_truck,32,257,640,22,480,292,2,289,314,LTAdatasets/2701/annotate/2701-2021_03_20_081920.jpg,273.0,303.0,0.4265625,0.63125,0.05,0.04583333333333333
2701-2021_03_20_081920.jpg,lorry_truck,44,208,640,34,480,304,2,252,338,LTAdatasets/2701/annotate/2701-2021_03_20_081920.jpg,230.0,321.0,0.359375,0.66875,0.06875,0.07083333333333333
2701-2021_03_20_081920.jpg,lorry_truck,54,149,640,35,480,331,2,203,366,LTAdatasets/2701/annotate/2701-2021_03_20_081920.jpg,176.0,348.5,0.275,0.7260416666666667,0.084375,0.07291666666666667
2701-2021_03_20_081920.jpg,lorry_truck,42,83,640,32,480,368,2,125,400,LTAdatasets/2701/annotate/2701-2021_03_20_081920.jpg,104.0,384.0,0.1625,0.8,0.065625,0.06666666666666667
2701-2021_03_20_081920.jpg,lorry_truck,24,456,640,23,480,180,2,480,203,LTAdatasets/2701/annotate/2701-2021_03_20_081920.jpg,468.0,191.5,0.73125,0.39895833333333336,0.0375,0.04791666666666667
2701-2021_03_20_081920.jpg,lorry_truck,26,509,640,19,480,155,2,535,174,LTAdatasets/2701/annotate/2701-2021_03_20_081920.jpg,522.0,164.5,0.815625,0.34270833333333334,0.040625,0.03958333333333333
2701-2021_03_20_081920.jpg,lorry_truck,25,482,640,23,480,171,2,507,194,LTAdatasets/2701/annotate/2701-2021_03_20_081920.jpg,494.5,182.5,0.77265625,0.3802083333333333,0.0390625,0.04791666666666667
2701-2021_03_20_081920.jpg,lorry_truck,25,448,640,21,480,160,2,473,181,LTAdatasets/2701/annotate/2701-2021_03_20_081920.jpg,460.5,170.5,0.71953125,0.35520833333333335,0.0390625,0.04375
2701-2021_03_20_081920.jpg,lorry_truck,18,374,640,21,480,228,2,392,249,LTAdatasets/2701/annotate/2701-2021_03_20_081920.jpg,383.0,238.5,0.5984375,0.496875,0.028125,0.04375
2701-2021_03_20_081920.jpg,lorry_truck,20,552,640,21,480,131,2,572,152,LTAdatasets/2701/annotate/2701-2021_03_20_081920.jpg,562.0,141.5,0.878125,0.2947916666666667,0.03125,0.04375
2701-2021_03_20_081920.jpg,lorry_truck,18,569,640,18,480,127,2,587,145,LTAdatasets/2701/annotate/2701-2021_03_20_081920.jpg,578.0,136.0,0.903125,0.2833333333333333,0.028125,0.0375
2701-2021_03_20_191614.jpg,lorry_truck,17,564,640,27,480,128,2,581,155,LTAdatasets/2701/annotate/2701-2021_03_20_191614.jpg,572.5,141.5,0.89453125,0.2947916666666667,0.0265625,0.05625
2701-2021_03_20_091002.jpg,lorry_truck,27,155,640,27,480,339,2,182,366,LTAdatasets/2701/annotate/2701-2021_03_20_091002.jpg,168.5,352.5,0.26328125,0.734375,0.0421875,0.05625
2701-2021_03_20_091002.jpg,lorry_truck,23,215,640,23,480,313,2,238,336,LTAdatasets/2701/annotate/2701-2021_03_20_091002.jpg,226.5,324.5,0.35390625,0.6760416666666667,0.0359375,0.04791666666666667
2701-2021_03_20_091002.jpg,lorry_truck,21,261,640,27,480,289,2,282,316,LTAdatasets/2701/annotate/2701-2021_03_20_091002.jpg,271.5,302.5,0.42421875,0.6302083333333334,0.0328125,0.05625
2701-2021_03_20_091002.jpg,lorry_truck,20,335,640,17,480,258,2,355,275,LTAdatasets/2701/annotate/2701-2021_03_20_091002.jpg,345.0,266.5,0.5390625,0.5552083333333333,0.03125,0.035416666666666666
2701-2021_03_20_091002.jpg,lorry_truck,24,364,640,22,480,236,2,388,258,LTAdatasets/2701/annotate/2701-2021_03_20_091002.jpg,376.0,247.0,0.5875,0.5145833333333333,0.0375,0.04583333333333333
2701-2021_03_20_091002.jpg,lorry_truck,22,361,640,13,480,216,2,383,229,LTAdatasets/2701/annotate/2701-2021_03_20_091002.jpg,372.0,222.5,0.58125,0.4635416666666667,0.034375,0.027083333333333334
2701-2021_03_20_091002.jpg,lorry_truck,25,457,640,14,480,183,2,482,197,LTAdatasets/2701/annotate/2701-2021_03_20_091002.jpg,469.5,190.0,0.73359375,0.3958333333333333,0.0390625,0.029166666666666667
2701-2021_03_20_091002.jpg,lorry_truck,30,406,640,24,480,211,2,436,235,LTAdatasets/2701/annotate/2701-2021_03_20_091002.jpg,421.0,223.0,0.6578125,0.46458333333333335,0.046875,0.05
2701-2021_03_20_091002.jpg,lorry_truck,37,178,640,25,480,304,2,215,329,LTAdatasets/2701/annotate/2701-2021_03_20_091002.jpg,196.5,316.5,0.30703125,0.659375,0.0578125,0.052083333333333336
2701-2021_03_20_091002.jpg,lorry_truck,39,101,640,25,480,338,2,140,363,LTAdatasets/2701/annotate/2701-2021_03_20_091002.jpg,120.5,350.5,0.18828125,0.7302083333333333,0.0609375,0.052083333333333336
2701-2021_03_20_091002.jpg,lorry_truck,43,83,640,33,480,364,2,126,397,LTAdatasets/2701/annotate/2701-2021_03_20_091002.jpg,104.5,380.5,0.16328125,0.7927083333333333,0.0671875,0.06875
2701-2021_03_20_091002.jpg,lorry_truck,30,298,640,28,480,267,2,328,295,LTAdatasets/2701/annotate/2701-2021_03_20_091002.jpg,313.0,281.0,0.4890625,0.5854166666666667,0.046875,0.058333333333333334
2701-2021_03_20_092143.jpg,bus,59,77,640,30,480,373,5,136,403,LTAdatasets/2701/annotate/2701-2021_03_20_092143.jpg,106.5,388.0,0.16640625,0.8083333333333333,0.0921875,0.0625
2701-2021_03_20_092143.jpg,lorry_truck,30,165,640,20,480,341,2,195,361,LTAdatasets/2701/annotate/2701-2021_03_20_092143.jpg,180.0,351.0,0.28125,0.73125,0.046875,0.041666666666666664
2701-2021_03_20_092143.jpg,lorry_truck,33,196,640,31,480,319,2,229,350,LTAdatasets/2701/annotate/2701-2021_03_20_092143.jpg,212.5,334.5,0.33203125,0.696875,0.0515625,0.06458333333333334
2701-2021_03_20_092143.jpg,lorry_truck,20,228,640,21,480,310,2,248,331,LTAdatasets/2701/annotate/2701-2021_03_20_092143.jpg,238.0,320.5,0.371875,0.6677083333333333,0.03125,0.04375
2701-2021_03_20_092143.jpg,lorry_truck,19,271,640,19,480,291,2,290,310,LTAdatasets/2701/annotate/2701-2021_03_20_092143.jpg,280.5,300.5,0.43828125,0.6260416666666667,0.0296875,0.03958333333333333
2701-2021_03_20_092143.jpg,lorry_truck,20,240,640,16,480,283,2,260,299,LTAdatasets/2701/annotate/2701-2021_03_20_092143.jpg,250.0,291.0,0.390625,0.60625,0.03125,0.03333333333333333
2701-2021_03_20_092143.jpg,lorry_truck,32,305,640,23,480,265,2,337,288,LTAdatasets/2701/annotate/2701-2021_03_20_092143.jpg,321.0,276.5,0.5015625,0.5760416666666667,0.05,0.04791666666666667
2701-2021_03_20_092143.jpg,lorry_truck,25,336,640,24,480,250,2,361,274,LTAdatasets/2701/annotate/2701-2021_03_20_092143.jpg,348.5,262.0,0.54453125,0.5458333333333333,0.0390625,0.05
2701-2021_03_20_092143.jpg,lorry_truck,25,369,640,27,480,231,2,394,258,LTAdatasets/2701/annotate/2701-2021_03_20_092143.jpg,381.5,244.5,0.59609375,0.509375,0.0390625,0.05625
2701-2021_03_20_092143.jpg,lorry_truck,36,388,640,28,480,213,2,424,241,LTAdatasets/2701/annotate/2701-2021_03_20_092143.jpg,406.0,227.0,0.634375,0.47291666666666665,0.05625,0.058333333333333334
2701-2021_03_20_092143.jpg,lorry_truck,28,417,640,26,480,203,2,445,229,LTAdatasets/2701/annotate/2701-2021_03_20_092143.jpg,431.0,216.0,0.6734375,0.45,0.04375,0.05416666666666667
2701-2021_03_20_092143.jpg,lorry_truck,29,427,640,18,480,180,2,456,198,LTAdatasets/2701/annotate/2701-2021_03_20_092143.jpg,441.5,189.0,0.68984375,0.39375,0.0453125,0.0375
2701-2021_03_20_092143.jpg,lorry_truck,27,468,640,21,480,174,2,495,195,LTAdatasets/2701/annotate/2701-2021_03_20_092143.jpg,481.5,184.5,0.75234375,0.384375,0.0421875,0.04375
2701-2021_03_20_092143.jpg,lorry_truck,20,184,640,26,480,315,2,204,341,LTAdatasets/2701/annotate/2701-2021_03_20_092143.jpg,194.0,328.0,0.303125,0.6833333333333333,0.03125,0.05416666666666667
2701-2021_03_20_092143.jpg,lorry_truck,25,485,640,26,480,164,2,510,190,LTAdatasets/2701/annotate/2701-2021_03_20_092143.jpg,497.5,177.0,0.77734375,0.36875,0.0390625,0.05416666666666667
2701-2021_03_20_092143.jpg,lorry_truck,28,533,640,16,480,144,2,561,160,LTAdatasets/2701/annotate/2701-2021_03_20_092143.jpg,547.0,152.0,0.8546875,0.31666666666666665,0.04375,0.03333333333333333
2701-2021_03_20_092143.jpg,lorry_truck,22,563,640,25,480,119,2,585,144,LTAdatasets/2701/annotate/2701-2021_03_20_092143.jpg,574.0,131.5,0.896875,0.27395833333333336,0.034375,0.052083333333333336
2701-2021_03_20_092143.jpg,lorry_truck,19,317,640,17,480,241,2,336,258,LTAdatasets/2701/annotate/2701-2021_03_20_092143.jpg,326.5,249.5,0.51015625,0.5197916666666667,0.0296875,0.035416666666666666
2701-2021_03_20_100705.jpg,lorry_truck,21,110,640,22,480,368,2,131,390,LTAdatasets/2701/annotate/2701-2021_03_20_100705.jpg,120.5,379.0,0.18828125,0.7895833333333333,0.0328125,0.04583333333333333
2701-2021_03_20_100705.jpg,lorry_truck,44,156,640,31,480,333,2,200,364,LTAdatasets/2701/annotate/2701-2021_03_20_100705.jpg,178.0,348.5,0.278125,0.7260416666666667,0.06875,0.06458333333333334
2701-2021_03_20_100705.jpg,lorry_truck,23,208,640,23,480,319,2,231,342,LTAdatasets/2701/annotate/2701-2021_03_20_100705.jpg,219.5,330.5,0.34296875,0.6885416666666667,0.0359375,0.04791666666666667
2701-2021_03_20_100705.jpg,lorry_truck,19,276,640,13,480,287,2,295,300,LTAdatasets/2701/annotate/2701-2021_03_20_100705.jpg,285.5,293.5,0.44609375,0.6114583333333333,0.0296875,0.027083333333333334
2701-2021_03_20_100705.jpg,lorry_truck,14,306,640,23,480,265,2,320,288,LTAdatasets/2701/annotate/2701-2021_03_20_100705.jpg,313.0,276.5,0.4890625,0.5760416666666667,0.021875,0.04791666666666667
2701-2021_03_20_100705.jpg,lorry_truck,15,284,640,21,480,265,2,299,286,LTAdatasets/2701/annotate/2701-2021_03_20_100705.jpg,291.5,275.5,0.45546875,0.5739583333333333,0.0234375,0.04375
2701-2021_03_20_100705.jpg,lorry_truck,32,221,640,23,480,292,2,253,315,LTAdatasets/2701/annotate/2701-2021_03_20_100705.jpg,237.0,303.5,0.3703125,0.6322916666666667,0.05,0.04791666666666667
2701-2021_03_20_100705.jpg,lorry_truck,34,392,640,25,480,203,2,426,228,LTAdatasets/2701/annotate/2701-2021_03_20_100705.jpg,409.0,215.5,0.6390625,0.44895833333333335,0.053125,0.052083333333333336
2701-2021_03_20_100705.jpg,lorry_truck,23,463,640,25,480,177,2,486,202,LTAdatasets/2701/annotate/2701-2021_03_20_100705.jpg,474.5,189.5,0.74140625,0.39479166666666665,0.0359375,0.052083333333333336
2701-2021_03_20_100705.jpg,lorry_truck,37,374,640,24,480,222,2,411,246,LTAdatasets/2701/annotate/2701-2021_03_20_100705.jpg,392.5,234.0,0.61328125,0.4875,0.0578125,0.05
2701-2021_03_20_100705.jpg,lorry_truck,17,518,640,20,480,155,2,535,175,LTAdatasets/2701/annotate/2701-2021_03_20_100705.jpg,526.5,165.0,0.82265625,0.34375,0.0265625,0.041666666666666664
2701-2021_03_20_100705.jpg,lorry_truck,38,434,640,21,480,193,2,472,214,LTAdatasets/2701/annotate/2701-2021_03_20_100705.jpg,453.0,203.5,0.7078125,0.4239583333333333,0.059375,0.04375
2701-2021_03_20_100705.jpg,lorry_truck,28,258,640,19,480,298,2,286,317,LTAdatasets/2701/annotate/2701-2021_03_20_100705.jpg,272.0,307.5,0.425,0.640625,0.04375,0.03958333333333333
2701-2021_03_20_100705.jpg,lorry_truck,49,107,640,17,480,341,2,156,358,LTAdatasets/2701/annotate/2701-2021_03_20_100705.jpg,131.5,349.5,0.20546875,0.728125,0.0765625,0.035416666666666666
2701-2021_03_20_091623.jpg,lorry_truck,25,172,640,20,480,338,2,197,358,LTAdatasets/2701/annotate/2701-2021_03_20_091623.jpg,184.5,348.0,0.28828125,0.725,0.0390625,0.041666666666666664
2701-2021_03_20_091623.jpg,lorry_truck,36,113,640,13,480,359,2,149,372,LTAdatasets/2701/annotate/2701-2021_03_20_091623.jpg,131.0,365.5,0.2046875,0.7614583333333333,0.05625,0.027083333333333334
2701-2021_03_20_091623.jpg,lorry_truck,31,201,640,18,480,300,2,232,318,LTAdatasets/2701/annotate/2701-2021_03_20_091623.jpg,216.5,309.0,0.33828125,0.64375,0.0484375,0.0375
2701-2021_03_20_091623.jpg,lorry_truck,35,214,640,18,480,316,2,249,334,LTAdatasets/2701/annotate/2701-2021_03_20_091623.jpg,231.5,325.0,0.36171875,0.6770833333333334,0.0546875,0.0375
2701-2021_03_20_091623.jpg,lorry_truck,32,263,640,23,480,285,2,295,308,LTAdatasets/2701/annotate/2701-2021_03_20_091623.jpg,279.0,296.5,0.4359375,0.6177083333333333,0.05,0.04791666666666667
2701-2021_03_20_091623.jpg,lorry_truck,27,304,640,27,480,261,2,331,288,LTAdatasets/2701/annotate/2701-2021_03_20_091623.jpg,317.5,274.5,0.49609375,0.571875,0.0421875,0.05625
2701-2021_03_20_091623.jpg,lorry_truck,21,338,640,25,480,245,2,359,270,LTAdatasets/2701/annotate/2701-2021_03_20_091623.jpg,348.5,257.5,0.54453125,0.5364583333333334,0.0328125,0.052083333333333336
2701-2021_03_20_091623.jpg,lorry_truck,19,415,640,16,480,212,2,434,228,LTAdatasets/2701/annotate/2701-2021_03_20_091623.jpg,424.5,220.0,0.66328125,0.4583333333333333,0.0296875,0.03333333333333333
2701-2021_03_20_091623.jpg,lorry_truck,32,379,640,25,480,221,2,411,246,LTAdatasets/2701/annotate/2701-2021_03_20_091623.jpg,395.0,233.5,0.6171875,0.4864583333333333,0.05,0.052083333333333336
2701-2021_03_20_091623.jpg,lorry_truck,37,432,640,28,480,173,2,469,201,LTAdatasets/2701/annotate/2701-2021_03_20_091623.jpg,450.5,187.0,0.70390625,0.38958333333333334,0.0578125,0.058333333333333334
2701-2021_03_20_091623.jpg,lorry_truck,22,445,640,18,480,194,2,467,212,LTAdatasets/2701/annotate/2701-2021_03_20_091623.jpg,456.0,203.0,0.7125,0.42291666666666666,0.034375,0.0375
2701-2021_03_20_091623.jpg,lorry_truck,25,489,640,23,480,148,2,514,171,LTAdatasets/2701/annotate/2701-2021_03_20_091623.jpg,501.5,159.5,0.78359375,0.33229166666666665,0.0390625,0.04791666666666667
2701-2021_03_20_091623.jpg,lorry_truck,18,511,640,15,480,157,2,529,172,LTAdatasets/2701/annotate/2701-2021_03_20_091623.jpg,520.0,164.5,0.8125,0.34270833333333334,0.028125,0.03125
2701-2021_03_20_091623.jpg,lorry_truck,18,535,640,13,480,145,2,553,158,LTAdatasets/2701/annotate/2701-2021_03_20_091623.jpg,544.0,151.5,0.85,0.315625,0.028125,0.027083333333333334
2701-2021_03_20_091623.jpg,lorry_truck,17,557,640,9,480,136,2,574,145,LTAdatasets/2701/annotate/2701-2021_03_20_091623.jpg,565.5,140.5,0.88359375,0.29270833333333335,0.0265625,0.01875
2701-2021_03_20_091623.jpg,lorry_truck,17,583,640,23,480,112,2,600,135,LTAdatasets/2701/annotate/2701-2021_03_20_091623.jpg,591.5,123.5,0.92421875,0.25729166666666664,0.0265625,0.04791666666666667
2701-2021_03_20_075138.jpg,lorry_truck,14,128,640,24,480,357,2,142,381,LTAdatasets/2701/annotate/2701-2021_03_20_075138.jpg,135.0,369.0,0.2109375,0.76875,0.021875,0.05
2701-2021_03_20_075138.jpg,lorry_truck,30,182,640,28,480,323,2,212,351,LTAdatasets/2701/annotate/2701-2021_03_20_075138.jpg,197.0,337.0,0.3078125,0.7020833333333333,0.046875,0.058333333333333334
2701-2021_03_20_075138.jpg,lorry_truck,25,242,640,36,480,292,2,267,328,LTAdatasets/2701/annotate/2701-2021_03_20_075138.jpg,254.5,310.0,0.39765625,0.6458333333333334,0.0390625,0.075
2701-2021_03_20_075138.jpg,lorry_truck,23,274,640,22,480,291,2,297,313,LTAdatasets/2701/annotate/2701-2021_03_20_075138.jpg,285.5,302.0,0.44609375,0.6291666666666667,0.0359375,0.04583333333333333
2701-2021_03_20_075138.jpg,lorry_truck,27,299,640,14,480,273,2,326,287,LTAdatasets/2701/annotate/2701-2021_03_20_075138.jpg,312.5,280.0,0.48828125,0.5833333333333334,0.0421875,0.029166666666666667
2701-2021_03_20_075138.jpg,lorry_truck,39,315,640,18,480,258,2,354,276,LTAdatasets/2701/annotate/2701-2021_03_20_075138.jpg,334.5,267.0,0.52265625,0.55625,0.0609375,0.0375
2701-2021_03_20_190413.jpg,lorry_truck,15,563,640,16,480,132,2,578,148,LTAdatasets/2701/annotate/2701-2021_03_20_190413.jpg,570.5,140.0,0.89140625,0.2916666666666667,0.0234375,0.03333333333333333
2701-2021_03_20_074318.jpg,lorry_truck,43,113,640,23,480,362,2,156,385,LTAdatasets/2701/annotate/2701-2021_03_20_074318.jpg,134.5,373.5,0.21015625,0.778125,0.0671875,0.04791666666666667
2701-2021_03_20_074318.jpg,lorry_truck,25,177,640,30,480,328,2,202,358,LTAdatasets/2701/annotate/2701-2021_03_20_074318.jpg,189.5,343.0,0.29609375,0.7145833333333333,0.0390625,0.0625
2701-2021_03_20_074318.jpg,lorry_truck,28,237,640,23,480,303,2,265,326,LTAdatasets/2701/annotate/2701-2021_03_20_074318.jpg,251.0,314.5,0.3921875,0.6552083333333333,0.04375,0.04791666666666667
2701-2021_03_20_074318.jpg,lorry_truck,47,297,640,26,480,260,2,344,286,LTAdatasets/2701/annotate/2701-2021_03_20_074318.jpg,320.5,273.0,0.50078125,0.56875,0.0734375,0.05416666666666667
2701-2021_03_20_074318.jpg,lorry_truck,44,344,640,27,480,234,2,388,261,LTAdatasets/2701/annotate/2701-2021_03_20_074318.jpg,366.0,247.5,0.571875,0.515625,0.06875,0.05625
2701-2021_03_20_074318.jpg,van,28,81,640,16,480,375,3,109,391,LTAdatasets/2701/annotate/2701-2021_03_20_074318.jpg,95.0,383.0,0.1484375,0.7979166666666667,0.04375,0.03333333333333333
2701-2021_03_20_084001.jpg,van,42,89,640,21,480,366,3,131,387,LTAdatasets/2701/annotate/2701-2021_03_20_084001.jpg,110.0,376.5,0.171875,0.784375,0.065625,0.04375
2701-2021_03_20_084001.jpg,van,28,158,640,21,480,343,3,186,364,LTAdatasets/2701/annotate/2701-2021_03_20_084001.jpg,172.0,353.5,0.26875,0.7364583333333333,0.04375,0.04375
2701-2021_03_20_084001.jpg,van,39,216,640,27,480,309,3,255,336,LTAdatasets/2701/annotate/2701-2021_03_20_084001.jpg,235.5,322.5,0.36796875,0.671875,0.0609375,0.05625
2701-2021_03_20_084001.jpg,van,24,194,640,18,480,308,3,218,326,LTAdatasets/2701/annotate/2701-2021_03_20_084001.jpg,206.0,317.0,0.321875,0.6604166666666667,0.0375,0.0375
2701-2021_03_20_084001.jpg,van,39,285,640,28,480,270,3,324,298,LTAdatasets/2701/annotate/2701-2021_03_20_084001.jpg,304.5,284.0,0.47578125,0.5916666666666667,0.0609375,0.058333333333333334
2701-2021_03_20_084001.jpg,van,30,343,640,23,480,244,3,373,267,LTAdatasets/2701/annotate/2701-2021_03_20_084001.jpg,358.0,255.5,0.559375,0.5322916666666667,0.046875,0.04791666666666667
2701-2021_03_20_084001.jpg,van,27,320,640,30,480,238,3,347,268,LTAdatasets/2701/annotate/2701-2021_03_20_084001.jpg,333.5,253.0,0.52109375,0.5270833333333333,0.0421875,0.0625
2701-2021_03_20_084001.jpg,van,25,399,640,19,480,217,3,424,236,LTAdatasets/2701/annotate/2701-2021_03_20_084001.jpg,411.5,226.5,0.64296875,0.471875,0.0390625,0.03958333333333333
2701-2021_03_20_084001.jpg,van,21,422,640,21,480,202,3,443,223,LTAdatasets/2701/annotate/2701-2021_03_20_084001.jpg,432.5,212.5,0.67578125,0.4427083333333333,0.0328125,0.04375
2701-2021_03_20_084001.jpg,van,27,450,640,23,480,181,3,477,204,LTAdatasets/2701/annotate/2701-2021_03_20_084001.jpg,463.5,192.5,0.72421875,0.4010416666666667,0.0421875,0.04791666666666667
2701-2021_03_20_084001.jpg,van,29,367,640,19,480,217,3,396,236,LTAdatasets/2701/annotate/2701-2021_03_20_084001.jpg,381.5,226.5,0.59609375,0.471875,0.0453125,0.03958333333333333
2701-2021_03_20_084001.jpg,van,18,531,640,15,480,145,3,549,160,LTAdatasets/2701/annotate/2701-2021_03_20_084001.jpg,540.0,152.5,0.84375,0.3177083333333333,0.028125,0.03125
2701-2021_03_20_092543.jpg,van,21,93,640,38,480,365,3,114,403,LTAdatasets/2701/annotate/2701-2021_03_20_092543.jpg,103.5,384.0,0.16171875,0.8,0.0328125,0.07916666666666666
2701-2021_03_20_092543.jpg,van,16,163,640,20,480,323,3,179,343,LTAdatasets/2701/annotate/2701-2021_03_20_092543.jpg,171.0,333.0,0.2671875,0.69375,0.025,0.041666666666666664
2701-2021_03_20_092543.jpg,van,28,166,640,24,480,337,3,194,361,LTAdatasets/2701/annotate/2701-2021_03_20_092543.jpg,180.0,349.0,0.28125,0.7270833333333333,0.04375,0.05
2701-2021_03_20_092543.jpg,van,24,219,640,28,480,309,3,243,337,LTAdatasets/2701/annotate/2701-2021_03_20_092543.jpg,231.0,323.0,0.3609375,0.6729166666666667,0.0375,0.058333333333333334
2701-2021_03_20_092543.jpg,van,16,233,640,25,480,285,3,249,310,LTAdatasets/2701/annotate/2701-2021_03_20_092543.jpg,241.0,297.5,0.3765625,0.6197916666666666,0.025,0.052083333333333336
2701-2021_03_20_092543.jpg,van,28,267,640,25,480,285,3,295,310,LTAdatasets/2701/annotate/2701-2021_03_20_092543.jpg,281.0,297.5,0.4390625,0.6197916666666666,0.04375,0.052083333333333336
2701-2021_03_20_092543.jpg,van,19,301,640,18,480,270,3,320,288,LTAdatasets/2701/annotate/2701-2021_03_20_092543.jpg,310.5,279.0,0.48515625,0.58125,0.0296875,0.0375
2701-2021_03_20_092543.jpg,van,19,308,640,18,480,251,3,327,269,LTAdatasets/2701/annotate/2701-2021_03_20_092543.jpg,317.5,260.0,0.49609375,0.5416666666666666,0.0296875,0.0375
2701-2021_03_20_092543.jpg,van,27,358,640,36,480,227,3,385,263,LTAdatasets/2701/annotate/2701-2021_03_20_092543.jpg,371.5,245.0,0.58046875,0.5104166666666666,0.0421875,0.075
2701-2021_03_20_092543.jpg,van,23,329,640,19,480,239,3,352,258,LTAdatasets/2701/annotate/2701-2021_03_20_092543.jpg,340.5,248.5,0.53203125,0.5177083333333333,0.0359375,0.03958333333333333
2701-2021_03_20_092543.jpg,van,39,388,640,15,480,219,3,427,234,LTAdatasets/2701/annotate/2701-2021_03_20_092543.jpg,407.5,226.5,0.63671875,0.471875,0.0609375,0.03125
2701-2021_03_20_092543.jpg,van,35,393,640,19,480,197,3,428,216,LTAdatasets/2701/annotate/2701-2021_03_20_092543.jpg,410.5,206.5,0.64140625,0.43020833333333336,0.0546875,0.03958333333333333
2701-2021_03_20_092543.jpg,van,34,436,640,21,480,193,3,470,214,LTAdatasets/2701/annotate/2701-2021_03_20_092543.jpg,453.0,203.5,0.7078125,0.4239583333333333,0.053125,0.04375
2701-2021_03_20_092543.jpg,van,29,469,640,23,480,172,3,498,195,LTAdatasets/2701/annotate/2701-2021_03_20_092543.jpg,483.5,183.5,0.75546875,0.38229166666666664,0.0453125,0.04791666666666667
2701-2021_03_20_092543.jpg,van,21,113,640,15,480,347,3,134,362,LTAdatasets/2701/annotate/2701-2021_03_20_092543.jpg,123.5,354.5,0.19296875,0.7385416666666667,0.0328125,0.03125
2701-2021_03_20_092543.jpg,van,20,270,640,16,480,268,3,290,284,LTAdatasets/2701/annotate/2701-2021_03_20_092543.jpg,280.0,276.0,0.4375,0.575,0.03125,0.03333333333333333
2701-2021_03_20_082440.jpg,van,27,170,640,23,480,332,3,197,355,LTAdatasets/2701/annotate/2701-2021_03_20_082440.jpg,183.5,343.5,0.28671875,0.715625,0.0421875,0.04791666666666667
2701-2021_03_20_082440.jpg,van,25,143,640,20,480,331,3,168,351,LTAdatasets/2701/annotate/2701-2021_03_20_082440.jpg,155.5,341.0,0.24296875,0.7104166666666667,0.0390625,0.041666666666666664
2701-2021_03_20_082440.jpg,van,25,117,640,25,480,353,3,142,378,LTAdatasets/2701/annotate/2701-2021_03_20_082440.jpg,129.5,365.5,0.20234375,0.7614583333333333,0.0390625,0.052083333333333336
2701-2021_03_20_082440.jpg,van,42,84,640,21,480,374,3,126,395,LTAdatasets/2701/annotate/2701-2021_03_20_082440.jpg,105.0,384.5,0.1640625,0.8010416666666667,0.065625,0.04375
2701-2021_03_20_082440.jpg,van,44,269,640,28,480,280,3,313,308,LTAdatasets/2701/annotate/2701-2021_03_20_082440.jpg,291.0,294.0,0.4546875,0.6125,0.06875,0.058333333333333334
2701-2021_03_20_082440.jpg,van,24,320,640,18,480,260,3,344,278,LTAdatasets/2701/annotate/2701-2021_03_20_082440.jpg,332.0,269.0,0.51875,0.5604166666666667,0.0375,0.0375
2701-2021_03_20_082440.jpg,van,25,343,640,13,480,253,3,368,266,LTAdatasets/2701/annotate/2701-2021_03_20_082440.jpg,355.5,259.5,0.55546875,0.540625,0.0390625,0.027083333333333334
2701-2021_03_20_082440.jpg,van,13,359,640,14,480,246,3,372,260,LTAdatasets/2701/annotate/2701-2021_03_20_082440.jpg,365.5,253.0,0.57109375,0.5270833333333333,0.0203125,0.029166666666666667
2701-2021_03_20_082440.jpg,van,35,372,640,34,480,217,3,407,251,LTAdatasets/2701/annotate/2701-2021_03_20_082440.jpg,389.5,234.0,0.60859375,0.4875,0.0546875,0.07083333333333333
2701-2021_03_20_082440.jpg,van,31,221,640,20,480,308,3,252,328,LTAdatasets/2701/annotate/2701-2021_03_20_082440.jpg,236.5,318.0,0.36953125,0.6625,0.0484375,0.041666666666666664
2701-2021_03_20_082440.jpg,van,27,193,640,25,480,305,3,220,330,LTAdatasets/2701/annotate/2701-2021_03_20_082440.jpg,206.5,317.5,0.32265625,0.6614583333333334,0.0421875,0.052083333333333336
2701-2021_03_20_082440.jpg,van,32,429,640,24,480,195,3,461,219,LTAdatasets/2701/annotate/2701-2021_03_20_082440.jpg,445.0,207.0,0.6953125,0.43125,0.05,0.05
2701-2021_03_20_082440.jpg,van,24,490,640,19,480,165,3,514,184,LTAdatasets/2701/annotate/2701-2021_03_20_082440.jpg,502.0,174.5,0.784375,0.36354166666666665,0.0375,0.03958333333333333
2701-2021_03_20_082440.jpg,van,25,527,640,23,480,143,3,552,166,LTAdatasets/2701/annotate/2701-2021_03_20_082440.jpg,539.5,154.5,0.84296875,0.321875,0.0390625,0.04791666666666667
2701-2021_03_20_094024.jpg,van,29,89,640,22,480,374,3,118,396,LTAdatasets/2701/annotate/2701-2021_03_20_094024.jpg,103.5,385.0,0.16171875,0.8020833333333334,0.0453125,0.04583333333333333
2701-2021_03_20_094024.jpg,van,34,157,640,22,480,345,3,191,367,LTAdatasets/2701/annotate/2701-2021_03_20_094024.jpg,174.0,356.0,0.271875,0.7416666666666667,0.053125,0.04583333333333333
2701-2021_03_20_094024.jpg,van,19,134,640,28,480,337,3,153,365,LTAdatasets/2701/annotate/2701-2021_03_20_094024.jpg,143.5,351.0,0.22421875,0.73125,0.0296875,0.058333333333333334
2701-2021_03_20_094024.jpg,van,18,193,640,18,480,306,3,211,324,LTAdatasets/2701/annotate/2701-2021_03_20_094024.jpg,202.0,315.0,0.315625,0.65625,0.028125,0.0375
2701-2021_03_20_094024.jpg,van,26,207,640,16,480,321,3,233,337,LTAdatasets/2701/annotate/2701-2021_03_20_094024.jpg,220.0,329.0,0.34375,0.6854166666666667,0.040625,0.03333333333333333
2701-2021_03_20_094024.jpg,van,19,245,640,22,480,299,3,264,321,LTAdatasets/2701/annotate/2701-2021_03_20_094024.jpg,254.5,310.0,0.39765625,0.6458333333333334,0.0296875,0.04583333333333333
2701-2021_03_20_094024.jpg,van,28,307,640,15,480,270,3,335,285,LTAdatasets/2701/annotate/2701-2021_03_20_094024.jpg,321.0,277.5,0.5015625,0.578125,0.04375,0.03125
2701-2021_03_20_094024.jpg,van,18,295,640,16,480,263,3,313,279,LTAdatasets/2701/annotate/2701-2021_03_20_094024.jpg,304.0,271.0,0.475,0.5645833333333333,0.028125,0.03333333333333333
2701-2021_03_20_094024.jpg,van,32,343,640,19,480,250,3,375,269,LTAdatasets/2701/annotate/2701-2021_03_20_094024.jpg,359.0,259.5,0.5609375,0.540625,0.05,0.03958333333333333
2701-2021_03_20_094024.jpg,van,20,374,640,20,480,225,3,394,245,LTAdatasets/2701/annotate/2701-2021_03_20_094024.jpg,384.0,235.0,0.6,0.4895833333333333,0.03125,0.041666666666666664
2701-2021_03_20_094024.jpg,van,23,424,640,18,480,199,3,447,217,LTAdatasets/2701/annotate/2701-2021_03_20_094024.jpg,435.5,208.0,0.68046875,0.43333333333333335,0.0359375,0.0375
2701-2021_03_20_094024.jpg,van,18,244,640,14,480,289,3,262,303,LTAdatasets/2701/annotate/2701-2021_03_20_094024.jpg,253.0,296.0,0.3953125,0.6166666666666667,0.028125,0.029166666666666667
2701-2021_03_20_094024.jpg,van,21,393,640,19,480,207,3,414,226,LTAdatasets/2701/annotate/2701-2021_03_20_094024.jpg,403.5,216.5,0.63046875,0.4510416666666667,0.0328125,0.03958333333333333
2701-2021_03_20_094024.jpg,van,32,456,640,23,480,179,3,488,202,LTAdatasets/2701/annotate/2701-2021_03_20_094024.jpg,472.0,190.5,0.7375,0.396875,0.05,0.04791666666666667
2701-2021_03_20_094024.jpg,van,15,504,640,20,480,161,3,519,181,LTAdatasets/2701/annotate/2701-2021_03_20_094024.jpg,511.5,171.0,0.79921875,0.35625,0.0234375,0.041666666666666664
2701-2021_03_20_094024.jpg,van,16,414,640,18,480,210,3,430,228,LTAdatasets/2701/annotate/2701-2021_03_20_094024.jpg,422.0,219.0,0.659375,0.45625,0.025,0.0375
2701-2021_03_20_094024.jpg,van,18,317,640,12,480,251,3,335,263,LTAdatasets/2701/annotate/2701-2021_03_20_094024.jpg,326.0,257.0,0.509375,0.5354166666666667,0.028125,0.025
2701-2021_03_20_094024.jpg,van,30,521,640,18,480,141,3,551,159,LTAdatasets/2701/annotate/2701-2021_03_20_094024.jpg,536.0,150.0,0.8375,0.3125,0.046875,0.0375
2701-2021_03_20_094024.jpg,van,40,221,640,18,480,279,3,261,297,LTAdatasets/2701/annotate/2701-2021_03_20_094024.jpg,241.0,288.0,0.3765625,0.6,0.0625,0.0375
2701-2021_03_20_100405.jpg,van,20,126,640,24,480,360,3,146,384,LTAdatasets/2701/annotate/2701-2021_03_20_100405.jpg,136.0,372.0,0.2125,0.775,0.03125,0.05
2701-2021_03_20_100405.jpg,van,19,153,640,25,480,327,3,172,352,LTAdatasets/2701/annotate/2701-2021_03_20_100405.jpg,162.5,339.5,0.25390625,0.7072916666666667,0.0296875,0.052083333333333336
2701-2021_03_20_100405.jpg,van,25,178,640,27,480,331,3,203,358,LTAdatasets/2701/annotate/2701-2021_03_20_100405.jpg,190.5,344.5,0.29765625,0.7177083333333333,0.0390625,0.05625
2701-2021_03_20_100405.jpg,van,20,244,640,18,480,304,3,264,322,LTAdatasets/2701/annotate/2701-2021_03_20_100405.jpg,254.0,313.0,0.396875,0.6520833333333333,0.03125,0.0375
2701-2021_03_20_100405.jpg,van,13,235,640,27,480,285,3,248,312,LTAdatasets/2701/annotate/2701-2021_03_20_100405.jpg,241.5,298.5,0.37734375,0.621875,0.0203125,0.05625
2701-2021_03_20_100405.jpg,van,16,311,640,21,480,263,3,327,284,LTAdatasets/2701/annotate/2701-2021_03_20_100405.jpg,319.0,273.5,0.4984375,0.5697916666666667,0.025,0.04375
2701-2021_03_20_100405.jpg,van,19,280,640,21,480,262,3,299,283,LTAdatasets/2701/annotate/2701-2021_03_20_100405.jpg,289.5,272.5,0.45234375,0.5677083333333334,0.0296875,0.04375
2701-2021_03_20_100405.jpg,van,18,381,640,23,480,227,3,399,250,LTAdatasets/2701/annotate/2701-2021_03_20_100405.jpg,390.0,238.5,0.609375,0.496875,0.028125,0.04791666666666667
2701-2021_03_20_100405.jpg,van,20,330,640,19,480,254,3,350,273,LTAdatasets/2701/annotate/2701-2021_03_20_100405.jpg,340.0,263.5,0.53125,0.5489583333333333,0.03125,0.03958333333333333
2701-2021_03_20_100405.jpg,van,9,316,640,11,480,249,3,325,260,LTAdatasets/2701/annotate/2701-2021_03_20_100405.jpg,320.5,254.5,0.50078125,0.5302083333333333,0.0140625,0.022916666666666665
2701-2021_03_20_100405.jpg,van,20,439,640,14,480,183,3,459,197,LTAdatasets/2701/annotate/2701-2021_03_20_100405.jpg,449.0,190.0,0.7015625,0.3958333333333333,0.03125,0.029166666666666667
2701-2021_03_20_100405.jpg,van,27,379,640,8,480,214,3,406,222,LTAdatasets/2701/annotate/2701-2021_03_20_100405.jpg,392.5,218.0,0.61328125,0.45416666666666666,0.0421875,0.016666666666666666
2701-2021_03_20_100405.jpg,van,30,449,640,13,480,188,3,479,201,LTAdatasets/2701/annotate/2701-2021_03_20_100405.jpg,464.0,194.5,0.725,0.40520833333333334,0.046875,0.027083333333333334
2701-2021_03_20_100405.jpg,van,32,417,640,38,480,198,3,449,236,LTAdatasets/2701/annotate/2701-2021_03_20_100405.jpg,433.0,217.0,0.6765625,0.45208333333333334,0.05,0.07916666666666666
2701-2021_03_20_100405.jpg,van,23,502,640,16,480,159,3,525,175,LTAdatasets/2701/annotate/2701-2021_03_20_100405.jpg,513.5,167.0,0.80234375,0.34791666666666665,0.0359375,0.03333333333333333
2701-2021_03_20_100405.jpg,van,21,471,640,10,480,168,3,492,178,LTAdatasets/2701/annotate/2701-2021_03_20_100405.jpg,481.5,173.0,0.75234375,0.36041666666666666,0.0328125,0.020833333333333332
2701-2021_03_20_100405.jpg,van,16,293,640,26,480,280,3,309,306,LTAdatasets/2701/annotate/2701-2021_03_20_100405.jpg,301.0,293.0,0.4703125,0.6104166666666667,0.025,0.05416666666666667
2701-2021_03_20_093424.jpg,lorry_truck,43,204,640,40,480,306,2,247,346,LTAdatasets/2701/annotate/2701-2021_03_20_093424.jpg,225.5,326.0,0.35234375,0.6791666666666667,0.0671875,0.08333333333333333
2701-2021_03_20_093424.jpg,lorry_truck,20,146,640,39,480,319,2,166,358,LTAdatasets/2701/annotate/2701-2021_03_20_093424.jpg,156.0,338.5,0.24375,0.7052083333333333,0.03125,0.08125
2701-2021_03_20_093424.jpg,lorry_truck,35,170,640,30,480,322,2,205,352,LTAdatasets/2701/annotate/2701-2021_03_20_093424.jpg,187.5,337.0,0.29296875,0.7020833333333333,0.0546875,0.0625
2701-2021_03_20_093424.jpg,lorry_truck,25,99,640,27,480,361,2,124,388,LTAdatasets/2701/annotate/2701-2021_03_20_093424.jpg,111.5,374.5,0.17421875,0.7802083333333333,0.0390625,0.05625
2701-2021_03_20_093424.jpg,lorry_truck,36,309,640,21,480,260,2,345,281,LTAdatasets/2701/annotate/2701-2021_03_20_093424.jpg,327.0,270.5,0.5109375,0.5635416666666667,0.05625,0.04375
2701-2021_03_20_093424.jpg,lorry_truck,20,280,640,15,480,282,2,300,297,LTAdatasets/2701/annotate/2701-2021_03_20_093424.jpg,290.0,289.5,0.453125,0.603125,0.03125,0.03125
2701-2021_03_20_093424.jpg,lorry_truck,25,379,640,18,480,226,2,404,244,LTAdatasets/2701/annotate/2701-2021_03_20_093424.jpg,391.5,235.0,0.61171875,0.4895833333333333,0.0390625,0.0375
2701-2021_03_20_093424.jpg,lorry_truck,28,403,640,25,480,210,2,431,235,LTAdatasets/2701/annotate/2701-2021_03_20_093424.jpg,417.0,222.5,0.6515625,0.4635416666666667,0.04375,0.052083333333333336
2701-2021_03_20_093424.jpg,lorry_truck,18,472,640,15,480,169,2,490,184,LTAdatasets/2701/annotate/2701-2021_03_20_093424.jpg,481.0,176.5,0.7515625,0.36770833333333336,0.028125,0.03125
2701-2021_03_20_093424.jpg,lorry_truck,24,451,640,18,480,187,2,475,205,LTAdatasets/2701/annotate/2701-2021_03_20_093424.jpg,463.0,196.0,0.7234375,0.4083333333333333,0.0375,0.0375
2701-2021_03_20_093424.jpg,lorry_truck,25,431,640,18,480,201,2,456,219,LTAdatasets/2701/annotate/2701-2021_03_20_093424.jpg,443.5,210.0,0.69296875,0.4375,0.0390625,0.0375
2701-2021_03_20_093424.jpg,lorry_truck,29,512,640,16,480,156,2,541,172,LTAdatasets/2701/annotate/2701-2021_03_20_093424.jpg,526.5,164.0,0.82265625,0.3416666666666667,0.0453125,0.03333333333333333
2701-2021_03_20_093424.jpg,lorry_truck,33,342,640,20,480,249,2,375,269,LTAdatasets/2701/annotate/2701-2021_03_20_093424.jpg,358.5,259.0,0.56015625,0.5395833333333333,0.0515625,0.041666666666666664
2701-2021_03_20_093424.jpg,lorry_truck,25,22,640,20,480,396,2,47,416,LTAdatasets/2701/annotate/2701-2021_03_20_093424.jpg,34.5,406.0,0.05390625,0.8458333333333333,0.0390625,0.041666666666666664
2701-2021_03_20_080419.jpg,lorry_truck,24,359,640,25,480,236,2,383,261,LTAdatasets/2701/annotate/2701-2021_03_20_080419.jpg,371.0,248.5,0.5796875,0.5177083333333333,0.0375,0.052083333333333336
2701-2021_03_20_080419.jpg,lorry_truck,20,307,640,19,480,270,2,327,289,LTAdatasets/2701/annotate/2701-2021_03_20_080419.jpg,317.0,279.5,0.4953125,0.5822916666666667,0.03125,0.03958333333333333
2701-2021_03_20_080419.jpg,lorry_truck,15,276,640,23,480,283,2,291,306,LTAdatasets/2701/annotate/2701-2021_03_20_080419.jpg,283.5,294.5,0.44296875,0.6135416666666667,0.0234375,0.04791666666666667
2701-2021_03_20_080419.jpg,lorry_truck,32,245,640,28,480,292,2,277,320,LTAdatasets/2701/annotate/2701-2021_03_20_080419.jpg,261.0,306.0,0.4078125,0.6375,0.05,0.058333333333333334
2701-2021_03_20_080419.jpg,lorry_truck,20,217,640,25,480,293,2,237,318,LTAdatasets/2701/annotate/2701-2021_03_20_080419.jpg,227.0,305.5,0.3546875,0.6364583333333333,0.03125,0.052083333333333336
2701-2021_03_20_080419.jpg,lorry_truck,15,215,640,20,480,325,2,230,345,LTAdatasets/2701/annotate/2701-2021_03_20_080419.jpg,222.5,335.0,0.34765625,0.6979166666666666,0.0234375,0.041666666666666664
2701-2021_03_20_080419.jpg,lorry_truck,44,167,640,27,480,330,2,211,357,LTAdatasets/2701/annotate/2701-2021_03_20_080419.jpg,189.0,343.5,0.2953125,0.715625,0.06875,0.05625
2701-2021_03_20_080419.jpg,lorry_truck,40,127,640,21,480,349,2,167,370,LTAdatasets/2701/annotate/2701-2021_03_20_080419.jpg,147.0,359.5,0.2296875,0.7489583333333333,0.0625,0.04375
2701-2021_03_20_080419.jpg,lorry_truck,46,83,640,36,480,364,2,129,400,LTAdatasets/2701/annotate/2701-2021_03_20_080419.jpg,106.0,382.0,0.165625,0.7958333333333333,0.071875,0.075
2701-2021_03_20_080419.jpg,lorry_truck,18,310,640,26,480,236,2,328,262,LTAdatasets/2701/annotate/2701-2021_03_20_080419.jpg,319.0,249.0,0.4984375,0.51875,0.028125,0.05416666666666667
2701-2021_03_20_080419.jpg,lorry_truck,37,422,640,23,480,196,2,459,219,LTAdatasets/2701/annotate/2701-2021_03_20_080419.jpg,440.5,207.5,0.68828125,0.4322916666666667,0.0578125,0.04791666666666667
2701-2021_03_20_080419.jpg,lorry_truck,35,476,640,19,480,165,2,511,184,LTAdatasets/2701/annotate/2701-2021_03_20_080419.jpg,493.5,174.5,0.77109375,0.36354166666666665,0.0546875,0.03958333333333333
2701-2021_03_20_180710.jpg,lorry_truck,28,24,640,18,480,361,2,52,379,LTAdatasets/2701/annotate/2701-2021_03_20_180710.jpg,38.0,370.0,0.059375,0.7708333333333334,0.04375,0.0375
2701-2021_03_20_182451.jpg,lorry_truck,40,376,640,33,480,213,2,416,246,LTAdatasets/2701/annotate/2701-2021_03_20_182451.jpg,396.0,229.5,0.61875,0.478125,0.0625,0.06875
2701-2021_03_20_182451.jpg,lorry_truck,25,461,640,24,480,176,2,486,200,LTAdatasets/2701/annotate/2701-2021_03_20_182451.jpg,473.5,188.0,0.73984375,0.39166666666666666,0.0390625,0.05
2701-2021_03_20_182151.jpg,lorry_truck,53,214,640,29,480,309,2,267,338,LTAdatasets/2701/annotate/2701-2021_03_20_182151.jpg,240.5,323.5,0.37578125,0.6739583333333333,0.0828125,0.06041666666666667
2701-2021_03_20_082220.jpg,lorry_truck,56,115,640,30,480,323,2,171,353,LTAdatasets/2701/annotate/2701-2021_03_20_082220.jpg,143.0,338.0,0.2234375,0.7041666666666667,0.0875,0.0625
2701-2021_03_20_082220.jpg,bus,52,139,640,30,480,352,5,191,382,LTAdatasets/2701/annotate/2701-2021_03_20_082220.jpg,165.0,367.0,0.2578125,0.7645833333333333,0.08125,0.0625
2701-2021_03_20_082220.jpg,lorry_truck,33,177,640,33,480,323,2,210,356,LTAdatasets/2701/annotate/2701-2021_03_20_082220.jpg,193.5,339.5,0.30234375,0.7072916666666667,0.0515625,0.06875
2701-2021_03_20_082220.jpg,lorry_truck,28,231,640,15,480,313,2,259,328,LTAdatasets/2701/annotate/2701-2021_03_20_082220.jpg,245.0,320.5,0.3828125,0.6677083333333333,0.04375,0.03125
2701-2021_03_20_082220.jpg,lorry_truck,21,230,640,25,480,284,2,251,309,LTAdatasets/2701/annotate/2701-2021_03_20_082220.jpg,240.5,296.5,0.37578125,0.6177083333333333,0.0328125,0.052083333333333336
2701-2021_03_20_082220.jpg,lorry_truck,38,253,640,24,480,289,2,291,313,LTAdatasets/2701/annotate/2701-2021_03_20_082220.jpg,272.0,301.0,0.425,0.6270833333333333,0.059375,0.05
2701-2021_03_20_082220.jpg,lorry_truck,43,187,640,27,480,296,2,230,323,LTAdatasets/2701/annotate/2701-2021_03_20_082220.jpg,208.5,309.5,0.32578125,0.6447916666666667,0.0671875,0.05625
2701-2021_03_20_082220.jpg,lorry_truck,30,352,640,20,480,242,2,382,262,LTAdatasets/2701/annotate/2701-2021_03_20_082220.jpg,367.0,252.0,0.5734375,0.525,0.046875,0.041666666666666664
2701-2021_03_20_082220.jpg,lorry_truck,46,307,640,35,480,259,2,353,294,LTAdatasets/2701/annotate/2701-2021_03_20_082220.jpg,330.0,276.5,0.515625,0.5760416666666667,0.071875,0.07291666666666667
2701-2021_03_20_082220.jpg,lorry_truck,33,276,640,19,480,267,2,309,286,LTAdatasets/2701/annotate/2701-2021_03_20_082220.jpg,292.5,276.5,0.45703125,0.5760416666666667,0.0515625,0.03958333333333333
2701-2021_03_20_082220.jpg,lorry_truck,51,5,640,27,480,392,2,56,419,LTAdatasets/2701/annotate/2701-2021_03_20_082220.jpg,30.5,405.5,0.04765625,0.8447916666666667,0.0796875,0.05625
2701-2021_03_20_082220.jpg,lorry_truck,33,431,640,25,480,189,2,464,214,LTAdatasets/2701/annotate/2701-2021_03_20_082220.jpg,447.5,201.5,0.69921875,0.4197916666666667,0.0515625,0.052083333333333336
2701-2021_03_20_082220.jpg,lorry_truck,31,454,640,23,480,172,2,485,195,LTAdatasets/2701/annotate/2701-2021_03_20_082220.jpg,469.5,183.5,0.73359375,0.38229166666666664,0.0484375,0.04791666666666667
2701-2021_03_20_082220.jpg,lorry_truck,31,395,640,17,480,200,2,426,217,LTAdatasets/2701/annotate/2701-2021_03_20_082220.jpg,410.5,208.5,0.64140625,0.434375,0.0484375,0.035416666666666666
2701-2021_03_20_194616.jpg,lorry_truck,37,393,640,28,480,211,2,430,239,LTAdatasets/2701/annotate/2701-2021_03_20_194616.jpg,411.5,225.0,0.64296875,0.46875,0.0578125,0.058333333333333334
2701-2021_03_20_194616.jpg,van,20,506,640,22,480,155,3,526,177,LTAdatasets/2701/annotate/2701-2021_03_20_194616.jpg,516.0,166.0,0.80625,0.3458333333333333,0.03125,0.04583333333333333
2701-2021_03_20_090702.jpg,lorry_truck,38,107,640,32,480,357,2,145,389,LTAdatasets/2701/annotate/2701-2021_03_20_090702.jpg,126.0,373.0,0.196875,0.7770833333333333,0.059375,0.06666666666666667
2701-2021_03_20_090702.jpg,lorry_truck,49,157,640,26,480,333,2,206,359,LTAdatasets/2701/annotate/2701-2021_03_20_090702.jpg,181.5,346.0,0.28359375,0.7208333333333333,0.0765625,0.05416666666666667
2701-2021_03_20_090702.jpg,lorry_truck,44,155,640,15,480,321,2,199,336,LTAdatasets/2701/annotate/2701-2021_03_20_090702.jpg,177.0,328.5,0.2765625,0.684375,0.06875,0.03125
2701-2021_03_20_090702.jpg,lorry_truck,37,220,640,29,480,306,2,257,335,LTAdatasets/2701/annotate/2701-2021_03_20_090702.jpg,238.5,320.5,0.37265625,0.6677083333333333,0.0578125,0.06041666666666667
2701-2021_03_20_090702.jpg,lorry_truck,28,202,640,13,480,298,2,230,311,LTAdatasets/2701/annotate/2701-2021_03_20_090702.jpg,216.0,304.5,0.3375,0.634375,0.04375,0.027083333333333334
2701-2021_03_20_090702.jpg,lorry_truck,31,250,640,27,480,276,2,281,303,LTAdatasets/2701/annotate/2701-2021_03_20_090702.jpg,265.5,289.5,0.41484375,0.603125,0.0484375,0.05625
2701-2021_03_20_090702.jpg,lorry_truck,45,275,640,31,480,277,2,320,308,LTAdatasets/2701/annotate/2701-2021_03_20_090702.jpg,297.5,292.5,0.46484375,0.609375,0.0703125,0.06458333333333334
2701-2021_03_20_090702.jpg,lorry_truck,47,293,640,33,480,243,2,340,276,LTAdatasets/2701/annotate/2701-2021_03_20_090702.jpg,316.5,259.5,0.49453125,0.540625,0.0734375,0.06875
2701-2021_03_20_090702.jpg,lorry_truck,43,341,640,24,480,238,2,384,262,LTAdatasets/2701/annotate/2701-2021_03_20_090702.jpg,362.5,250.0,0.56640625,0.5208333333333334,0.0671875,0.05
2701-2021_03_20_090702.jpg,lorry_truck,32,384,640,24,480,225,2,416,249,LTAdatasets/2701/annotate/2701-2021_03_20_090702.jpg,400.0,237.0,0.625,0.49375,0.05,0.05
2701-2021_03_20_090702.jpg,lorry_truck,31,404,640,22,480,210,2,435,232,LTAdatasets/2701/annotate/2701-2021_03_20_090702.jpg,419.5,221.0,0.65546875,0.46041666666666664,0.0484375,0.04583333333333333
2701-2021_03_20_090702.jpg,lorry_truck,25,386,640,19,480,202,2,411,221,LTAdatasets/2701/annotate/2701-2021_03_20_090702.jpg,398.5,211.5,0.62265625,0.440625,0.0390625,0.03958333333333333
2701-2021_03_20_090702.jpg,lorry_truck,30,429,640,18,480,196,2,459,214,LTAdatasets/2701/annotate/2701-2021_03_20_090702.jpg,444.0,205.0,0.69375,0.4270833333333333,0.046875,0.0375
2701-2021_03_20_090702.jpg,lorry_truck,21,448,640,11,480,194,2,469,205,LTAdatasets/2701/annotate/2701-2021_03_20_090702.jpg,458.5,199.5,0.71640625,0.415625,0.0328125,0.022916666666666665
2701-2021_03_20_090702.jpg,lorry_truck,26,465,640,16,480,184,2,491,200,LTAdatasets/2701/annotate/2701-2021_03_20_090702.jpg,478.0,192.0,0.746875,0.4,0.040625,0.03333333333333333
2701-2021_03_20_090702.jpg,lorry_truck,47,441,640,33,480,165,2,488,198,LTAdatasets/2701/annotate/2701-2021_03_20_090702.jpg,464.5,181.5,0.72578125,0.378125,0.0734375,0.06875
2701-2021_03_20_090702.jpg,lorry_truck,21,506,640,20,480,157,2,527,177,LTAdatasets/2701/annotate/2701-2021_03_20_090702.jpg,516.5,167.0,0.80703125,0.34791666666666665,0.0328125,0.041666666666666664
2701-2021_03_20_090702.jpg,lorry_truck,28,473,640,25,480,159,2,501,184,LTAdatasets/2701/annotate/2701-2021_03_20_090702.jpg,487.0,171.5,0.7609375,0.3572916666666667,0.04375,0.052083333333333336
2701-2021_03_20_184613.jpg,lorry_truck,32,329,640,28,480,251,2,361,279,LTAdatasets/2701/annotate/2701-2021_03_20_184613.jpg,345.0,265.0,0.5390625,0.5520833333333334,0.05,0.058333333333333334
2701-2021_03_20_081539.jpg,lorry_truck,33,547,640,18,480,135,2,580,153,LTAdatasets/2701/annotate/2701-2021_03_20_081539.jpg,563.5,144.0,0.88046875,0.3,0.0515625,0.0375
2701-2021_03_20_081539.jpg,lorry_truck,38,445,640,25,480,183,2,483,208,LTAdatasets/2701/annotate/2701-2021_03_20_081539.jpg,464.0,195.5,0.725,0.40729166666666666,0.059375,0.052083333333333336
2701-2021_03_20_081539.jpg,lorry_truck,49,268,640,36,480,272,2,317,308,LTAdatasets/2701/annotate/2701-2021_03_20_081539.jpg,292.5,290.0,0.45703125,0.6041666666666666,0.0765625,0.075
2701-2021_03_20_081539.jpg,lorry_truck,31,486,640,25,480,164,2,517,189,LTAdatasets/2701/annotate/2701-2021_03_20_081539.jpg,501.5,176.5,0.78359375,0.36770833333333336,0.0484375,0.052083333333333336
2701-2021_03_20_081539.jpg,lorry_truck,28,385,640,26,480,223,2,413,249,LTAdatasets/2701/annotate/2701-2021_03_20_081539.jpg,399.0,236.0,0.6234375,0.49166666666666664,0.04375,0.05416666666666667
2701-2021_03_20_081539.jpg,lorry_truck,28,409,640,27,480,203,2,437,230,LTAdatasets/2701/annotate/2701-2021_03_20_081539.jpg,423.0,216.5,0.6609375,0.4510416666666667,0.04375,0.05625
2701-2021_03_20_081539.jpg,lorry_truck,24,381,640,25,480,208,2,405,233,LTAdatasets/2701/annotate/2701-2021_03_20_081539.jpg,393.0,220.5,0.6140625,0.459375,0.0375,0.052083333333333336
2701-2021_03_20_081539.jpg,lorry_truck,50,209,640,16,480,294,2,259,310,LTAdatasets/2701/annotate/2701-2021_03_20_081539.jpg,234.0,302.0,0.365625,0.6291666666666667,0.078125,0.03333333333333333
2701-2021_03_20_081539.jpg,lorry_truck,61,158,640,18,480,328,2,219,346,LTAdatasets/2701/annotate/2701-2021_03_20_081539.jpg,188.5,337.0,0.29453125,0.7020833333333333,0.0953125,0.0375
2701-2021_03_20_081539.jpg,lorry_truck,64,77,640,36,480,352,2,141,388,LTAdatasets/2701/annotate/2701-2021_03_20_081539.jpg,109.0,370.0,0.1703125,0.7708333333333334,0.1,0.075
2701-2021_03_20_081539.jpg,lorry_truck,34,127,640,21,480,332,2,161,353,LTAdatasets/2701/annotate/2701-2021_03_20_081539.jpg,144.0,342.5,0.225,0.7135416666666666,0.053125,0.04375
2701-2021_03_20_081539.jpg,lorry_truck,47,214,640,30,480,305,2,261,335,LTAdatasets/2701/annotate/2701-2021_03_20_081539.jpg,237.5,320.0,0.37109375,0.6666666666666666,0.0734375,0.0625
2701-2021_03_20_081539.jpg,lorry_truck,38,324,640,28,480,245,2,362,273,LTAdatasets/2701/annotate/2701-2021_03_20_081539.jpg,343.0,259.0,0.5359375,0.5395833333333333,0.059375,0.058333333333333334
2701-2021_03_20_081539.jpg,lorry_truck,27,290,640,15,480,263,2,317,278,LTAdatasets/2701/annotate/2701-2021_03_20_081539.jpg,303.5,270.5,0.47421875,0.5635416666666667,0.0421875,0.03125
2701-2021_03_20_081539.jpg,lorry_truck,30,286,640,26,480,241,2,316,267,LTAdatasets/2701/annotate/2701-2021_03_20_081539.jpg,301.0,254.0,0.4703125,0.5291666666666667,0.046875,0.05416666666666667
2701-2021_03_20_081539.jpg,lorry_truck,29,453,640,20,480,168,2,482,188,LTAdatasets/2701/annotate/2701-2021_03_20_081539.jpg,467.5,178.0,0.73046875,0.37083333333333335,0.0453125,0.041666666666666664
2701-2021_03_20_081539.jpg,lorry_truck,24,519,640,26,480,145,2,543,171,LTAdatasets/2701/annotate/2701-2021_03_20_081539.jpg,531.0,158.0,0.8296875,0.32916666666666666,0.0375,0.05416666666666667
2701-2021_03_20_074618.jpg,lorry_truck,33,107,640,52,480,341,2,140,393,LTAdatasets/2701/annotate/2701-2021_03_20_074618.jpg,123.5,367.0,0.19296875,0.7645833333333333,0.0515625,0.10833333333333334
2701-2021_03_20_074618.jpg,lorry_truck,37,130,640,30,480,323,2,167,353,LTAdatasets/2701/annotate/2701-2021_03_20_074618.jpg,148.5,338.0,0.23203125,0.7041666666666667,0.0578125,0.0625
2701-2021_03_20_074618.jpg,lorry_truck,64,155,640,38,480,328,2,219,366,LTAdatasets/2701/annotate/2701-2021_03_20_074618.jpg,187.0,347.0,0.2921875,0.7229166666666667,0.1,0.07916666666666666
2701-2021_03_20_074618.jpg,lorry_truck,51,208,640,37,480,303,2,259,340,LTAdatasets/2701/annotate/2701-2021_03_20_074618.jpg,233.5,321.5,0.36484375,0.6697916666666667,0.0796875,0.07708333333333334
2701-2021_03_20_074618.jpg,lorry_truck,44,260,640,33,480,279,2,304,312,LTAdatasets/2701/annotate/2701-2021_03_20_074618.jpg,282.0,295.5,0.440625,0.615625,0.06875,0.06875
2701-2021_03_20_074618.jpg,lorry_truck,28,269,640,23,480,261,2,297,284,LTAdatasets/2701/annotate/2701-2021_03_20_074618.jpg,283.0,272.5,0.4421875,0.5677083333333334,0.04375,0.04791666666666667
2701-2021_03_20_074618.jpg,lorry_truck,45,297,640,30,480,262,2,342,292,LTAdatasets/2701/annotate/2701-2021_03_20_074618.jpg,319.5,277.0,0.49921875,0.5770833333333333,0.0703125,0.0625
2701-2021_03_20_074618.jpg,lorry_truck,47,331,640,31,480,240,2,378,271,LTAdatasets/2701/annotate/2701-2021_03_20_074618.jpg,354.5,255.5,0.55390625,0.5322916666666667,0.0734375,0.06458333333333334
2701-2021_03_20_074618.jpg,lorry_truck,39,353,640,19,480,221,2,392,240,LTAdatasets/2701/annotate/2701-2021_03_20_074618.jpg,372.5,230.5,0.58203125,0.48020833333333335,0.0609375,0.03958333333333333
2701-2021_03_20_074618.jpg,lorry_truck,27,389,640,20,480,209,2,416,229,LTAdatasets/2701/annotate/2701-2021_03_20_074618.jpg,402.5,219.0,0.62890625,0.45625,0.0421875,0.041666666666666664
2701-2021_03_20_074618.jpg,lorry_truck,32,409,640,24,480,191,2,441,215,LTAdatasets/2701/annotate/2701-2021_03_20_074618.jpg,425.0,203.0,0.6640625,0.42291666666666666,0.05,0.05
3705-2021_03_20_190113.jpg,van,33,434,640,14,360,82,3,467,96,LTAdatasets/3705/annotate/3705-2021_03_20_190113.jpg,450.5,89.0,0.70390625,0.24722222222222223,0.0515625,0.03888888888888889
3705-2021_03_20_190113.jpg,car,25,385,640,22,360,72,1,410,94,LTAdatasets/3705/annotate/3705-2021_03_20_190113.jpg,397.5,83.0,0.62109375,0.23055555555555557,0.0390625,0.06111111111111111
3705-2021_03_20_202758.jpg,car,51,327,640,39,360,117,1,378,156,LTAdatasets/3705/annotate/3705-2021_03_20_202758.jpg,352.5,136.5,0.55078125,0.37916666666666665,0.0796875,0.10833333333333334
3705-2021_03_20_202758.jpg,car,22,204,640,15,360,65,1,226,80,LTAdatasets/3705/annotate/3705-2021_03_20_202758.jpg,215.0,72.5,0.3359375,0.2013888888888889,0.034375,0.041666666666666664
3705-2021_03_20_202758.jpg,car,35,513,640,28,360,108,1,548,136,LTAdatasets/3705/annotate/3705-2021_03_20_202758.jpg,530.5,122.0,0.82890625,0.3388888888888889,0.0546875,0.07777777777777778
3705-2021_03_20_072817.jpg,bike,19,191,640,30,360,132,4,210,162,LTAdatasets/3705/annotate/3705-2021_03_20_072817.jpg,200.5,147.0,0.31328125,0.4083333333333333,0.0296875,0.08333333333333333
3705-2021_03_20_072817.jpg,bike,15,155,640,22,360,97,4,170,119,LTAdatasets/3705/annotate/3705-2021_03_20_072817.jpg,162.5,108.0,0.25390625,0.3,0.0234375,0.06111111111111111
3705-2021_03_20_075518.jpg,car,32,156,640,23,360,96,1,188,119,LTAdatasets/3705/annotate/3705-2021_03_20_075518.jpg,172.0,107.5,0.26875,0.2986111111111111,0.05,0.06388888888888888
3705-2021_03_20_075518.jpg,lorry_truck,19,129,640,28,360,55,2,148,83,LTAdatasets/3705/annotate/3705-2021_03_20_075518.jpg,138.5,69.0,0.21640625,0.19166666666666668,0.0296875,0.07777777777777778
3705-2021_03_20_072517.jpg,car,33,543,640,29,360,109,1,576,138,LTAdatasets/3705/annotate/3705-2021_03_20_072517.jpg,559.5,123.5,0.87421875,0.34305555555555556,0.0515625,0.08055555555555556
3705-2021_03_20_091002.jpg,car,106,233,640,102,360,227,1,339,329,LTAdatasets/3705/annotate/3705-2021_03_20_091002.jpg,286.0,278.0,0.446875,0.7722222222222223,0.165625,0.2833333333333333
3705-2021_03_20_091002.jpg,lorry_truck,215,408,640,165,360,195,2,623,360,LTAdatasets/3705/annotate/3705-2021_03_20_091002.jpg,515.5,277.5,0.80546875,0.7708333333333334,0.3359375,0.4583333333333333
3705-2021_03_20_091002.jpg,lorry_truck,64,144,640,65,360,80,2,208,145,LTAdatasets/3705/annotate/3705-2021_03_20_091002.jpg,176.0,112.5,0.275,0.3125,0.1,0.18055555555555555
3705-2021_03_20_091002.jpg,car,18,233,640,19,360,61,1,251,80,LTAdatasets/3705/annotate/3705-2021_03_20_091002.jpg,242.0,70.5,0.378125,0.19583333333333333,0.028125,0.05277777777777778
3705-2021_03_20_092143.jpg,car,47,289,640,33,360,106,1,336,139,LTAdatasets/3705/annotate/3705-2021_03_20_092143.jpg,312.5,122.5,0.48828125,0.3402777777777778,0.0734375,0.09166666666666666
3705-2021_03_20_090102.jpg,car,37,313,640,26,360,97,1,350,123,LTAdatasets/3705/annotate/3705-2021_03_20_090102.jpg,331.5,110.0,0.51796875,0.3055555555555556,0.0578125,0.07222222222222222
3705-2021_03_20_090102.jpg,car,34,254,640,24,360,88,1,288,112,LTAdatasets/3705/annotate/3705-2021_03_20_090102.jpg,271.0,100.0,0.4234375,0.2777777777777778,0.053125,0.06666666666666667
3705-2021_03_20_090102.jpg,car,19,436,640,14,360,80,1,455,94,LTAdatasets/3705/annotate/3705-2021_03_20_090102.jpg,445.5,87.0,0.69609375,0.24166666666666667,0.0296875,0.03888888888888889
3705-2021_03_20_203658.jpg,lorry_truck,24,130,640,19,360,61,2,154,80,LTAdatasets/3705/annotate/3705-2021_03_20_203658.jpg,142.0,70.5,0.221875,0.19583333333333333,0.0375,0.05277777777777778
3705-2021_03_20_190634.jpg,lorry_truck,78,171,640,86,360,91,2,249,177,LTAdatasets/3705/annotate/3705-2021_03_20_190634.jpg,210.0,134.0,0.328125,0.37222222222222223,0.121875,0.2388888888888889
3705-2021_03_20_190634.jpg,car,28,399,640,18,360,72,1,427,90,LTAdatasets/3705/annotate/3705-2021_03_20_190634.jpg,413.0,81.0,0.6453125,0.225,0.04375,0.05
3705-2021_03_20_191234.jpg,car,52,310,640,34,360,116,1,362,150,LTAdatasets/3705/annotate/3705-2021_03_20_191234.jpg,336.0,133.0,0.525,0.36944444444444446,0.08125,0.09444444444444444
3705-2021_03_20_191234.jpg,lorry_truck,58,528,640,44,360,95,2,586,139,LTAdatasets/3705/annotate/3705-2021_03_20_191234.jpg,557.0,117.0,0.8703125,0.325,0.090625,0.12222222222222222
3705-2021_03_20_191234.jpg,car,18,134,640,13,360,73,1,152,86,LTAdatasets/3705/annotate/3705-2021_03_20_191234.jpg,143.0,79.5,0.2234375,0.22083333333333333,0.028125,0.03611111111111111
3705-2021_03_20_191234.jpg,bike,15,389,640,16,360,73,4,404,89,LTAdatasets/3705/annotate/3705-2021_03_20_191234.jpg,396.5,81.0,0.61953125,0.225,0.0234375,0.044444444444444446
3705-2021_03_20_095505.jpg,lorry_truck,105,180,640,109,360,101,2,285,210,LTAdatasets/3705/annotate/3705-2021_03_20_095505.jpg,232.5,155.5,0.36328125,0.43194444444444446,0.1640625,0.30277777777777776
3705-2021_03_20_095505.jpg,car,20,396,640,17,360,75,1,416,92,LTAdatasets/3705/annotate/3705-2021_03_20_095505.jpg,406.0,83.5,0.634375,0.23194444444444445,0.03125,0.04722222222222222
3705-2021_03_20_181011.jpg,car,20,620,640,23,360,150,1,640,173,LTAdatasets/3705/annotate/3705-2021_03_20_181011.jpg,630.0,161.5,0.984375,0.4486111111111111,0.03125,0.06388888888888888
3705-2021_03_20_181011.jpg,car,21,401,640,14,360,73,1,422,87,LTAdatasets/3705/annotate/3705-2021_03_20_181011.jpg,411.5,80.0,0.64296875,0.2222222222222222,0.0328125,0.03888888888888889
3705-2021_03_20_181011.jpg,lorry_truck,37,427,640,25,360,67,2,464,92,LTAdatasets/3705/annotate/3705-2021_03_20_181011.jpg,445.5,79.5,0.69609375,0.22083333333333333,0.0578125,0.06944444444444445
3705-2021_03_20_095205.jpg,car,52,366,640,32,360,120,1,418,152,LTAdatasets/3705/annotate/3705-2021_03_20_095205.jpg,392.0,136.0,0.6125,0.37777777777777777,0.08125,0.08888888888888889
3705-2021_03_20_095205.jpg,car,51,238,640,34,360,127,1,289,161,LTAdatasets/3705/annotate/3705-2021_03_20_095205.jpg,263.5,144.0,0.41171875,0.4,0.0796875,0.09444444444444444
3705-2021_03_20_183412.jpg,car,78,464,640,50,360,164,1,542,214,LTAdatasets/3705/annotate/3705-2021_03_20_183412.jpg,503.0,189.0,0.7859375,0.525,0.121875,0.1388888888888889
3705-2021_03_20_183412.jpg,car,30,551,640,25,360,118,1,581,143,LTAdatasets/3705/annotate/3705-2021_03_20_183412.jpg,566.0,130.5,0.884375,0.3625,0.046875,0.06944444444444445
3705-2021_03_20_202217.jpg,car,33,254,640,34,360,116,1,287,150,LTAdatasets/3705/annotate/3705-2021_03_20_202217.jpg,270.5,133.0,0.42265625,0.36944444444444446,0.0515625,0.09444444444444444
3705-2021_03_20_202217.jpg,car,31,241,640,21,360,82,1,272,103,LTAdatasets/3705/annotate/3705-2021_03_20_202217.jpg,256.5,92.5,0.40078125,0.2569444444444444,0.0484375,0.058333333333333334
3705-2021_03_20_202217.jpg,car,31,423,640,16,360,83,1,454,99,LTAdatasets/3705/annotate/3705-2021_03_20_202217.jpg,438.5,91.0,0.68515625,0.25277777777777777,0.0484375,0.044444444444444446
3705-2021_03_20_083340.jpg,lorry_truck,54,457,640,29,360,82,2,511,111,LTAdatasets/3705/annotate/3705-2021_03_20_083340.jpg,484.0,96.5,0.75625,0.26805555555555555,0.084375,0.08055555555555556
3705-2021_03_20_072216.jpg,bus,68,540,640,45,360,101,5,608,146,LTAdatasets/3705/annotate/3705-2021_03_20_072216.jpg,574.0,123.5,0.896875,0.34305555555555556,0.10625,0.125
3705-2021_03_20_091302.jpg,car,69,223,640,69,360,185,1,292,254,LTAdatasets/3705/annotate/3705-2021_03_20_091302.jpg,257.5,219.5,0.40234375,0.6097222222222223,0.1078125,0.19166666666666668
3705-2021_03_20_091302.jpg,lorry_truck,39,149,640,41,360,70,2,188,111,LTAdatasets/3705/annotate/3705-2021_03_20_091302.jpg,168.5,90.5,0.26328125,0.2513888888888889,0.0609375,0.11388888888888889
3705-2021_03_20_082220.jpg,lorry_truck,75,565,640,54,360,106,2,640,160,LTAdatasets/3705/annotate/3705-2021_03_20_082220.jpg,602.5,133.0,0.94140625,0.36944444444444446,0.1171875,0.15
3705-2021_03_20_082220.jpg,lorry_truck,218,273,640,107,360,253,2,491,360,LTAdatasets/3705/annotate/3705-2021_03_20_082220.jpg,382.0,306.5,0.596875,0.8513888888888889,0.340625,0.2972222222222222
3705-2021_03_20_184613.jpg,car,115,525,640,98,360,236,1,640,334,LTAdatasets/3705/annotate/3705-2021_03_20_184613.jpg,582.5,285.0,0.91015625,0.7916666666666666,0.1796875,0.2722222222222222
3705-2021_03_20_182151.jpg,car,50,354,640,27,360,115,1,404,142,LTAdatasets/3705/annotate/3705-2021_03_20_182151.jpg,379.0,128.5,0.5921875,0.35694444444444445,0.078125,0.075
3705-2021_03_20_182151.jpg,car,28,164,640,24,360,106,1,192,130,LTAdatasets/3705/annotate/3705-2021_03_20_182151.jpg,178.0,118.0,0.278125,0.3277777777777778,0.04375,0.06666666666666667
3705-2021_03_20_182151.jpg,car,19,178,640,14,360,67,1,197,81,LTAdatasets/3705/annotate/3705-2021_03_20_182151.jpg,187.5,74.0,0.29296875,0.20555555555555555,0.0296875,0.03888888888888889
3705-2021_03_20_182151.jpg,car,15,209,640,10,360,67,1,224,77,LTAdatasets/3705/annotate/3705-2021_03_20_182151.jpg,216.5,72.0,0.33828125,0.2,0.0234375,0.027777777777777776
3705-2021_03_20_182151.jpg,lorry_truck,30,127,640,30,360,57,2,157,87,LTAdatasets/3705/annotate/3705-2021_03_20_182151.jpg,142.0,72.0,0.221875,0.2,0.046875,0.08333333333333333
3705-2021_03_20_094305.jpg,lorry_truck,77,563,640,92,360,247,2,640,339,LTAdatasets/3705/annotate/3705-2021_03_20_094305.jpg,601.5,293.0,0.93984375,0.8138888888888889,0.1203125,0.25555555555555554
3705-2021_03_20_094305.jpg,van,21,183,640,18,360,64,3,204,82,LTAdatasets/3705/annotate/3705-2021_03_20_094305.jpg,193.5,73.0,0.30234375,0.20277777777777778,0.0328125,0.05
3705-2021_03_20_185153.jpg,lorry_truck,45,144,640,46,360,69,2,189,115,LTAdatasets/3705/annotate/3705-2021_03_20_185153.jpg,166.5,92.0,0.26015625,0.25555555555555554,0.0703125,0.12777777777777777
3705-2021_03_20_185153.jpg,car,25,230,640,15,360,66,1,255,81,LTAdatasets/3705/annotate/3705-2021_03_20_185153.jpg,242.5,73.5,0.37890625,0.20416666666666666,0.0390625,0.041666666666666664
3705-2021_03_20_092543.jpg,car,30,414,640,17,360,83,1,444,100,LTAdatasets/3705/annotate/3705-2021_03_20_092543.jpg,429.0,91.5,0.6703125,0.25416666666666665,0.046875,0.04722222222222222
3705-2021_03_20_092543.jpg,car,72,568,640,73,360,262,1,640,335,LTAdatasets/3705/annotate/3705-2021_03_20_092543.jpg,604.0,298.5,0.94375,0.8291666666666667,0.1125,0.20277777777777778
3705-2021_03_20_075818.jpg,bike,11,243,640,22,360,96,4,254,118,LTAdatasets/3705/annotate/3705-2021_03_20_075818.jpg,248.5,107.0,0.38828125,0.2972222222222222,0.0171875,0.06111111111111111
3705-2021_03_20_180110.jpg,lorry_truck,41,384,640,30,360,61,2,425,91,LTAdatasets/3705/annotate/3705-2021_03_20_180110.jpg,404.5,76.0,0.63203125,0.2111111111111111,0.0640625,0.08333333333333333
3705-2021_03_20_075138.jpg,car,143,234,640,107,360,250,1,377,357,LTAdatasets/3705/annotate/3705-2021_03_20_075138.jpg,305.5,303.5,0.47734375,0.8430555555555556,0.2234375,0.2972222222222222
3705-2021_03_20_075138.jpg,car,22,146,640,19,360,83,1,168,102,LTAdatasets/3705/annotate/3705-2021_03_20_075138.jpg,157.0,92.5,0.2453125,0.2569444444444444,0.034375,0.05277777777777778
3705-2021_03_20_075138.jpg,lorry_truck,33,214,640,37,360,78,2,247,115,LTAdatasets/3705/annotate/3705-2021_03_20_075138.jpg,230.5,96.5,0.36015625,0.26805555555555555,0.0515625,0.10277777777777777
3705-2021_03_20_193415.jpg,car,32,608,640,23,360,136,1,640,159,LTAdatasets/3705/annotate/3705-2021_03_20_193415.jpg,624.0,147.5,0.975,0.4097222222222222,0.05,0.06388888888888888
3705-2021_03_20_081920.jpg,lorry_truck,76,161,640,75,360,90,2,237,165,LTAdatasets/3705/annotate/3705-2021_03_20_081920.jpg,199.0,127.5,0.3109375,0.3541666666666667,0.11875,0.20833333333333334
3705-2021_03_20_081920.jpg,lorry_truck,36,604,640,29,360,131,2,640,160,LTAdatasets/3705/annotate/3705-2021_03_20_081920.jpg,622.0,145.5,0.971875,0.4041666666666667,0.05625,0.08055555555555556
3705-2021_03_20_081920.jpg,lorry_truck,28,168,640,30,360,45,2,196,75,LTAdatasets/3705/annotate/3705-2021_03_20_081920.jpg,182.0,60.0,0.284375,0.16666666666666666,0.04375,0.08333333333333333
3705-2021_03_20_194916.jpg,car,30,398,640,18,360,76,1,428,94,LTAdatasets/3705/annotate/3705-2021_03_20_194916.jpg,413.0,85.0,0.6453125,0.2361111111111111,0.046875,0.05
3705-2021_03_20_194916.jpg,car,26,433,640,17,360,90,1,459,107,LTAdatasets/3705/annotate/3705-2021_03_20_194916.jpg,446.0,98.5,0.696875,0.27361111111111114,0.040625,0.04722222222222222
3705-2021_03_20_084301.jpg,car,73,318,640,41,360,121,1,391,162,LTAdatasets/3705/annotate/3705-2021_03_20_084301.jpg,354.5,141.5,0.55390625,0.39305555555555555,0.1140625,0.11388888888888889
3705-2021_03_20_084301.jpg,car,18,212,640,15,360,64,1,230,79,LTAdatasets/3705/annotate/3705-2021_03_20_084301.jpg,221.0,71.5,0.3453125,0.1986111111111111,0.028125,0.041666666666666664
3705-2021_03_20_180710.jpg,car,24,159,640,24,360,97,1,183,121,LTAdatasets/3705/annotate/3705-2021_03_20_180710.jpg,171.0,109.0,0.2671875,0.30277777777777776,0.0375,0.06666666666666667
3705-2021_03_20_180710.jpg,car,19,174,640,12,360,65,1,193,77,LTAdatasets/3705/annotate/3705-2021_03_20_180710.jpg,183.5,71.0,0.28671875,0.19722222222222222,0.0296875,0.03333333333333333
3705-2021_03_20_073717.jpg,car,31,426,640,25,360,76,1,457,101,LTAdatasets/3705/annotate/3705-2021_03_20_073717.jpg,441.5,88.5,0.68984375,0.24583333333333332,0.0484375,0.06944444444444445
3705-2021_03_20_100105.jpg,car,14,193,640,14,360,56,1,207,70,LTAdatasets/3705/annotate/3705-2021_03_20_100105.jpg,200.0,63.0,0.3125,0.175,0.021875,0.03888888888888889
3705-2021_03_20_200116.jpg,car,25,436,640,15,360,79,1,461,94,LTAdatasets/3705/annotate/3705-2021_03_20_200116.jpg,448.5,86.5,0.70078125,0.24027777777777778,0.0390625,0.041666666666666664
3705-2021_03_20_185753.jpg,car,28,465,640,16,360,91,1,493,107,LTAdatasets/3705/annotate/3705-2021_03_20_185753.jpg,479.0,99.0,0.7484375,0.275,0.04375,0.044444444444444446
3705-2021_03_20_185753.jpg,van,31,224,640,22,360,69,3,255,91,LTAdatasets/3705/annotate/3705-2021_03_20_185753.jpg,239.5,80.0,0.37421875,0.2222222222222222,0.0484375,0.06111111111111111
3705-2021_03_20_090702.jpg,car,77,352,640,36,360,155,1,429,191,LTAdatasets/3705/annotate/3705-2021_03_20_090702.jpg,390.5,173.0,0.61015625,0.48055555555555557,0.1203125,0.1
3705-2021_03_20_090702.jpg,car,48,395,640,34,360,123,1,443,157,LTAdatasets/3705/annotate/3705-2021_03_20_090702.jpg,419.0,140.0,0.6546875,0.3888888888888889,0.075,0.09444444444444444
3705-2021_03_20_090702.jpg,lorry_truck,63,494,640,38,360,91,2,557,129,LTAdatasets/3705/annotate/3705-2021_03_20_090702.jpg,525.5,110.0,0.82109375,0.3055555555555556,0.0984375,0.10555555555555556
3705-2021_03_20_090702.jpg,lorry_truck,47,424,640,32,360,70,2,471,102,LTAdatasets/3705/annotate/3705-2021_03_20_090702.jpg,447.5,86.0,0.69921875,0.2388888888888889,0.0734375,0.08888888888888889
3705-2021_03_20_203358.jpg,bus,77,211,640,74,360,69,5,288,143,LTAdatasets/3705/annotate/3705-2021_03_20_203358.jpg,249.5,106.0,0.38984375,0.29444444444444445,0.1203125,0.20555555555555555
3705-2021_03_20_203358.jpg,car,41,544,640,20,360,125,1,585,145,LTAdatasets/3705/annotate/3705-2021_03_20_203358.jpg,564.5,135.0,0.88203125,0.375,0.0640625,0.05555555555555555
3705-2021_03_20_203358.jpg,car,21,387,640,18,360,70,1,408,88,LTAdatasets/3705/annotate/3705-2021_03_20_203358.jpg,397.5,79.0,0.62109375,0.21944444444444444,0.0328125,0.05
3705-2021_03_20_190413.jpg,bus,79,476,640,30,360,84,5,555,114,LTAdatasets/3705/annotate/3705-2021_03_20_190413.jpg,515.5,99.0,0.80546875,0.275,0.1234375,0.08333333333333333
3705-2021_03_20_202437.jpg,car,47,569,640,25,360,127,1,616,152,LTAdatasets/3705/annotate/3705-2021_03_20_202437.jpg,592.5,139.5,0.92578125,0.3875,0.0734375,0.06944444444444445
3705-2021_03_20_093724.jpg,car,82,482,640,49,360,174,1,564,223,LTAdatasets/3705/annotate/3705-2021_03_20_093724.jpg,523.0,198.5,0.8171875,0.5513888888888889,0.128125,0.1361111111111111
3705-2021_03_20_093724.jpg,lorry_truck,78,165,640,83,360,91,2,243,174,LTAdatasets/3705/annotate/3705-2021_03_20_093724.jpg,204.0,132.5,0.31875,0.3680555555555556,0.121875,0.23055555555555557
3705-2021_03_20_081319.jpg,lorry_truck,32,466,640,17,360,94,2,498,111,LTAdatasets/3705/annotate/3705-2021_03_20_081319.jpg,482.0,102.5,0.753125,0.2847222222222222,0.05,0.04722222222222222
3705-2021_03_20_073417.jpg,lorry_truck,168,196,640,165,360,178,2,364,343,LTAdatasets/3705/annotate/3705-2021_03_20_073417.jpg,280.0,260.5,0.4375,0.7236111111111111,0.2625,0.4583333333333333
3705-2021_03_20_073417.jpg,car,32,264,640,20,360,93,1,296,113,LTAdatasets/3705/annotate/3705-2021_03_20_073417.jpg,280.0,103.0,0.4375,0.2861111111111111,0.05,0.05555555555555555
3705-2021_03_20_080119.jpg,lorry_truck,49,194,640,45,360,66,2,243,111,LTAdatasets/3705/annotate/3705-2021_03_20_080119.jpg,218.5,88.5,0.34140625,0.24583333333333332,0.0765625,0.125
3705-2021_03_20_080119.jpg,car,15,188,640,11,360,55,1,203,66,LTAdatasets/3705/annotate/3705-2021_03_20_080119.jpg,195.5,60.5,0.30546875,0.16805555555555557,0.0234375,0.030555555555555555
3705-2021_03_20_080939.jpg,lorry_truck,138,208,640,158,360,161,2,346,319,LTAdatasets/3705/annotate/3705-2021_03_20_080939.jpg,277.0,240.0,0.4328125,0.6666666666666666,0.215625,0.4388888888888889
3705-2021_03_20_080939.jpg,car,37,534,640,25,360,115,1,571,140,LTAdatasets/3705/annotate/3705-2021_03_20_080939.jpg,552.5,127.5,0.86328125,0.3541666666666667,0.0578125,0.06944444444444445
3705-2021_03_20_080939.jpg,lorry_truck,31,136,640,33,360,61,2,167,94,LTAdatasets/3705/annotate/3705-2021_03_20_080939.jpg,151.5,77.5,0.23671875,0.2152777777777778,0.0484375,0.09166666666666666
3705-2021_03_20_192515.jpg,car,37,462,640,18,360,96,1,499,114,LTAdatasets/3705/annotate/3705-2021_03_20_192515.jpg,480.5,105.0,0.75078125,0.2916666666666667,0.0578125,0.05
3705-2021_03_20_192515.jpg,car,17,221,640,18,360,68,1,238,86,LTAdatasets/3705/annotate/3705-2021_03_20_192515.jpg,229.5,77.0,0.35859375,0.21388888888888888,0.0265625,0.05
3705-2021_03_20_184913.jpg,car,70,372,640,56,360,151,1,442,207,LTAdatasets/3705/annotate/3705-2021_03_20_184913.jpg,407.0,179.0,0.6359375,0.49722222222222223,0.109375,0.15555555555555556
3705-2021_03_20_184913.jpg,car,83,456,640,48,360,160,1,539,208,LTAdatasets/3705/annotate/3705-2021_03_20_184913.jpg,497.5,184.0,0.77734375,0.5111111111111111,0.1296875,0.13333333333333333
3705-2021_03_20_184913.jpg,car,46,537,640,24,360,125,1,583,149,LTAdatasets/3705/annotate/3705-2021_03_20_184913.jpg,560.0,137.0,0.875,0.38055555555555554,0.071875,0.06666666666666667
3705-2021_03_20_184913.jpg,car,38,284,640,25,360,89,1,322,114,LTAdatasets/3705/annotate/3705-2021_03_20_184913.jpg,303.0,101.5,0.4734375,0.28194444444444444,0.059375,0.06944444444444445
3705-2021_03_20_083640.jpg,lorry_truck,48,180,640,52,360,41,2,228,93,LTAdatasets/3705/annotate/3705-2021_03_20_083640.jpg,204.0,67.0,0.31875,0.18611111111111112,0.075,0.14444444444444443
3705-2021_03_20_083640.jpg,lorry_truck,22,136,640,25,360,58,2,158,83,LTAdatasets/3705/annotate/3705-2021_03_20_083640.jpg,147.0,70.5,0.2296875,0.19583333333333333,0.034375,0.06944444444444445
3705-2021_03_20_093103.jpg,lorry_truck,22,132,640,22,360,71,2,154,93,LTAdatasets/3705/annotate/3705-2021_03_20_093103.jpg,143.0,82.0,0.2234375,0.22777777777777777,0.034375,0.06111111111111111
3705-2021_03_20_191614.jpg,car,66,355,640,51,360,135,1,421,186,LTAdatasets/3705/annotate/3705-2021_03_20_191614.jpg,388.0,160.5,0.60625,0.44583333333333336,0.103125,0.14166666666666666
3705-2021_03_20_191614.jpg,lorry_truck,48,426,640,35,360,69,2,474,104,LTAdatasets/3705/annotate/3705-2021_03_20_191614.jpg,450.0,86.5,0.703125,0.24027777777777778,0.075,0.09722222222222222
3705-2021_03_20_191614.jpg,bus,20,161,640,19,360,44,5,181,63,LTAdatasets/3705/annotate/3705-2021_03_20_191614.jpg,171.0,53.5,0.2671875,0.1486111111111111,0.03125,0.05277777777777778
3705-2021_03_20_073937.jpg,bike,22,185,640,38,360,129,4,207,167,LTAdatasets/3705/annotate/3705-2021_03_20_073937.jpg,196.0,148.0,0.30625,0.4111111111111111,0.034375,0.10555555555555556
3705-2021_03_20_073937.jpg,lorry_truck,79,393,640,26,360,65,2,472,91,LTAdatasets/3705/annotate/3705-2021_03_20_073937.jpg,432.5,78.0,0.67578125,0.21666666666666667,0.1234375,0.07222222222222222
3705-2021_03_20_073937.jpg,car,18,197,640,11,360,61,1,215,72,LTAdatasets/3705/annotate/3705-2021_03_20_073937.jpg,206.0,66.5,0.321875,0.18472222222222223,0.028125,0.030555555555555555
3705-2021_03_20_085141.jpg,lorry_truck,23,137,640,25,360,72,2,160,97,LTAdatasets/3705/annotate/3705-2021_03_20_085141.jpg,148.5,84.5,0.23203125,0.23472222222222222,0.0359375,0.06944444444444445
3705-2021_03_20_085141.jpg,lorry_truck,16,123,640,18,360,57,2,139,75,LTAdatasets/3705/annotate/3705-2021_03_20_085141.jpg,131.0,66.0,0.2046875,0.18333333333333332,0.025,0.05
3705-2021_03_20_183712.jpg,van,25,191,640,16,360,75,3,216,91,LTAdatasets/3705/annotate/3705-2021_03_20_183712.jpg,203.5,83.0,0.31796875,0.23055555555555557,0.0390625,0.044444444444444446
3705-2021_03_20_183712.jpg,car,9,189,640,8,360,55,1,198,63,LTAdatasets/3705/annotate/3705-2021_03_20_183712.jpg,193.5,59.0,0.30234375,0.1638888888888889,0.0140625,0.022222222222222223
3705-2021_03_20_085822.jpg,lorry_truck,54,151,640,56,360,74,2,205,130,LTAdatasets/3705/annotate/3705-2021_03_20_085822.jpg,178.0,102.0,0.278125,0.2833333333333333,0.084375,0.15555555555555556
3705-2021_03_20_085822.jpg,lorry_truck,23,126,640,31,360,54,2,149,85,LTAdatasets/3705/annotate/3705-2021_03_20_085822.jpg,137.5,69.5,0.21484375,0.19305555555555556,0.0359375,0.08611111111111111
3705-2021_03_20_073037.jpg,car,22,135,640,13,360,70,1,157,83,LTAdatasets/3705/annotate/3705-2021_03_20_073037.jpg,146.0,76.5,0.228125,0.2125,0.034375,0.03611111111111111
3705-2021_03_20_182752.jpg,car,29,408,640,15,360,79,1,437,94,LTAdatasets/3705/annotate/3705-2021_03_20_182752.jpg,422.5,86.5,0.66015625,0.24027777777777778,0.0453125,0.041666666666666664
3705-2021_03_20_181851.jpg,car,82,489,640,60,360,165,1,571,225,LTAdatasets/3705/annotate/3705-2021_03_20_181851.jpg,530.0,195.0,0.828125,0.5416666666666666,0.128125,0.16666666666666666
3705-2021_03_20_181851.jpg,car,62,578,640,78,360,269,1,640,347,LTAdatasets/3705/annotate/3705-2021_03_20_181851.jpg,609.0,308.0,0.9515625,0.8555555555555555,0.096875,0.21666666666666667
3705-2021_03_20_181851.jpg,car,26,384,640,16,360,75,1,410,91,LTAdatasets/3705/annotate/3705-2021_03_20_181851.jpg,397.0,83.0,0.6203125,0.23055555555555557,0.040625,0.044444444444444446
3705-2021_03_20_181851.jpg,lorry_truck,44,447,640,22,360,84,2,491,106,LTAdatasets/3705/annotate/3705-2021_03_20_181851.jpg,469.0,95.0,0.7328125,0.2638888888888889,0.06875,0.06111111111111111
3705-2021_03_20_181851.jpg,lorry_truck,43,597,640,48,360,121,2,640,169,LTAdatasets/3705/annotate/3705-2021_03_20_181851.jpg,618.5,145.0,0.96640625,0.4027777777777778,0.0671875,0.13333333333333333
3705-2021_03_20_181851.jpg,bike,12,191,640,16,360,58,4,203,74,LTAdatasets/3705/annotate/3705-2021_03_20_181851.jpg,197.0,66.0,0.3078125,0.18333333333333332,0.01875,0.044444444444444446
3705-2021_03_20_195736.jpg,car,29,164,640,28,360,105,1,193,133,LTAdatasets/3705/annotate/3705-2021_03_20_195736.jpg,178.5,119.0,0.27890625,0.33055555555555555,0.0453125,0.07777777777777778
3705-2021_03_20_195736.jpg,lorry_truck,20,126,640,19,360,58,2,146,77,LTAdatasets/3705/annotate/3705-2021_03_20_195736.jpg,136.0,67.5,0.2125,0.1875,0.03125,0.05277777777777778
3705-2021_03_20_195736.jpg,lorry_truck,45,417,640,33,360,68,2,462,101,LTAdatasets/3705/annotate/3705-2021_03_20_195736.jpg,439.5,84.5,0.68671875,0.23472222222222222,0.0703125,0.09166666666666666
3705-2021_03_20_191914.jpg,car,18,206,640,9,360,66,1,224,75,LTAdatasets/3705/annotate/3705-2021_03_20_191914.jpg,215.0,70.5,0.3359375,0.19583333333333333,0.028125,0.025
3705-2021_03_20_185453.jpg,car,35,296,640,24,360,88,1,331,112,LTAdatasets/3705/annotate/3705-2021_03_20_185453.jpg,313.5,100.0,0.48984375,0.2777777777777778,0.0546875,0.06666666666666667
3705-2021_03_20_185453.jpg,car,25,217,640,13,360,74,1,242,87,LTAdatasets/3705/annotate/3705-2021_03_20_185453.jpg,229.5,80.5,0.35859375,0.22361111111111112,0.0390625,0.03611111111111111
3705-2021_03_20_185453.jpg,car,37,492,640,21,360,109,1,529,130,LTAdatasets/3705/annotate/3705-2021_03_20_185453.jpg,510.5,119.5,0.79765625,0.33194444444444443,0.0578125,0.058333333333333334
3705-2021_03_20_185453.jpg,car,23,455,640,17,360,81,1,478,98,LTAdatasets/3705/annotate/3705-2021_03_20_185453.jpg,466.5,89.5,0.72890625,0.24861111111111112,0.0359375,0.04722222222222222
3705-2021_03_20_185453.jpg,lorry_truck,58,157,640,61,360,78,2,215,139,LTAdatasets/3705/annotate/3705-2021_03_20_185453.jpg,186.0,108.5,0.290625,0.3013888888888889,0.090625,0.16944444444444445
3705-2021_03_20_185453.jpg,lorry_truck,19,177,640,19,360,57,2,196,76,LTAdatasets/3705/annotate/3705-2021_03_20_185453.jpg,186.5,66.5,0.29140625,0.18472222222222223,0.0296875,0.05277777777777778
3705-2021_03_20_185453.jpg,bike,10,484,640,14,360,96,4,494,110,LTAdatasets/3705/annotate/3705-2021_03_20_185453.jpg,489.0,103.0,0.7640625,0.2861111111111111,0.015625,0.03888888888888889
3705-2021_03_20_201317.jpg,car,56,320,640,39,360,116,1,376,155,LTAdatasets/3705/annotate/3705-2021_03_20_201317.jpg,348.0,135.5,0.54375,0.3763888888888889,0.0875,0.10833333333333334
3705-2021_03_20_201317.jpg,lorry_truck,37,144,640,39,360,67,2,181,106,LTAdatasets/3705/annotate/3705-2021_03_20_201317.jpg,162.5,86.5,0.25390625,0.24027777777777778,0.0578125,0.10833333333333334
3705-2021_03_20_201317.jpg,van,22,195,640,19,360,72,3,217,91,LTAdatasets/3705/annotate/3705-2021_03_20_201317.jpg,206.0,81.5,0.321875,0.2263888888888889,0.034375,0.05277777777777778
3705-2021_03_20_193115.jpg,lorry_truck,197,428,640,152,360,208,2,625,360,LTAdatasets/3705/annotate/3705-2021_03_20_193115.jpg,526.5,284.0,0.82265625,0.7888888888888889,0.3078125,0.4222222222222222
3705-2021_03_20_193115.jpg,lorry_truck,39,430,640,29,360,74,2,469,103,LTAdatasets/3705/annotate/3705-2021_03_20_193115.jpg,449.5,88.5,0.70234375,0.24583333333333332,0.0609375,0.08055555555555556
3705-2021_03_20_191014.jpg,car,49,591,640,19,360,136,1,640,155,LTAdatasets/3705/annotate/3705-2021_03_20_191014.jpg,615.5,145.5,0.96171875,0.4041666666666667,0.0765625,0.05277777777777778
3705-2021_03_20_191014.jpg,car,33,467,640,18,360,101,1,500,119,LTAdatasets/3705/annotate/3705-2021_03_20_191014.jpg,483.5,110.0,0.75546875,0.3055555555555556,0.0515625,0.05
3705-2021_03_20_200416.jpg,car,49,290,640,34,360,102,1,339,136,LTAdatasets/3705/annotate/3705-2021_03_20_200416.jpg,314.5,119.0,0.49140625,0.33055555555555555,0.0765625,0.09444444444444444
3705-2021_03_20_094605.jpg,lorry_truck,37,237,640,28,360,74,2,274,102,LTAdatasets/3705/annotate/3705-2021_03_20_094605.jpg,255.5,88.0,0.39921875,0.24444444444444444,0.0578125,0.07777777777777778
3705-2021_03_20_094904.jpg,lorry_truck,48,144,640,52,360,67,2,192,119,LTAdatasets/3705/annotate/3705-2021_03_20_094904.jpg,168.0,93.0,0.2625,0.25833333333333336,0.075,0.14444444444444443
3705-2021_03_20_094904.jpg,lorry_truck,49,452,640,28,360,83,2,501,111,LTAdatasets/3705/annotate/3705-2021_03_20_094904.jpg,476.5,97.0,0.74453125,0.26944444444444443,0.0765625,0.07777777777777778
3705-2021_03_20_180410.jpg,lorry_truck,47,460,640,32,360,82,2,507,114,LTAdatasets/3705/annotate/3705-2021_03_20_180410.jpg,483.5,98.0,0.75546875,0.2722222222222222,0.0734375,0.08888888888888889
3705-2021_03_20_180410.jpg,car,55,377,640,34,360,131,1,432,165,LTAdatasets/3705/annotate/3705-2021_03_20_180410.jpg,404.5,148.0,0.63203125,0.4111111111111111,0.0859375,0.09444444444444444
3705-2021_03_20_180410.jpg,van,41,219,640,31,360,96,3,260,127,LTAdatasets/3705/annotate/3705-2021_03_20_180410.jpg,239.5,111.5,0.37421875,0.30972222222222223,0.0640625,0.08611111111111111
3705-2021_03_20_085501.jpg,lorry_truck,54,168,640,32,360,118,2,222,150,LTAdatasets/3705/annotate/3705-2021_03_20_085501.jpg,195.0,134.0,0.3046875,0.37222222222222223,0.084375,0.08888888888888889
3705-2021_03_20_085501.jpg,lorry_truck,42,399,640,24,360,67,2,441,91,LTAdatasets/3705/annotate/3705-2021_03_20_085501.jpg,420.0,79.0,0.65625,0.21944444444444444,0.065625,0.06666666666666667
3705-2021_03_20_085501.jpg,car,23,245,640,10,360,74,1,268,84,LTAdatasets/3705/annotate/3705-2021_03_20_085501.jpg,256.5,79.0,0.40078125,0.21944444444444444,0.0359375,0.027777777777777776
3705-2021_03_20_084901.jpg,lorry_truck,41,599,640,26,360,124,2,640,150,LTAdatasets/3705/annotate/3705-2021_03_20_084901.jpg,619.5,137.0,0.96796875,0.38055555555555554,0.0640625,0.07222222222222222
3705-2021_03_20_084901.jpg,lorry_truck,19,186,640,25,360,63,2,205,88,LTAdatasets/3705/annotate/3705-2021_03_20_084901.jpg,195.5,75.5,0.30546875,0.20972222222222223,0.0296875,0.06944444444444445
3705-2021_03_20_084901.jpg,car,38,270,640,21,360,98,1,308,119,LTAdatasets/3705/annotate/3705-2021_03_20_084901.jpg,289.0,108.5,0.4515625,0.3013888888888889,0.059375,0.058333333333333334
3705-2021_03_20_084901.jpg,car,24,242,640,11,360,71,1,266,82,LTAdatasets/3705/annotate/3705-2021_03_20_084901.jpg,254.0,76.5,0.396875,0.2125,0.0375,0.030555555555555555
3705-2021_03_20_183952.jpg,car,34,353,640,28,360,114,1,387,142,LTAdatasets/3705/annotate/3705-2021_03_20_183952.jpg,370.0,128.0,0.578125,0.35555555555555557,0.053125,0.07777777777777778
3705-2021_03_20_183952.jpg,car,25,392,640,15,360,74,1,417,89,LTAdatasets/3705/annotate/3705-2021_03_20_183952.jpg,404.5,81.5,0.63203125,0.2263888888888889,0.0390625,0.041666666666666664
3705-2021_03_20_183952.jpg,lorry_truck,36,142,640,38,360,66,2,178,104,LTAdatasets/3705/annotate/3705-2021_03_20_183952.jpg,160.0,85.0,0.25,0.2361111111111111,0.05625,0.10555555555555556
3705-2021_03_20_194616.jpg,car,28,231,640,15,360,65,1,259,80,LTAdatasets/3705/annotate/3705-2021_03_20_194616.jpg,245.0,72.5,0.3828125,0.2013888888888889,0.04375,0.041666666666666664
3705-2021_03_20_193935.jpg,lorry_truck,123,345,640,94,360,174,2,468,268,LTAdatasets/3705/annotate/3705-2021_03_20_193935.jpg,406.5,221.0,0.63515625,0.6138888888888889,0.1921875,0.2611111111111111
3705-2021_03_20_193935.jpg,lorry_truck,69,539,640,45,360,99,2,608,144,LTAdatasets/3705/annotate/3705-2021_03_20_193935.jpg,573.5,121.5,0.89609375,0.3375,0.1078125,0.125
3705-2021_03_20_193935.jpg,lorry_truck,74,165,640,75,360,88,2,239,163,LTAdatasets/3705/annotate/3705-2021_03_20_193935.jpg,202.0,125.5,0.315625,0.3486111111111111,0.115625,0.20833333333333334
3705-2021_03_20_193935.jpg,van,30,449,640,22,360,84,3,479,106,LTAdatasets/3705/annotate/3705-2021_03_20_193935.jpg,464.0,95.0,0.725,0.2638888888888889,0.046875,0.06111111111111111
3705-2021_03_20_193935.jpg,van,30,393,640,19,360,72,3,423,91,LTAdatasets/3705/annotate/3705-2021_03_20_193935.jpg,408.0,81.5,0.6375,0.2263888888888889,0.046875,0.05277777777777778
3705-2021_03_20_193935.jpg,car,26,228,640,11,360,74,1,254,85,LTAdatasets/3705/annotate/3705-2021_03_20_193935.jpg,241.0,79.5,0.3765625,0.22083333333333333,0.040625,0.030555555555555555
3705-2021_03_20_084001.jpg,car,23,209,640,14,360,71,1,232,85,LTAdatasets/3705/annotate/3705-2021_03_20_084001.jpg,220.5,78.0,0.34453125,0.21666666666666667,0.0359375,0.03888888888888889
3705-2021_03_20_091903.jpg,lorry_truck,64,488,640,39,360,86,2,552,125,LTAdatasets/3705/annotate/3705-2021_03_20_091903.jpg,520.0,105.5,0.8125,0.29305555555555557,0.1,0.10833333333333334
3705-2021_03_20_091903.jpg,lorry_truck,63,155,640,75,360,88,2,218,163,LTAdatasets/3705/annotate/3705-2021_03_20_091903.jpg,186.5,125.5,0.29140625,0.3486111111111111,0.0984375,0.20833333333333334
3705-2021_03_20_091903.jpg,lorry_truck,22,126,640,23,360,54,2,148,77,LTAdatasets/3705/annotate/3705-2021_03_20_091903.jpg,137.0,65.5,0.2140625,0.18194444444444444,0.034375,0.06388888888888888
3705-2021_03_20_192214.jpg,car,40,171,640,32,360,118,1,211,150,LTAdatasets/3705/annotate/3705-2021_03_20_192214.jpg,191.0,134.0,0.2984375,0.37222222222222223,0.0625,0.08888888888888889
3705-2021_03_20_192214.jpg,van,26,458,640,22,360,84,3,484,106,LTAdatasets/3705/annotate/3705-2021_03_20_192214.jpg,471.0,95.0,0.7359375,0.2638888888888889,0.040625,0.06111111111111111
3705-2021_03_20_093424.jpg,car,20,228,640,21,360,70,1,248,91,LTAdatasets/3705/annotate/3705-2021_03_20_093424.jpg,238.0,80.5,0.371875,0.22361111111111112,0.03125,0.058333333333333334
3705-2021_03_20_093424.jpg,lorry_truck,23,174,640,24,360,51,2,197,75,LTAdatasets/3705/annotate/3705-2021_03_20_093424.jpg,185.5,63.0,0.28984375,0.175,0.0359375,0.06666666666666667
3705-2021_03_20_094024.jpg,car,21,235,640,15,360,63,1,256,78,LTAdatasets/3705/annotate/3705-2021_03_20_094024.jpg,245.5,70.5,0.38359375,0.19583333333333333,0.0328125,0.041666666666666664
3705-2021_03_20_182451.jpg,car,21,209,640,18,360,63,1,230,81,LTAdatasets/3705/annotate/3705-2021_03_20_182451.jpg,219.5,72.0,0.34296875,0.2,0.0328125,0.05
3705-2021_03_20_182451.jpg,car,31,598,640,25,360,131,1,629,156,LTAdatasets/3705/annotate/3705-2021_03_20_182451.jpg,613.5,143.5,0.95859375,0.39861111111111114,0.0484375,0.06944444444444445
3705-2021_03_20_182451.jpg,car,24,501,640,18,360,111,1,525,129,LTAdatasets/3705/annotate/3705-2021_03_20_182451.jpg,513.0,120.0,0.8015625,0.3333333333333333,0.0375,0.05
3705-2021_03_20_182451.jpg,car,46,594,640,71,360,289,1,640,360,LTAdatasets/3705/annotate/3705-2021_03_20_182451.jpg,617.0,324.5,0.9640625,0.9013888888888889,0.071875,0.19722222222222222
3705-2021_03_20_074618.jpg,car,22,127,640,11,360,71,1,149,82,LTAdatasets/3705/annotate/3705-2021_03_20_074618.jpg,138.0,76.5,0.215625,0.2125,0.034375,0.030555555555555555
3705-2021_03_20_074318.jpg,lorry_truck,47,149,640,44,360,69,2,196,113,LTAdatasets/3705/annotate/3705-2021_03_20_074318.jpg,172.5,91.0,0.26953125,0.25277777777777777,0.0734375,0.12222222222222222
3705-2021_03_20_201617.jpg,bus,62,401,640,33,360,69,5,463,102,LTAdatasets/3705/annotate/3705-2021_03_20_201617.jpg,432.0,85.5,0.675,0.2375,0.096875,0.09166666666666666
3705-2021_03_20_082440.jpg,van,113,236,640,106,360,215,3,349,321,LTAdatasets/3705/annotate/3705-2021_03_20_082440.jpg,292.5,268.0,0.45703125,0.7444444444444445,0.1765625,0.29444444444444445
3705-2021_03_20_082440.jpg,lorry_truck,34,445,640,17,360,90,2,479,107,LTAdatasets/3705/annotate/3705-2021_03_20_082440.jpg,462.0,98.5,0.721875,0.27361111111111114,0.053125,0.04722222222222222
3705-2021_03_20_082440.jpg,lorry_truck,37,385,640,26,360,63,2,422,89,LTAdatasets/3705/annotate/3705-2021_03_20_082440.jpg,403.5,76.0,0.63046875,0.2111111111111111,0.0578125,0.07222222222222222
1003-2021_03_20_095205.jpg,van,29,153,320,29,240,153,3,182,182,LTAdatasets/1003/annotate/1003-2021_03_20_095205.jpg,167.5,167.5,0.5234375,0.6979166666666666,0.090625,0.12083333333333333
1003-2021_03_20_095205.jpg,car,15,165,320,15,240,134,1,180,149,LTAdatasets/1003/annotate/1003-2021_03_20_095205.jpg,172.5,141.5,0.5390625,0.5895833333333333,0.046875,0.0625
1003-2021_03_20_095205.jpg,car,14,131,320,15,240,122,1,145,137,LTAdatasets/1003/annotate/1003-2021_03_20_095205.jpg,138.0,129.5,0.43125,0.5395833333333333,0.04375,0.0625
1003-2021_03_20_095205.jpg,car,17,149,320,16,240,119,1,166,135,LTAdatasets/1003/annotate/1003-2021_03_20_095205.jpg,157.5,127.0,0.4921875,0.5291666666666667,0.053125,0.06666666666666667
1003-2021_03_20_095205.jpg,car,13,136,320,13,240,109,1,149,122,LTAdatasets/1003/annotate/1003-2021_03_20_095205.jpg,142.5,115.5,0.4453125,0.48125,0.040625,0.05416666666666667
1003-2021_03_20_095205.jpg,car,9,130,320,9,240,104,1,139,113,LTAdatasets/1003/annotate/1003-2021_03_20_095205.jpg,134.5,108.5,0.4203125,0.45208333333333334,0.028125,0.0375
1003-2021_03_20_095205.jpg,car,16,180,320,12,240,109,1,196,121,LTAdatasets/1003/annotate/1003-2021_03_20_095205.jpg,188.0,115.0,0.5875,0.4791666666666667,0.05,0.05
1003-2021_03_20_095205.jpg,lorry_truck,19,218,320,14,240,111,2,237,125,LTAdatasets/1003/annotate/1003-2021_03_20_095205.jpg,227.5,118.0,0.7109375,0.49166666666666664,0.059375,0.058333333333333334
1003-2021_03_20_095205.jpg,bus,46,185,320,39,240,134,5,231,173,LTAdatasets/1003/annotate/1003-2021_03_20_095205.jpg,208.0,153.5,0.65,0.6395833333333333,0.14375,0.1625
1003-2021_03_20_095205.jpg,lorry_truck,16,171,320,12,240,91,2,187,103,LTAdatasets/1003/annotate/1003-2021_03_20_095205.jpg,179.0,97.0,0.559375,0.4041666666666667,0.05,0.05
1003-2021_03_20_095205.jpg,car,12,207,320,9,240,97,1,219,106,LTAdatasets/1003/annotate/1003-2021_03_20_095205.jpg,213.0,101.5,0.665625,0.42291666666666666,0.0375,0.0375
1003-2021_03_20_095205.jpg,car,18,270,320,14,240,102,1,288,116,LTAdatasets/1003/annotate/1003-2021_03_20_095205.jpg,279.0,109.0,0.871875,0.45416666666666666,0.05625,0.058333333333333334
1003-2021_03_20_095205.jpg,car,11,284,320,13,240,96,1,295,109,LTAdatasets/1003/annotate/1003-2021_03_20_095205.jpg,289.5,102.5,0.9046875,0.4270833333333333,0.034375,0.05416666666666667
1003-2021_03_20_095205.jpg,car,8,125,320,8,240,96,1,133,104,LTAdatasets/1003/annotate/1003-2021_03_20_095205.jpg,129.0,100.0,0.403125,0.4166666666666667,0.025,0.03333333333333333
1003-2021_03_20_182151.jpg,lorry_truck,13,174,320,10,240,91,2,187,101,LTAdatasets/1003/annotate/1003-2021_03_20_182151.jpg,180.5,96.0,0.5640625,0.4,0.040625,0.041666666666666664
1003-2021_03_20_182151.jpg,lorry_truck,28,232,320,24,240,109,2,260,133,LTAdatasets/1003/annotate/1003-2021_03_20_182151.jpg,246.0,121.0,0.76875,0.5041666666666667,0.0875,0.1
1003-2021_03_20_182151.jpg,car,11,210,320,9,240,103,1,221,112,LTAdatasets/1003/annotate/1003-2021_03_20_182151.jpg,215.5,107.5,0.6734375,0.4479166666666667,0.034375,0.0375
1003-2021_03_20_182151.jpg,van,12,189,320,9,240,108,3,201,117,LTAdatasets/1003/annotate/1003-2021_03_20_182151.jpg,195.0,112.5,0.609375,0.46875,0.0375,0.0375
1003-2021_03_20_182151.jpg,car,18,141,320,18,240,112,1,159,130,LTAdatasets/1003/annotate/1003-2021_03_20_182151.jpg,150.0,121.0,0.46875,0.5041666666666667,0.05625,0.075
1003-2021_03_20_182151.jpg,car,11,131,320,9,240,102,1,142,111,LTAdatasets/1003/annotate/1003-2021_03_20_182151.jpg,136.5,106.5,0.4265625,0.44375,0.034375,0.0375
1003-2021_03_20_182151.jpg,car,25,183,320,27,240,182,1,208,209,LTAdatasets/1003/annotate/1003-2021_03_20_182151.jpg,195.5,195.5,0.6109375,0.8145833333333333,0.078125,0.1125
1003-2021_03_20_182151.jpg,car,7,125,320,7,240,96,1,132,103,LTAdatasets/1003/annotate/1003-2021_03_20_182151.jpg,128.5,99.5,0.4015625,0.41458333333333336,0.021875,0.029166666666666667
1003-2021_03_20_182151.jpg,car,10,264,320,12,240,97,1,274,109,LTAdatasets/1003/annotate/1003-2021_03_20_182151.jpg,269.0,103.0,0.840625,0.42916666666666664,0.03125,0.05
1003-2021_03_20_182151.jpg,car,7,275,320,7,240,96,1,282,103,LTAdatasets/1003/annotate/1003-2021_03_20_182151.jpg,278.5,99.5,0.8703125,0.41458333333333336,0.021875,0.029166666666666667
1003-2021_03_20_182151.jpg,car,12,283,320,7,240,95,1,295,102,LTAdatasets/1003/annotate/1003-2021_03_20_182151.jpg,289.0,98.5,0.903125,0.41041666666666665,0.0375,0.029166666666666667
1003-2021_03_20_182151.jpg,car,7,254,320,8,240,91,1,261,99,LTAdatasets/1003/annotate/1003-2021_03_20_182151.jpg,257.5,95.0,0.8046875,0.3958333333333333,0.021875,0.03333333333333333
1003-2021_03_20_062153.jpg,car,26,168,320,26,240,157,1,194,183,LTAdatasets/1003/annotate/1003-2021_03_20_062153.jpg,181.0,170.0,0.565625,0.7083333333333334,0.08125,0.10833333333333334
1003-2021_03_20_062153.jpg,lorry_truck,12,12,320,13,240,102,2,24,115,LTAdatasets/1003/annotate/1003-2021_03_20_062153.jpg,18.0,108.5,0.05625,0.45208333333333334,0.0375,0.05416666666666667
1003-2021_03_20_193635.jpg,car,22,223,320,24,240,175,1,245,199,LTAdatasets/1003/annotate/1003-2021_03_20_193635.jpg,234.0,187.0,0.73125,0.7791666666666667,0.06875,0.1
1003-2021_03_20_193635.jpg,car,14,189,320,11,240,109,1,203,120,LTAdatasets/1003/annotate/1003-2021_03_20_193635.jpg,196.0,114.5,0.6125,0.47708333333333336,0.04375,0.04583333333333333
1003-2021_03_20_193635.jpg,bike,11,129,320,14,240,118,4,140,132,LTAdatasets/1003/annotate/1003-2021_03_20_193635.jpg,134.5,125.0,0.4203125,0.5208333333333334,0.034375,0.058333333333333334
1003-2021_03_20_193635.jpg,lorry_truck,13,133,320,12,240,103,2,146,115,LTAdatasets/1003/annotate/1003-2021_03_20_193635.jpg,139.5,109.0,0.4359375,0.45416666666666666,0.040625,0.05
1003-2021_03_20_193635.jpg,lorry_truck,9,175,320,10,240,89,2,184,99,LTAdatasets/1003/annotate/1003-2021_03_20_193635.jpg,179.5,94.0,0.5609375,0.39166666666666666,0.028125,0.041666666666666664
1003-2021_03_20_193635.jpg,lorry_truck,14,157,320,14,240,90,2,171,104,LTAdatasets/1003/annotate/1003-2021_03_20_193635.jpg,164.0,97.0,0.5125,0.4041666666666667,0.04375,0.058333333333333334
1003-2021_03_20_193635.jpg,car,27,192,320,9,240,197,1,219,206,LTAdatasets/1003/annotate/1003-2021_03_20_193635.jpg,205.5,201.5,0.6421875,0.8395833333333333,0.084375,0.0375
1003-2021_03_20_193635.jpg,car,9,307,320,7,240,99,1,316,106,LTAdatasets/1003/annotate/1003-2021_03_20_193635.jpg,311.5,102.5,0.9734375,0.4270833333333333,0.028125,0.029166666666666667
1003-2021_03_20_070716.jpg,van,22,246,320,15,240,104,3,268,119,LTAdatasets/1003/annotate/1003-2021_03_20_070716.jpg,257.0,111.5,0.803125,0.46458333333333335,0.06875,0.0625
1003-2021_03_20_070716.jpg,van,26,188,320,21,240,150,3,214,171,LTAdatasets/1003/annotate/1003-2021_03_20_070716.jpg,201.0,160.5,0.628125,0.66875,0.08125,0.0875
1003-2021_03_20_070716.jpg,car,15,212,320,10,240,109,1,227,119,LTAdatasets/1003/annotate/1003-2021_03_20_070716.jpg,219.5,114.0,0.6859375,0.475,0.046875,0.041666666666666664
1003-2021_03_20_070716.jpg,bike,6,226,320,11,240,122,4,232,133,LTAdatasets/1003/annotate/1003-2021_03_20_070716.jpg,229.0,127.5,0.715625,0.53125,0.01875,0.04583333333333333
1003-2021_03_20_070716.jpg,lorry_truck,36,131,320,34,240,121,2,167,155,LTAdatasets/1003/annotate/1003-2021_03_20_070716.jpg,149.0,138.0,0.465625,0.575,0.1125,0.14166666666666666
1003-2021_03_20_070716.jpg,car,10,288,320,10,240,94,1,298,104,LTAdatasets/1003/annotate/1003-2021_03_20_070716.jpg,293.0,99.0,0.915625,0.4125,0.03125,0.041666666666666664
1003-2021_03_20_070716.jpg,bus,21,257,320,14,240,88,5,278,102,LTAdatasets/1003/annotate/1003-2021_03_20_070716.jpg,267.5,95.0,0.8359375,0.3958333333333333,0.065625,0.058333333333333334
1003-2021_03_20_070716.jpg,bike,6,179,320,9,240,95,4,185,104,LTAdatasets/1003/annotate/1003-2021_03_20_070716.jpg,182.0,99.5,0.56875,0.41458333333333336,0.01875,0.0375
1003-2021_03_20_070716.jpg,car,14,201,320,7,240,93,1,215,100,LTAdatasets/1003/annotate/1003-2021_03_20_070716.jpg,208.0,96.5,0.65,0.40208333333333335,0.04375,0.029166666666666667
1003-2021_03_20_211300.jpg,car,34,234,320,9,240,194,1,268,203,LTAdatasets/1003/annotate/1003-2021_03_20_211300.jpg,251.0,198.5,0.784375,0.8270833333333333,0.10625,0.0375
1003-2021_03_20_211300.jpg,car,17,265,320,15,240,129,1,282,144,LTAdatasets/1003/annotate/1003-2021_03_20_211300.jpg,273.5,136.5,0.8546875,0.56875,0.053125,0.0625
1003-2021_03_20_211300.jpg,car,12,308,320,15,240,126,1,320,141,LTAdatasets/1003/annotate/1003-2021_03_20_211300.jpg,314.0,133.5,0.98125,0.55625,0.0375,0.0625
1003-2021_03_20_211300.jpg,car,19,286,320,11,240,103,1,305,114,LTAdatasets/1003/annotate/1003-2021_03_20_211300.jpg,295.5,108.5,0.9234375,0.45208333333333334,0.059375,0.04583333333333333
1003-2021_03_20_211300.jpg,car,8,312,320,9,240,102,1,320,111,LTAdatasets/1003/annotate/1003-2021_03_20_211300.jpg,316.0,106.5,0.9875,0.44375,0.025,0.0375
1003-2021_03_20_211300.jpg,car,18,222,320,14,240,99,1,240,113,LTAdatasets/1003/annotate/1003-2021_03_20_211300.jpg,231.0,106.0,0.721875,0.44166666666666665,0.05625,0.058333333333333334
1003-2021_03_20_211300.jpg,car,13,133,320,11,240,118,1,146,129,LTAdatasets/1003/annotate/1003-2021_03_20_211300.jpg,139.5,123.5,0.4359375,0.5145833333333333,0.040625,0.04583333333333333
1003-2021_03_20_211300.jpg,car,14,69,320,11,240,110,1,83,121,LTAdatasets/1003/annotate/1003-2021_03_20_211300.jpg,76.0,115.5,0.2375,0.48125,0.04375,0.04583333333333333
1003-2021_03_20_211300.jpg,car,11,172,320,6,240,88,1,183,94,LTAdatasets/1003/annotate/1003-2021_03_20_211300.jpg,177.5,91.0,0.5546875,0.37916666666666665,0.034375,0.025
1003-2021_03_20_211300.jpg,car,13,156,320,8,240,88,1,169,96,LTAdatasets/1003/annotate/1003-2021_03_20_211300.jpg,162.5,92.0,0.5078125,0.38333333333333336,0.040625,0.03333333333333333
1003-2021_03_20_220403.jpg,car,15,282,320,16,240,114,1,297,130,LTAdatasets/1003/annotate/1003-2021_03_20_220403.jpg,289.5,122.0,0.9046875,0.5083333333333333,0.046875,0.06666666666666667
1003-2021_03_20_220403.jpg,car,14,2,320,12,240,130,1,16,142,LTAdatasets/1003/annotate/1003-2021_03_20_220403.jpg,9.0,136.0,0.028125,0.5666666666666667,0.04375,0.05
1003-2021_03_20_082740.jpg,car,23,168,320,18,240,136,1,191,154,LTAdatasets/1003/annotate/1003-2021_03_20_082740.jpg,179.5,145.0,0.5609375,0.6041666666666666,0.071875,0.075
1003-2021_03_20_082740.jpg,lorry_truck,12,124,320,15,240,95,2,136,110,LTAdatasets/1003/annotate/1003-2021_03_20_082740.jpg,130.0,102.5,0.40625,0.4270833333333333,0.0375,0.0625
1003-2021_03_20_082740.jpg,bike,10,219,320,12,240,123,4,229,135,LTAdatasets/1003/annotate/1003-2021_03_20_082740.jpg,224.0,129.0,0.7,0.5375,0.03125,0.05
1003-2021_03_20_082740.jpg,car,20,260,320,10,240,123,1,280,133,LTAdatasets/1003/annotate/1003-2021_03_20_082740.jpg,270.0,128.0,0.84375,0.5333333333333333,0.0625,0.041666666666666664
1003-2021_03_20_082740.jpg,car,16,282,320,9,240,99,1,298,108,LTAdatasets/1003/annotate/1003-2021_03_20_082740.jpg,290.0,103.5,0.90625,0.43125,0.05,0.0375
1003-2021_03_20_082740.jpg,car,15,258,320,9,240,94,1,273,103,LTAdatasets/1003/annotate/1003-2021_03_20_082740.jpg,265.5,98.5,0.8296875,0.41041666666666665,0.046875,0.0375
1003-2021_03_20_093424.jpg,car,18,246,320,16,240,125,1,264,141,LTAdatasets/1003/annotate/1003-2021_03_20_093424.jpg,255.0,133.0,0.796875,0.5541666666666667,0.05625,0.06666666666666667
1003-2021_03_20_093424.jpg,car,13,307,320,15,240,130,1,320,145,LTAdatasets/1003/annotate/1003-2021_03_20_093424.jpg,313.5,137.5,0.9796875,0.5729166666666666,0.040625,0.0625
1003-2021_03_20_093424.jpg,lorry_truck,15,203,320,11,240,105,2,218,116,LTAdatasets/1003/annotate/1003-2021_03_20_093424.jpg,210.5,110.5,0.6578125,0.46041666666666664,0.046875,0.04583333333333333
1003-2021_03_20_093424.jpg,car,31,173,320,24,240,183,1,204,207,LTAdatasets/1003/annotate/1003-2021_03_20_093424.jpg,188.5,195.0,0.5890625,0.8125,0.096875,0.1
1003-2021_03_20_093424.jpg,car,31,234,320,17,240,194,1,265,211,LTAdatasets/1003/annotate/1003-2021_03_20_093424.jpg,249.5,202.5,0.7796875,0.84375,0.096875,0.07083333333333333
1003-2021_03_20_093424.jpg,car,27,195,320,16,240,165,1,222,181,LTAdatasets/1003/annotate/1003-2021_03_20_093424.jpg,208.5,173.0,0.6515625,0.7208333333333333,0.084375,0.06666666666666667
1003-2021_03_20_093424.jpg,car,23,159,320,19,240,157,1,182,176,LTAdatasets/1003/annotate/1003-2021_03_20_093424.jpg,170.5,166.5,0.5328125,0.69375,0.071875,0.07916666666666666
1003-2021_03_20_093424.jpg,car,19,180,320,17,240,142,1,199,159,LTAdatasets/1003/annotate/1003-2021_03_20_093424.jpg,189.5,150.5,0.5921875,0.6270833333333333,0.059375,0.07083333333333333
1003-2021_03_20_093424.jpg,car,21,143,320,14,240,137,1,164,151,LTAdatasets/1003/annotate/1003-2021_03_20_093424.jpg,153.5,144.0,0.4796875,0.6,0.065625,0.058333333333333334
1003-2021_03_20_093424.jpg,car,21,125,320,13,240,122,1,146,135,LTAdatasets/1003/annotate/1003-2021_03_20_093424.jpg,135.5,128.5,0.4234375,0.5354166666666667,0.065625,0.05416666666666667
1003-2021_03_20_093424.jpg,car,11,148,320,12,240,119,1,159,131,LTAdatasets/1003/annotate/1003-2021_03_20_093424.jpg,153.5,125.0,0.4796875,0.5208333333333334,0.034375,0.05
1003-2021_03_20_093424.jpg,lorry_truck,21,164,320,19,240,125,2,185,144,LTAdatasets/1003/annotate/1003-2021_03_20_093424.jpg,174.5,134.5,0.5453125,0.5604166666666667,0.065625,0.07916666666666666
1003-2021_03_20_093424.jpg,car,9,141,320,9,240,113,1,150,122,LTAdatasets/1003/annotate/1003-2021_03_20_093424.jpg,145.5,117.5,0.4546875,0.4895833333333333,0.028125,0.0375
1003-2021_03_20_093424.jpg,bike,11,133,320,10,240,104,4,144,114,LTAdatasets/1003/annotate/1003-2021_03_20_093424.jpg,138.5,109.0,0.4328125,0.45416666666666666,0.034375,0.041666666666666664
1003-2021_03_20_093424.jpg,car,11,169,320,9,240,95,1,180,104,LTAdatasets/1003/annotate/1003-2021_03_20_093424.jpg,174.5,99.5,0.5453125,0.41458333333333336,0.034375,0.0375
1003-2021_03_20_093424.jpg,car,8,126,320,9,240,100,1,134,109,LTAdatasets/1003/annotate/1003-2021_03_20_093424.jpg,130.0,104.5,0.40625,0.4354166666666667,0.025,0.0375
1003-2021_03_20_075138.jpg,van,15,65,320,18,240,115,3,80,133,LTAdatasets/1003/annotate/1003-2021_03_20_075138.jpg,72.5,124.0,0.2265625,0.5166666666666667,0.046875,0.075
1003-2021_03_20_075138.jpg,lorry_truck,52,225,320,44,240,164,2,277,208,LTAdatasets/1003/annotate/1003-2021_03_20_075138.jpg,251.0,186.0,0.784375,0.775,0.1625,0.18333333333333332
1003-2021_03_20_075138.jpg,bike,12,276,320,14,240,145,4,288,159,LTAdatasets/1003/annotate/1003-2021_03_20_075138.jpg,282.0,152.0,0.88125,0.6333333333333333,0.0375,0.058333333333333334
1003-2021_03_20_075138.jpg,bike,8,235,320,12,240,116,4,243,128,LTAdatasets/1003/annotate/1003-2021_03_20_075138.jpg,239.0,122.0,0.746875,0.5083333333333333,0.025,0.05
1003-2021_03_20_075138.jpg,bike,9,217,320,12,240,103,4,226,115,LTAdatasets/1003/annotate/1003-2021_03_20_075138.jpg,221.5,109.0,0.6921875,0.45416666666666666,0.028125,0.05
1003-2021_03_20_075138.jpg,car,19,280,320,15,240,115,1,299,130,LTAdatasets/1003/annotate/1003-2021_03_20_075138.jpg,289.5,122.5,0.9046875,0.5104166666666666,0.059375,0.0625
1003-2021_03_20_075138.jpg,car,10,226,320,9,240,99,1,236,108,LTAdatasets/1003/annotate/1003-2021_03_20_075138.jpg,231.0,103.5,0.721875,0.43125,0.03125,0.0375
1003-2021_03_20_075138.jpg,car,8,289,320,9,240,94,1,297,103,LTAdatasets/1003/annotate/1003-2021_03_20_075138.jpg,293.0,98.5,0.915625,0.41041666666666665,0.025,0.0375
1003-2021_03_20_075138.jpg,car,11,260,320,10,240,94,1,271,104,LTAdatasets/1003/annotate/1003-2021_03_20_075138.jpg,265.5,99.0,0.8296875,0.4125,0.034375,0.041666666666666664
1003-2021_03_20_181251.jpg,car,18,130,320,11,240,124,1,148,135,LTAdatasets/1003/annotate/1003-2021_03_20_181251.jpg,139.0,129.5,0.434375,0.5395833333333333,0.05625,0.04583333333333333
1003-2021_03_20_181251.jpg,car,15,148,320,13,240,118,1,163,131,LTAdatasets/1003/annotate/1003-2021_03_20_181251.jpg,155.5,124.5,0.4859375,0.51875,0.046875,0.05416666666666667
1003-2021_03_20_181251.jpg,car,11,139,320,10,240,111,1,150,121,LTAdatasets/1003/annotate/1003-2021_03_20_181251.jpg,144.5,116.0,0.4515625,0.48333333333333334,0.034375,0.041666666666666664
1003-2021_03_20_181251.jpg,car,23,229,320,16,240,127,1,252,143,LTAdatasets/1003/annotate/1003-2021_03_20_181251.jpg,240.5,135.0,0.7515625,0.5625,0.071875,0.06666666666666667
1003-2021_03_20_181251.jpg,car,22,189,320,16,240,153,1,211,169,LTAdatasets/1003/annotate/1003-2021_03_20_181251.jpg,200.0,161.0,0.625,0.6708333333333333,0.06875,0.06666666666666667
1003-2021_03_20_181251.jpg,car,13,73,320,12,240,103,1,86,115,LTAdatasets/1003/annotate/1003-2021_03_20_181251.jpg,79.5,109.0,0.2484375,0.45416666666666666,0.040625,0.05
1003-2021_03_20_181251.jpg,van,15,17,320,10,240,107,3,32,117,LTAdatasets/1003/annotate/1003-2021_03_20_181251.jpg,24.5,112.0,0.0765625,0.4666666666666667,0.046875,0.041666666666666664
1003-2021_03_20_181251.jpg,car,10,6,320,9,240,105,1,16,114,LTAdatasets/1003/annotate/1003-2021_03_20_181251.jpg,11.0,109.5,0.034375,0.45625,0.03125,0.0375
1003-2021_03_20_181251.jpg,car,11,131,320,9,240,103,1,142,112,LTAdatasets/1003/annotate/1003-2021_03_20_181251.jpg,136.5,107.5,0.4265625,0.4479166666666667,0.034375,0.0375
1003-2021_03_20_181251.jpg,car,11,179,320,8,240,99,1,190,107,LTAdatasets/1003/annotate/1003-2021_03_20_181251.jpg,184.5,103.0,0.5765625,0.42916666666666664,0.034375,0.03333333333333333
1003-2021_03_20_181251.jpg,car,7,109,320,6,240,98,1,116,104,LTAdatasets/1003/annotate/1003-2021_03_20_181251.jpg,112.5,101.0,0.3515625,0.42083333333333334,0.021875,0.025
1003-2021_03_20_193415.jpg,car,22,169,320,12,240,139,1,191,151,LTAdatasets/1003/annotate/1003-2021_03_20_193415.jpg,180.0,145.0,0.5625,0.6041666666666666,0.06875,0.05
1003-2021_03_20_193415.jpg,van,17,213,320,15,240,117,3,230,132,LTAdatasets/1003/annotate/1003-2021_03_20_193415.jpg,221.5,124.5,0.6921875,0.51875,0.053125,0.0625
1003-2021_03_20_193415.jpg,car,17,139,320,11,240,111,1,156,122,LTAdatasets/1003/annotate/1003-2021_03_20_193415.jpg,147.5,116.5,0.4609375,0.48541666666666666,0.053125,0.04583333333333333
1003-2021_03_20_193415.jpg,car,14,124,320,10,240,115,1,138,125,LTAdatasets/1003/annotate/1003-2021_03_20_193415.jpg,131.0,120.0,0.409375,0.5,0.04375,0.041666666666666664
1003-2021_03_20_193415.jpg,car,9,187,320,8,240,101,1,196,109,LTAdatasets/1003/annotate/1003-2021_03_20_193415.jpg,191.5,105.0,0.5984375,0.4375,0.028125,0.03333333333333333
1003-2021_03_20_191614.jpg,car,26,217,320,27,240,164,1,243,191,LTAdatasets/1003/annotate/1003-2021_03_20_191614.jpg,230.0,177.5,0.71875,0.7395833333333334,0.08125,0.1125
1003-2021_03_20_191614.jpg,car,18,132,320,15,240,125,1,150,140,LTAdatasets/1003/annotate/1003-2021_03_20_191614.jpg,141.0,132.5,0.440625,0.5520833333333334,0.05625,0.0625
1003-2021_03_20_191614.jpg,car,17,229,320,11,240,117,1,246,128,LTAdatasets/1003/annotate/1003-2021_03_20_191614.jpg,237.5,122.5,0.7421875,0.5104166666666666,0.053125,0.04583333333333333
1003-2021_03_20_191614.jpg,car,13,179,320,9,240,103,1,192,112,LTAdatasets/1003/annotate/1003-2021_03_20_191614.jpg,185.5,107.5,0.5796875,0.4479166666666667,0.040625,0.0375
1003-2021_03_20_191614.jpg,car,10,122,320,7,240,96,1,132,103,LTAdatasets/1003/annotate/1003-2021_03_20_191614.jpg,127.0,99.5,0.396875,0.41458333333333336,0.03125,0.029166666666666667
1003-2021_03_20_191614.jpg,car,8,27,320,8,240,98,1,35,106,LTAdatasets/1003/annotate/1003-2021_03_20_191614.jpg,31.0,102.0,0.096875,0.425,0.025,0.03333333333333333
1003-2021_03_20_191614.jpg,car,17,293,320,10,240,103,1,310,113,LTAdatasets/1003/annotate/1003-2021_03_20_191614.jpg,301.5,108.0,0.9421875,0.45,0.053125,0.041666666666666664
1003-2021_03_20_191614.jpg,car,13,271,320,8,240,90,1,284,98,LTAdatasets/1003/annotate/1003-2021_03_20_191614.jpg,277.5,94.0,0.8671875,0.39166666666666666,0.040625,0.03333333333333333
1003-2021_03_20_092143.jpg,car,28,143,320,24,240,134,1,171,158,LTAdatasets/1003/annotate/1003-2021_03_20_092143.jpg,157.0,146.0,0.490625,0.6083333333333333,0.0875,0.1
1003-2021_03_20_092143.jpg,car,13,124,320,11,240,117,1,137,128,LTAdatasets/1003/annotate/1003-2021_03_20_092143.jpg,130.5,122.5,0.4078125,0.5104166666666666,0.040625,0.04583333333333333
1003-2021_03_20_092143.jpg,car,27,170,320,23,240,174,1,197,197,LTAdatasets/1003/annotate/1003-2021_03_20_092143.jpg,183.5,185.5,0.5734375,0.7729166666666667,0.084375,0.09583333333333334
1003-2021_03_20_092143.jpg,car,20,177,320,19,240,138,1,197,157,LTAdatasets/1003/annotate/1003-2021_03_20_092143.jpg,187.0,147.5,0.584375,0.6145833333333334,0.0625,0.07916666666666666
1003-2021_03_20_092143.jpg,lorry_truck,20,146,320,14,240,118,2,166,132,LTAdatasets/1003/annotate/1003-2021_03_20_092143.jpg,156.0,125.0,0.4875,0.5208333333333334,0.0625,0.058333333333333334
1003-2021_03_20_092143.jpg,lorry_truck,71,201,320,72,240,137,2,272,209,LTAdatasets/1003/annotate/1003-2021_03_20_092143.jpg,236.5,173.0,0.7390625,0.7208333333333333,0.221875,0.3
1003-2021_03_20_092143.jpg,lorry_truck,20,134,320,20,240,98,2,154,118,LTAdatasets/1003/annotate/1003-2021_03_20_092143.jpg,144.0,108.0,0.45,0.45,0.0625,0.08333333333333333
1003-2021_03_20_092143.jpg,lorry_truck,19,199,320,15,240,98,2,218,113,LTAdatasets/1003/annotate/1003-2021_03_20_092143.jpg,208.5,105.5,0.6515625,0.4395833333333333,0.059375,0.0625
1003-2021_03_20_092143.jpg,van,28,291,320,20,240,129,3,319,149,LTAdatasets/1003/annotate/1003-2021_03_20_092143.jpg,305.0,139.0,0.953125,0.5791666666666667,0.0875,0.08333333333333333
1003-2021_03_20_092143.jpg,car,6,111,320,7,240,101,1,117,108,LTAdatasets/1003/annotate/1003-2021_03_20_092143.jpg,114.0,104.5,0.35625,0.4354166666666667,0.01875,0.029166666666666667
1003-2021_03_20_092143.jpg,van,15,266,320,11,240,101,3,281,112,LTAdatasets/1003/annotate/1003-2021_03_20_092143.jpg,273.5,106.5,0.8546875,0.44375,0.046875,0.04583333333333333
1003-2021_03_20_092143.jpg,car,11,285,320,9,240,103,1,296,112,LTAdatasets/1003/annotate/1003-2021_03_20_092143.jpg,290.5,107.5,0.9078125,0.4479166666666667,0.034375,0.0375
1003-2021_03_20_092143.jpg,car,9,168,320,7,240,93,1,177,100,LTAdatasets/1003/annotate/1003-2021_03_20_092143.jpg,172.5,96.5,0.5390625,0.40208333333333335,0.028125,0.029166666666666667
1003-2021_03_20_212801.jpg,car,32,201,320,21,240,164,1,233,185,LTAdatasets/1003/annotate/1003-2021_03_20_212801.jpg,217.0,174.5,0.678125,0.7270833333333333,0.1,0.0875
1003-2021_03_20_212801.jpg,car,16,151,320,17,240,120,1,167,137,LTAdatasets/1003/annotate/1003-2021_03_20_212801.jpg,159.0,128.5,0.496875,0.5354166666666667,0.05,0.07083333333333333
1003-2021_03_20_212801.jpg,car,21,281,320,17,240,123,1,302,140,LTAdatasets/1003/annotate/1003-2021_03_20_212801.jpg,291.5,131.5,0.9109375,0.5479166666666667,0.065625,0.07083333333333333
1003-2021_03_20_212801.jpg,car,19,250,320,13,240,107,1,269,120,LTAdatasets/1003/annotate/1003-2021_03_20_212801.jpg,259.5,113.5,0.8109375,0.47291666666666665,0.059375,0.05416666666666667
1003-2021_03_20_212801.jpg,car,13,211,320,6,240,103,1,224,109,LTAdatasets/1003/annotate/1003-2021_03_20_212801.jpg,217.5,106.0,0.6796875,0.44166666666666665,0.040625,0.025
1003-2021_03_20_212801.jpg,car,17,72,320,15,240,133,1,89,148,LTAdatasets/1003/annotate/1003-2021_03_20_212801.jpg,80.5,140.5,0.2515625,0.5854166666666667,0.053125,0.0625
1003-2021_03_20_212801.jpg,car,13,17,320,7,240,108,1,30,115,LTAdatasets/1003/annotate/1003-2021_03_20_212801.jpg,23.5,111.5,0.0734375,0.46458333333333335,0.040625,0.029166666666666667
1003-2021_03_20_212801.jpg,car,15,64,320,11,240,110,1,79,121,LTAdatasets/1003/annotate/1003-2021_03_20_212801.jpg,71.5,115.5,0.2234375,0.48125,0.046875,0.04583333333333333
1003-2021_03_20_212801.jpg,bike,8,4,320,8,240,108,4,12,116,LTAdatasets/1003/annotate/1003-2021_03_20_212801.jpg,8.0,112.0,0.025,0.4666666666666667,0.025,0.03333333333333333
1003-2021_03_20_212801.jpg,lorry_truck,10,124,320,11,240,92,2,134,103,LTAdatasets/1003/annotate/1003-2021_03_20_212801.jpg,129.0,97.5,0.403125,0.40625,0.03125,0.04583333333333333
1003-2021_03_20_082220.jpg,car,24,147,320,20,240,144,1,171,164,LTAdatasets/1003/annotate/1003-2021_03_20_082220.jpg,159.0,154.0,0.496875,0.6416666666666667,0.075,0.08333333333333333
1003-2021_03_20_082220.jpg,car,28,177,320,22,240,143,1,205,165,LTAdatasets/1003/annotate/1003-2021_03_20_082220.jpg,191.0,154.0,0.596875,0.6416666666666667,0.0875,0.09166666666666666
1003-2021_03_20_082220.jpg,car,25,285,320,17,240,140,1,310,157,LTAdatasets/1003/annotate/1003-2021_03_20_082220.jpg,297.5,148.5,0.9296875,0.61875,0.078125,0.07083333333333333
1003-2021_03_20_082220.jpg,car,17,303,320,16,240,135,1,320,151,LTAdatasets/1003/annotate/1003-2021_03_20_082220.jpg,311.5,143.0,0.9734375,0.5958333333333333,0.053125,0.06666666666666667
1003-2021_03_20_082220.jpg,lorry_truck,15,171,320,13,240,98,2,186,111,LTAdatasets/1003/annotate/1003-2021_03_20_082220.jpg,178.5,104.5,0.5578125,0.4354166666666667,0.046875,0.05416666666666667
1003-2021_03_20_082220.jpg,lorry_truck,17,137,320,15,240,110,2,154,125,LTAdatasets/1003/annotate/1003-2021_03_20_082220.jpg,145.5,117.5,0.4546875,0.4895833333333333,0.053125,0.0625
1003-2021_03_20_082220.jpg,lorry_truck,19,8,320,15,240,121,2,27,136,LTAdatasets/1003/annotate/1003-2021_03_20_082220.jpg,17.5,128.5,0.0546875,0.5354166666666667,0.059375,0.0625
1003-2021_03_20_082220.jpg,lorry_truck,21,80,320,22,240,191,2,101,213,LTAdatasets/1003/annotate/1003-2021_03_20_082220.jpg,90.5,202.0,0.2828125,0.8416666666666667,0.065625,0.09166666666666666
1003-2021_03_20_082220.jpg,lorry_truck,9,22,320,17,240,101,2,31,118,LTAdatasets/1003/annotate/1003-2021_03_20_082220.jpg,26.5,109.5,0.0828125,0.45625,0.028125,0.07083333333333333
1003-2021_03_20_203358.jpg,car,18,68,320,11,240,118,1,86,129,LTAdatasets/1003/annotate/1003-2021_03_20_203358.jpg,77.0,123.5,0.240625,0.5145833333333333,0.05625,0.04583333333333333
1003-2021_03_20_203358.jpg,car,17,259,320,12,240,108,1,276,120,LTAdatasets/1003/annotate/1003-2021_03_20_203358.jpg,267.5,114.0,0.8359375,0.475,0.053125,0.05
1003-2021_03_20_203358.jpg,car,13,166,320,8,240,90,1,179,98,LTAdatasets/1003/annotate/1003-2021_03_20_203358.jpg,172.5,94.0,0.5390625,0.39166666666666666,0.040625,0.03333333333333333
1003-2021_03_20_203358.jpg,car,9,203,320,7,240,94,1,212,101,LTAdatasets/1003/annotate/1003-2021_03_20_203358.jpg,207.5,97.5,0.6484375,0.40625,0.028125,0.029166666666666667
1003-2021_03_20_203358.jpg,car,17,293,320,8,240,103,1,310,111,LTAdatasets/1003/annotate/1003-2021_03_20_203358.jpg,301.5,107.0,0.9421875,0.44583333333333336,0.053125,0.03333333333333333
1003-2021_03_20_203358.jpg,bike,4,157,320,8,240,92,4,161,100,LTAdatasets/1003/annotate/1003-2021_03_20_203358.jpg,159.0,96.0,0.496875,0.4,0.0125,0.03333333333333333
1003-2021_03_20_195136.jpg,car,24,72,320,20,240,162,1,96,182,LTAdatasets/1003/annotate/1003-2021_03_20_195136.jpg,84.0,172.0,0.2625,0.7166666666666667,0.075,0.08333333333333333
1003-2021_03_20_195136.jpg,car,15,131,320,12,240,106,1,146,118,LTAdatasets/1003/annotate/1003-2021_03_20_195136.jpg,138.5,112.0,0.4328125,0.4666666666666667,0.046875,0.05
1003-2021_03_20_195136.jpg,car,16,64,320,16,240,120,1,80,136,LTAdatasets/1003/annotate/1003-2021_03_20_195136.jpg,72.0,128.0,0.225,0.5333333333333333,0.05,0.06666666666666667
1003-2021_03_20_195136.jpg,car,13,123,320,9,240,98,1,136,107,LTAdatasets/1003/annotate/1003-2021_03_20_195136.jpg,129.5,102.5,0.4046875,0.4270833333333333,0.040625,0.0375
1003-2021_03_20_195136.jpg,car,10,107,320,11,240,95,1,117,106,LTAdatasets/1003/annotate/1003-2021_03_20_195136.jpg,112.0,100.5,0.35,0.41875,0.03125,0.04583333333333333
1003-2021_03_20_220643.jpg,car,20,250,320,25,240,201,1,270,226,LTAdatasets/1003/annotate/1003-2021_03_20_220643.jpg,260.0,213.5,0.8125,0.8895833333333333,0.0625,0.10416666666666667
1003-2021_03_20_220643.jpg,car,20,236,320,10,240,121,1,256,131,LTAdatasets/1003/annotate/1003-2021_03_20_220643.jpg,246.0,126.0,0.76875,0.525,0.0625,0.041666666666666664
1003-2021_03_20_220643.jpg,car,14,65,320,6,240,99,1,79,105,LTAdatasets/1003/annotate/1003-2021_03_20_220643.jpg,72.0,102.0,0.225,0.425,0.04375,0.025
1003-2021_03_20_220643.jpg,car,15,276,320,9,240,103,1,291,112,LTAdatasets/1003/annotate/1003-2021_03_20_220643.jpg,283.5,107.5,0.8859375,0.4479166666666667,0.046875,0.0375
1003-2021_03_20_220643.jpg,car,13,293,320,8,240,100,1,306,108,LTAdatasets/1003/annotate/1003-2021_03_20_220643.jpg,299.5,104.0,0.9359375,0.43333333333333335,0.040625,0.03333333333333333
1003-2021_03_20_220643.jpg,car,9,151,320,9,240,83,1,160,92,LTAdatasets/1003/annotate/1003-2021_03_20_220643.jpg,155.5,87.5,0.4859375,0.3645833333333333,0.028125,0.0375
1003-2021_03_20_213341.jpg,car,12,130,320,13,240,98,1,142,111,LTAdatasets/1003/annotate/1003-2021_03_20_213341.jpg,136.0,104.5,0.425,0.4354166666666667,0.0375,0.05416666666666667
1003-2021_03_20_213341.jpg,car,20,277,320,15,240,118,1,297,133,LTAdatasets/1003/annotate/1003-2021_03_20_213341.jpg,287.0,125.5,0.896875,0.5229166666666667,0.0625,0.0625
1003-2021_03_20_213341.jpg,car,14,285,320,11,240,96,1,299,107,LTAdatasets/1003/annotate/1003-2021_03_20_213341.jpg,292.0,101.5,0.9125,0.42291666666666666,0.04375,0.04583333333333333
1003-2021_03_20_213341.jpg,car,13,260,320,8,240,97,1,273,105,LTAdatasets/1003/annotate/1003-2021_03_20_213341.jpg,266.5,101.0,0.8328125,0.42083333333333334,0.040625,0.03333333333333333
1003-2021_03_20_210720.jpg,car,17,181,320,12,240,101,1,198,113,LTAdatasets/1003/annotate/1003-2021_03_20_210720.jpg,189.5,107.0,0.5921875,0.44583333333333336,0.053125,0.05
1003-2021_03_20_210720.jpg,car,14,10,320,14,240,121,1,24,135,LTAdatasets/1003/annotate/1003-2021_03_20_210720.jpg,17.0,128.0,0.053125,0.5333333333333333,0.04375,0.058333333333333334
1003-2021_03_20_210720.jpg,car,11,20,320,11,240,108,1,31,119,LTAdatasets/1003/annotate/1003-2021_03_20_210720.jpg,25.5,113.5,0.0796875,0.47291666666666665,0.034375,0.04583333333333333
1003-2021_03_20_210720.jpg,car,24,266,320,16,240,128,1,290,144,LTAdatasets/1003/annotate/1003-2021_03_20_210720.jpg,278.0,136.0,0.86875,0.5666666666666667,0.075,0.06666666666666667
1003-2021_03_20_210720.jpg,car,8,124,320,7,240,98,1,132,105,LTAdatasets/1003/annotate/1003-2021_03_20_210720.jpg,128.0,101.5,0.4,0.42291666666666666,0.025,0.029166666666666667
1003-2021_03_20_210720.jpg,car,9,200,320,7,240,98,1,209,105,LTAdatasets/1003/annotate/1003-2021_03_20_210720.jpg,204.5,101.5,0.6390625,0.42291666666666666,0.028125,0.029166666666666667
1003-2021_03_20_210720.jpg,car,7,211,320,8,240,93,1,218,101,LTAdatasets/1003/annotate/1003-2021_03_20_210720.jpg,214.5,97.0,0.6703125,0.4041666666666667,0.021875,0.03333333333333333
1003-2021_03_20_210720.jpg,van,9,171,320,10,240,91,3,180,101,LTAdatasets/1003/annotate/1003-2021_03_20_210720.jpg,175.5,96.0,0.5484375,0.4,0.028125,0.041666666666666664
1003-2021_03_20_092803.jpg,car,20,153,320,16,240,151,1,173,167,LTAdatasets/1003/annotate/1003-2021_03_20_092803.jpg,163.0,159.0,0.509375,0.6625,0.0625,0.06666666666666667
1003-2021_03_20_092803.jpg,car,18,209,320,14,240,167,1,227,181,LTAdatasets/1003/annotate/1003-2021_03_20_092803.jpg,218.0,174.0,0.68125,0.725,0.05625,0.058333333333333334
1003-2021_03_20_092803.jpg,car,12,129,320,15,240,121,1,141,136,LTAdatasets/1003/annotate/1003-2021_03_20_092803.jpg,135.0,128.5,0.421875,0.5354166666666667,0.0375,0.0625
1003-2021_03_20_092803.jpg,car,21,67,320,21,240,153,1,88,174,LTAdatasets/1003/annotate/1003-2021_03_20_092803.jpg,77.5,163.5,0.2421875,0.68125,0.065625,0.0875
1003-2021_03_20_092803.jpg,car,12,183,320,9,240,106,1,195,115,LTAdatasets/1003/annotate/1003-2021_03_20_092803.jpg,189.0,110.5,0.590625,0.46041666666666664,0.0375,0.0375
1003-2021_03_20_092803.jpg,lorry_truck,10,145,320,15,240,111,2,155,126,LTAdatasets/1003/annotate/1003-2021_03_20_092803.jpg,150.0,118.5,0.46875,0.49375,0.03125,0.0625
1003-2021_03_20_092803.jpg,car,14,265,320,9,240,122,1,279,131,LTAdatasets/1003/annotate/1003-2021_03_20_092803.jpg,272.0,126.5,0.85,0.5270833333333333,0.04375,0.0375
1003-2021_03_20_092803.jpg,bus,29,285,320,30,240,124,5,314,154,LTAdatasets/1003/annotate/1003-2021_03_20_092803.jpg,299.5,139.0,0.9359375,0.5791666666666667,0.090625,0.125
1003-2021_03_20_092803.jpg,lorry_truck,23,165,320,19,240,131,2,188,150,LTAdatasets/1003/annotate/1003-2021_03_20_092803.jpg,176.5,140.5,0.5515625,0.5854166666666667,0.071875,0.07916666666666666
1003-2021_03_20_092803.jpg,lorry_truck,10,137,320,9,240,105,2,147,114,LTAdatasets/1003/annotate/1003-2021_03_20_092803.jpg,142.0,109.5,0.44375,0.45625,0.03125,0.0375
1003-2021_03_20_092803.jpg,lorry_truck,12,128,320,14,240,99,2,140,113,LTAdatasets/1003/annotate/1003-2021_03_20_092803.jpg,134.0,106.0,0.41875,0.44166666666666665,0.0375,0.058333333333333334
1003-2021_03_20_092803.jpg,lorry_truck,8,124,320,10,240,95,2,132,105,LTAdatasets/1003/annotate/1003-2021_03_20_092803.jpg,128.0,100.0,0.4,0.4166666666666667,0.025,0.041666666666666664
1003-2021_03_20_092803.jpg,car,9,156,320,7,240,92,1,165,99,LTAdatasets/1003/annotate/1003-2021_03_20_092803.jpg,160.5,95.5,0.5015625,0.39791666666666664,0.028125,0.029166666666666667
1003-2021_03_20_092803.jpg,car,15,280,320,11,240,96,1,295,107,LTAdatasets/1003/annotate/1003-2021_03_20_092803.jpg,287.5,101.5,0.8984375,0.42291666666666666,0.046875,0.04583333333333333
1003-2021_03_20_180710.jpg,car,16,268,320,17,240,120,1,284,137,LTAdatasets/1003/annotate/1003-2021_03_20_180710.jpg,276.0,128.5,0.8625,0.5354166666666667,0.05,0.07083333333333333
1003-2021_03_20_180710.jpg,car,17,289,320,13,240,118,1,306,131,LTAdatasets/1003/annotate/1003-2021_03_20_180710.jpg,297.5,124.5,0.9296875,0.51875,0.053125,0.05416666666666667
1003-2021_03_20_180710.jpg,car,13,68,320,13,240,109,1,81,122,LTAdatasets/1003/annotate/1003-2021_03_20_180710.jpg,74.5,115.5,0.2328125,0.48125,0.040625,0.05416666666666667
1003-2021_03_20_180710.jpg,car,12,123,320,9,240,96,1,135,105,LTAdatasets/1003/annotate/1003-2021_03_20_180710.jpg,129.0,100.5,0.403125,0.41875,0.0375,0.0375
1003-2021_03_20_180710.jpg,lorry_truck,14,284,320,11,240,100,2,298,111,LTAdatasets/1003/annotate/1003-2021_03_20_180710.jpg,291.0,105.5,0.909375,0.4395833333333333,0.04375,0.04583333333333333
1003-2021_03_20_180710.jpg,car,12,274,320,9,240,96,1,286,105,LTAdatasets/1003/annotate/1003-2021_03_20_180710.jpg,280.0,100.5,0.875,0.41875,0.0375,0.0375
1003-2021_03_20_180710.jpg,car,10,253,320,5,240,92,1,263,97,LTAdatasets/1003/annotate/1003-2021_03_20_180710.jpg,258.0,94.5,0.80625,0.39375,0.03125,0.020833333333333332
1003-2021_03_20_071836.jpg,car,19,145,320,15,240,139,1,164,154,LTAdatasets/1003/annotate/1003-2021_03_20_071836.jpg,154.5,146.5,0.4828125,0.6104166666666667,0.059375,0.0625
1003-2021_03_20_071836.jpg,car,21,253,320,16,240,113,1,274,129,LTAdatasets/1003/annotate/1003-2021_03_20_071836.jpg,263.5,121.0,0.8234375,0.5041666666666667,0.065625,0.06666666666666667
1003-2021_03_20_071836.jpg,car,25,176,320,18,240,145,1,201,163,LTAdatasets/1003/annotate/1003-2021_03_20_071836.jpg,188.5,154.0,0.5890625,0.6416666666666667,0.078125,0.075
1003-2021_03_20_071836.jpg,car,16,272,320,10,240,100,1,288,110,LTAdatasets/1003/annotate/1003-2021_03_20_071836.jpg,280.0,105.0,0.875,0.4375,0.05,0.041666666666666664
1003-2021_03_20_071836.jpg,van,18,143,320,14,240,111,3,161,125,LTAdatasets/1003/annotate/1003-2021_03_20_071836.jpg,152.0,118.0,0.475,0.49166666666666664,0.05625,0.058333333333333334
1003-2021_03_20_071836.jpg,car,14,306,320,15,240,123,1,320,138,LTAdatasets/1003/annotate/1003-2021_03_20_071836.jpg,313.0,130.5,0.978125,0.54375,0.04375,0.0625
1003-2021_03_20_071836.jpg,car,12,191,320,10,240,108,1,203,118,LTAdatasets/1003/annotate/1003-2021_03_20_071836.jpg,197.0,113.0,0.615625,0.4708333333333333,0.0375,0.041666666666666664
1003-2021_03_20_071836.jpg,car,13,160,320,5,240,98,1,173,103,LTAdatasets/1003/annotate/1003-2021_03_20_071836.jpg,166.5,100.5,0.5203125,0.41875,0.040625,0.020833333333333332
1003-2021_03_20_071836.jpg,lorry_truck,9,163,320,9,240,88,2,172,97,LTAdatasets/1003/annotate/1003-2021_03_20_071836.jpg,167.5,92.5,0.5234375,0.3854166666666667,0.028125,0.0375
1003-2021_03_20_075818.jpg,car,14,124,320,14,240,114,1,138,128,LTAdatasets/1003/annotate/1003-2021_03_20_075818.jpg,131.0,121.0,0.409375,0.5041666666666667,0.04375,0.058333333333333334
1003-2021_03_20_075818.jpg,car,23,142,320,15,240,117,1,165,132,LTAdatasets/1003/annotate/1003-2021_03_20_075818.jpg,153.5,124.5,0.4796875,0.51875,0.071875,0.0625
1003-2021_03_20_075818.jpg,lorry_truck,15,218,320,13,240,104,2,233,117,LTAdatasets/1003/annotate/1003-2021_03_20_075818.jpg,225.5,110.5,0.7046875,0.46041666666666664,0.046875,0.05416666666666667
1003-2021_03_20_075818.jpg,car,11,127,320,8,240,103,1,138,111,LTAdatasets/1003/annotate/1003-2021_03_20_075818.jpg,132.5,107.0,0.4140625,0.44583333333333336,0.034375,0.03333333333333333
1003-2021_03_20_075818.jpg,car,23,182,320,21,240,185,1,205,206,LTAdatasets/1003/annotate/1003-2021_03_20_075818.jpg,193.5,195.5,0.6046875,0.8145833333333333,0.071875,0.0875
1003-2021_03_20_075818.jpg,car,12,289,320,14,240,100,1,301,114,LTAdatasets/1003/annotate/1003-2021_03_20_075818.jpg,295.0,107.0,0.921875,0.44583333333333336,0.0375,0.058333333333333334
1003-2021_03_20_090402.jpg,lorry_truck,25,177,320,27,240,138,2,202,165,LTAdatasets/1003/annotate/1003-2021_03_20_090402.jpg,189.5,151.5,0.5921875,0.63125,0.078125,0.1125
1003-2021_03_20_090402.jpg,car,14,140,320,10,240,124,1,154,134,LTAdatasets/1003/annotate/1003-2021_03_20_090402.jpg,147.0,129.0,0.459375,0.5375,0.04375,0.041666666666666664
1003-2021_03_20_090402.jpg,car,44,260,320,25,240,215,1,304,240,LTAdatasets/1003/annotate/1003-2021_03_20_090402.jpg,282.0,227.5,0.88125,0.9479166666666666,0.1375,0.10416666666666667
1003-2021_03_20_090402.jpg,lorry_truck,58,262,320,45,240,131,2,320,176,LTAdatasets/1003/annotate/1003-2021_03_20_090402.jpg,291.0,153.5,0.909375,0.6395833333333333,0.18125,0.1875
1003-2021_03_20_090402.jpg,car,7,124,320,9,240,111,1,131,120,LTAdatasets/1003/annotate/1003-2021_03_20_090402.jpg,127.5,115.5,0.3984375,0.48125,0.021875,0.0375
1003-2021_03_20_090402.jpg,car,16,291,320,9,240,98,1,307,107,LTAdatasets/1003/annotate/1003-2021_03_20_090402.jpg,299.0,102.5,0.934375,0.4270833333333333,0.05,0.0375
1003-2021_03_20_184913.jpg,lorry_truck,26,206,320,24,240,153,2,232,177,LTAdatasets/1003/annotate/1003-2021_03_20_184913.jpg,219.0,165.0,0.684375,0.6875,0.08125,0.1
1003-2021_03_20_184913.jpg,car,25,170,320,16,240,137,1,195,153,LTAdatasets/1003/annotate/1003-2021_03_20_184913.jpg,182.5,145.0,0.5703125,0.6041666666666666,0.078125,0.06666666666666667
1003-2021_03_20_184913.jpg,car,12,233,320,13,240,107,1,245,120,LTAdatasets/1003/annotate/1003-2021_03_20_184913.jpg,239.0,113.5,0.746875,0.47291666666666665,0.0375,0.05416666666666667
1003-2021_03_20_184913.jpg,car,13,218,320,9,240,98,1,231,107,LTAdatasets/1003/annotate/1003-2021_03_20_184913.jpg,224.5,102.5,0.7015625,0.4270833333333333,0.040625,0.0375
1003-2021_03_20_184913.jpg,car,12,170,320,8,240,93,1,182,101,LTAdatasets/1003/annotate/1003-2021_03_20_184913.jpg,176.0,97.0,0.55,0.4041666666666667,0.0375,0.03333333333333333
1003-2021_03_20_184913.jpg,car,17,152,320,10,240,120,1,169,130,LTAdatasets/1003/annotate/1003-2021_03_20_184913.jpg,160.5,125.0,0.5015625,0.5208333333333334,0.053125,0.041666666666666664
1003-2021_03_20_184913.jpg,car,16,138,320,11,240,111,1,154,122,LTAdatasets/1003/annotate/1003-2021_03_20_184913.jpg,146.0,116.5,0.45625,0.48541666666666666,0.05,0.04583333333333333
1003-2021_03_20_184913.jpg,car,10,127,320,7,240,96,1,137,103,LTAdatasets/1003/annotate/1003-2021_03_20_184913.jpg,132.0,99.5,0.4125,0.41458333333333336,0.03125,0.029166666666666667
1003-2021_03_20_184913.jpg,car,15,270,320,11,240,98,1,285,109,LTAdatasets/1003/annotate/1003-2021_03_20_184913.jpg,277.5,103.5,0.8671875,0.43125,0.046875,0.04583333333333333
1003-2021_03_20_184913.jpg,car,10,283,320,10,240,96,1,293,106,LTAdatasets/1003/annotate/1003-2021_03_20_184913.jpg,288.0,101.0,0.9,0.42083333333333334,0.03125,0.041666666666666664
1003-2021_03_20_061853.jpg,bike,9,183,320,11,240,103,4,192,114,LTAdatasets/1003/annotate/1003-2021_03_20_061853.jpg,187.5,108.5,0.5859375,0.45208333333333334,0.028125,0.04583333333333333
1003-2021_03_20_061853.jpg,bus,19,155,320,18,240,79,5,174,97,LTAdatasets/1003/annotate/1003-2021_03_20_061853.jpg,164.5,88.0,0.5140625,0.36666666666666664,0.059375,0.075
1003-2021_03_20_195736.jpg,lorry_truck,33,73,320,60,240,152,2,106,212,LTAdatasets/1003/annotate/1003-2021_03_20_195736.jpg,89.5,182.0,0.2796875,0.7583333333333333,0.103125,0.25
1003-2021_03_20_195736.jpg,lorry_truck,31,226,320,36,240,170,2,257,206,LTAdatasets/1003/annotate/1003-2021_03_20_195736.jpg,241.5,188.0,0.7546875,0.7833333333333333,0.096875,0.15
1003-2021_03_20_195736.jpg,bus,45,275,320,33,240,140,5,320,173,LTAdatasets/1003/annotate/1003-2021_03_20_195736.jpg,297.5,156.5,0.9296875,0.6520833333333333,0.140625,0.1375
1003-2021_03_20_195736.jpg,car,24,267,320,14,240,122,1,291,136,LTAdatasets/1003/annotate/1003-2021_03_20_195736.jpg,279.0,129.0,0.871875,0.5375,0.075,0.058333333333333334
1003-2021_03_20_195736.jpg,car,16,235,320,13,240,116,1,251,129,LTAdatasets/1003/annotate/1003-2021_03_20_195736.jpg,243.0,122.5,0.759375,0.5104166666666666,0.05,0.05416666666666667
1003-2021_03_20_195736.jpg,car,12,122,320,11,240,106,1,134,117,LTAdatasets/1003/annotate/1003-2021_03_20_195736.jpg,128.0,111.5,0.4,0.46458333333333335,0.0375,0.04583333333333333
1003-2021_03_20_195736.jpg,car,10,156,320,4,240,87,1,166,91,LTAdatasets/1003/annotate/1003-2021_03_20_195736.jpg,161.0,89.0,0.503125,0.37083333333333335,0.03125,0.016666666666666666
1003-2021_03_20_195736.jpg,car,16,283,320,10,240,99,1,299,109,LTAdatasets/1003/annotate/1003-2021_03_20_195736.jpg,291.0,104.0,0.909375,0.43333333333333335,0.05,0.041666666666666664
1003-2021_03_20_214302.jpg,car,16,130,320,17,240,114,1,146,131,LTAdatasets/1003/annotate/1003-2021_03_20_214302.jpg,138.0,122.5,0.43125,0.5104166666666666,0.05,0.07083333333333333
1003-2021_03_20_214302.jpg,car,14,177,320,10,240,90,1,191,100,LTAdatasets/1003/annotate/1003-2021_03_20_214302.jpg,184.0,95.0,0.575,0.3958333333333333,0.04375,0.041666666666666664
1003-2021_03_20_214302.jpg,car,19,202,320,15,240,96,1,221,111,LTAdatasets/1003/annotate/1003-2021_03_20_214302.jpg,211.5,103.5,0.6609375,0.43125,0.059375,0.0625
1003-2021_03_20_214302.jpg,car,27,177,320,18,240,141,1,204,159,LTAdatasets/1003/annotate/1003-2021_03_20_214302.jpg,190.5,150.0,0.5953125,0.625,0.084375,0.075
1003-2021_03_20_214302.jpg,car,21,291,320,15,240,119,1,312,134,LTAdatasets/1003/annotate/1003-2021_03_20_214302.jpg,301.5,126.5,0.9421875,0.5270833333333333,0.065625,0.0625
1003-2021_03_20_214302.jpg,car,44,251,320,43,240,197,1,295,240,LTAdatasets/1003/annotate/1003-2021_03_20_214302.jpg,273.0,218.5,0.853125,0.9104166666666667,0.1375,0.17916666666666667
1003-2021_03_20_214302.jpg,car,25,78,320,28,240,183,1,103,211,LTAdatasets/1003/annotate/1003-2021_03_20_214302.jpg,90.5,197.0,0.2828125,0.8208333333333333,0.078125,0.11666666666666667
1003-2021_03_20_214302.jpg,car,17,65,320,13,240,103,1,82,116,LTAdatasets/1003/annotate/1003-2021_03_20_214302.jpg,73.5,109.5,0.2296875,0.45625,0.053125,0.05416666666666667
1003-2021_03_20_214302.jpg,car,13,19,320,11,240,109,1,32,120,LTAdatasets/1003/annotate/1003-2021_03_20_214302.jpg,25.5,114.5,0.0796875,0.47708333333333336,0.040625,0.04583333333333333
1003-2021_03_20_214302.jpg,car,15,127,320,8,240,104,1,142,112,LTAdatasets/1003/annotate/1003-2021_03_20_214302.jpg,134.5,108.0,0.4203125,0.45,0.046875,0.03333333333333333
1003-2021_03_20_084301.jpg,lorry_truck,24,248,320,42,240,181,2,272,223,LTAdatasets/1003/annotate/1003-2021_03_20_084301.jpg,260.0,202.0,0.8125,0.8416666666666667,0.075,0.175
1003-2021_03_20_084301.jpg,car,23,150,320,18,240,141,1,173,159,LTAdatasets/1003/annotate/1003-2021_03_20_084301.jpg,161.5,150.0,0.5046875,0.625,0.071875,0.075
1003-2021_03_20_084301.jpg,car,10,131,320,10,240,103,1,141,113,LTAdatasets/1003/annotate/1003-2021_03_20_084301.jpg,136.0,108.0,0.425,0.45,0.03125,0.041666666666666664
1003-2021_03_20_084301.jpg,car,11,17,320,12,240,111,1,28,123,LTAdatasets/1003/annotate/1003-2021_03_20_084301.jpg,22.5,117.0,0.0703125,0.4875,0.034375,0.05
1003-2021_03_20_084301.jpg,van,14,222,320,9,240,107,3,236,116,LTAdatasets/1003/annotate/1003-2021_03_20_084301.jpg,229.0,111.5,0.715625,0.46458333333333335,0.04375,0.0375
1003-2021_03_20_084301.jpg,car,14,243,320,15,240,104,1,257,119,LTAdatasets/1003/annotate/1003-2021_03_20_084301.jpg,250.0,111.5,0.78125,0.46458333333333335,0.04375,0.0625
1003-2021_03_20_084301.jpg,car,13,282,320,8,240,102,1,295,110,LTAdatasets/1003/annotate/1003-2021_03_20_084301.jpg,288.5,106.0,0.9015625,0.44166666666666665,0.040625,0.03333333333333333
1003-2021_03_20_084301.jpg,car,10,277,320,7,240,96,1,287,103,LTAdatasets/1003/annotate/1003-2021_03_20_084301.jpg,282.0,99.5,0.88125,0.41458333333333336,0.03125,0.029166666666666667
1003-2021_03_20_084301.jpg,car,13,165,320,7,240,94,1,178,101,LTAdatasets/1003/annotate/1003-2021_03_20_084301.jpg,171.5,97.5,0.5359375,0.40625,0.040625,0.029166666666666667
1003-2021_03_20_084301.jpg,car,12,1,320,12,240,139,1,13,151,LTAdatasets/1003/annotate/1003-2021_03_20_084301.jpg,7.0,145.0,0.021875,0.6041666666666666,0.0375,0.05
1003-2021_03_20_084601.jpg,bus,49,219,320,39,240,108,5,268,147,LTAdatasets/1003/annotate/1003-2021_03_20_084601.jpg,243.5,127.5,0.7609375,0.53125,0.153125,0.1625
1003-2021_03_20_084601.jpg,car,25,278,320,22,240,126,1,303,148,LTAdatasets/1003/annotate/1003-2021_03_20_084601.jpg,290.5,137.0,0.9078125,0.5708333333333333,0.078125,0.09166666666666666
1003-2021_03_20_084601.jpg,lorry_truck,46,225,320,46,240,160,2,271,206,LTAdatasets/1003/annotate/1003-2021_03_20_084601.jpg,248.0,183.0,0.775,0.7625,0.14375,0.19166666666666668
1003-2021_03_20_084601.jpg,car,13,7,320,14,240,122,1,20,136,LTAdatasets/1003/annotate/1003-2021_03_20_084601.jpg,13.5,129.0,0.0421875,0.5375,0.040625,0.058333333333333334
1003-2021_03_20_084601.jpg,car,16,287,320,9,240,104,1,303,113,LTAdatasets/1003/annotate/1003-2021_03_20_084601.jpg,295.0,108.5,0.921875,0.45208333333333334,0.05,0.0375
1003-2021_03_20_084601.jpg,bike,8,175,320,7,240,96,4,183,103,LTAdatasets/1003/annotate/1003-2021_03_20_084601.jpg,179.0,99.5,0.559375,0.41458333333333336,0.025,0.029166666666666667
1003-2021_03_20_084601.jpg,lorry_truck,12,13,320,17,240,92,2,25,109,LTAdatasets/1003/annotate/1003-2021_03_20_084601.jpg,19.0,100.5,0.059375,0.41875,0.0375,0.07083333333333333
1003-2021_03_20_194315.jpg,car,35,250,320,36,240,201,1,285,237,LTAdatasets/1003/annotate/1003-2021_03_20_194315.jpg,267.5,219.0,0.8359375,0.9125,0.109375,0.15
1003-2021_03_20_194315.jpg,car,23,68,320,23,240,152,1,91,175,LTAdatasets/1003/annotate/1003-2021_03_20_194315.jpg,79.5,163.5,0.2484375,0.68125,0.071875,0.09583333333333334
1003-2021_03_20_194315.jpg,car,24,163,320,15,240,132,1,187,147,LTAdatasets/1003/annotate/1003-2021_03_20_194315.jpg,175.0,139.5,0.546875,0.58125,0.075,0.0625
1003-2021_03_20_194315.jpg,bike,10,223,320,17,240,121,4,233,138,LTAdatasets/1003/annotate/1003-2021_03_20_194315.jpg,228.0,129.5,0.7125,0.5395833333333333,0.03125,0.07083333333333333
1003-2021_03_20_194315.jpg,bike,9,11,320,21,240,113,4,20,134,LTAdatasets/1003/annotate/1003-2021_03_20_194315.jpg,15.5,123.5,0.0484375,0.5145833333333333,0.028125,0.0875
1003-2021_03_20_194315.jpg,car,9,181,320,11,240,90,1,190,101,LTAdatasets/1003/annotate/1003-2021_03_20_194315.jpg,185.5,95.5,0.5796875,0.39791666666666664,0.028125,0.04583333333333333
1003-2021_03_20_194315.jpg,car,10,310,320,13,240,105,1,320,118,LTAdatasets/1003/annotate/1003-2021_03_20_194315.jpg,315.0,111.5,0.984375,0.46458333333333335,0.03125,0.05416666666666667
1003-2021_03_20_201317.jpg,car,28,164,320,21,240,163,1,192,184,LTAdatasets/1003/annotate/1003-2021_03_20_201317.jpg,178.0,173.5,0.55625,0.7229166666666667,0.0875,0.0875
1003-2021_03_20_201317.jpg,car,33,225,320,27,240,178,1,258,205,LTAdatasets/1003/annotate/1003-2021_03_20_201317.jpg,241.5,191.5,0.7546875,0.7979166666666667,0.103125,0.1125
1003-2021_03_20_201317.jpg,car,16,304,320,19,240,131,1,320,150,LTAdatasets/1003/annotate/1003-2021_03_20_201317.jpg,312.0,140.5,0.975,0.5854166666666667,0.05,0.07916666666666666
1003-2021_03_20_201317.jpg,car,19,137,320,16,240,128,1,156,144,LTAdatasets/1003/annotate/1003-2021_03_20_201317.jpg,146.5,136.0,0.4578125,0.5666666666666667,0.059375,0.06666666666666667
1003-2021_03_20_201317.jpg,car,18,160,320,14,240,126,1,178,140,LTAdatasets/1003/annotate/1003-2021_03_20_201317.jpg,169.0,133.0,0.528125,0.5541666666666667,0.05625,0.058333333333333334
1003-2021_03_20_201317.jpg,car,16,139,320,11,240,113,1,155,124,LTAdatasets/1003/annotate/1003-2021_03_20_201317.jpg,147.0,118.5,0.459375,0.49375,0.05,0.04583333333333333
1003-2021_03_20_201317.jpg,car,15,179,320,9,240,105,1,194,114,LTAdatasets/1003/annotate/1003-2021_03_20_201317.jpg,186.5,109.5,0.5828125,0.45625,0.046875,0.0375
1003-2021_03_20_183112.jpg,car,24,170,320,15,240,138,1,194,153,LTAdatasets/1003/annotate/1003-2021_03_20_183112.jpg,182.0,145.5,0.56875,0.60625,0.075,0.0625
1003-2021_03_20_183112.jpg,car,23,152,320,25,240,144,1,175,169,LTAdatasets/1003/annotate/1003-2021_03_20_183112.jpg,163.5,156.5,0.5109375,0.6520833333333333,0.071875,0.10416666666666667
1003-2021_03_20_183112.jpg,car,16,149,320,12,240,118,1,165,130,LTAdatasets/1003/annotate/1003-2021_03_20_183112.jpg,157.0,124.0,0.490625,0.5166666666666667,0.05,0.05
1003-2021_03_20_183112.jpg,car,35,251,320,37,240,199,1,286,236,LTAdatasets/1003/annotate/1003-2021_03_20_183112.jpg,268.5,217.5,0.8390625,0.90625,0.109375,0.15416666666666667
1003-2021_03_20_183112.jpg,car,23,79,320,23,240,193,1,102,216,LTAdatasets/1003/annotate/1003-2021_03_20_183112.jpg,90.5,204.5,0.2828125,0.8520833333333333,0.071875,0.09583333333333334
1003-2021_03_20_183112.jpg,bike,9,214,320,15,240,118,4,223,133,LTAdatasets/1003/annotate/1003-2021_03_20_183112.jpg,218.5,125.5,0.6828125,0.5229166666666667,0.028125,0.0625
1003-2021_03_20_183112.jpg,bike,5,219,320,14,240,111,4,224,125,LTAdatasets/1003/annotate/1003-2021_03_20_183112.jpg,221.5,118.0,0.6921875,0.49166666666666664,0.015625,0.058333333333333334
1003-2021_03_20_183112.jpg,car,15,134,320,9,240,108,1,149,117,LTAdatasets/1003/annotate/1003-2021_03_20_183112.jpg,141.5,112.5,0.4421875,0.46875,0.046875,0.0375
1003-2021_03_20_183112.jpg,car,12,125,320,8,240,99,1,137,107,LTAdatasets/1003/annotate/1003-2021_03_20_183112.jpg,131.0,103.0,0.409375,0.42916666666666664,0.0375,0.03333333333333333
1003-2021_03_20_183112.jpg,van,14,121,320,11,240,110,3,135,121,LTAdatasets/1003/annotate/1003-2021_03_20_183112.jpg,128.0,115.5,0.4,0.48125,0.04375,0.04583333333333333
1003-2021_03_20_183112.jpg,lorry_truck,16,10,320,19,240,88,2,26,107,LTAdatasets/1003/annotate/1003-2021_03_20_183112.jpg,18.0,97.5,0.05625,0.40625,0.05,0.07916666666666666
1003-2021_03_20_183112.jpg,car,16,244,320,10,240,113,1,260,123,LTAdatasets/1003/annotate/1003-2021_03_20_183112.jpg,252.0,118.0,0.7875,0.49166666666666664,0.05,0.041666666666666664
1003-2021_03_20_183112.jpg,car,12,215,320,7,240,100,1,227,107,LTAdatasets/1003/annotate/1003-2021_03_20_183112.jpg,221.0,103.5,0.690625,0.43125,0.0375,0.029166666666666667
1003-2021_03_20_183112.jpg,car,11,269,320,12,240,96,1,280,108,LTAdatasets/1003/annotate/1003-2021_03_20_183112.jpg,274.5,102.0,0.8578125,0.425,0.034375,0.05
1003-2021_03_20_183112.jpg,bike,8,299,320,14,240,121,4,307,135,LTAdatasets/1003/annotate/1003-2021_03_20_183112.jpg,303.0,128.0,0.946875,0.5333333333333333,0.025,0.058333333333333334
1003-2021_03_20_214902.jpg,car,18,154,320,12,240,128,1,172,140,LTAdatasets/1003/annotate/1003-2021_03_20_214902.jpg,163.0,134.0,0.509375,0.5583333333333333,0.05625,0.05
1003-2021_03_20_214902.jpg,car,10,169,320,11,240,91,1,179,102,LTAdatasets/1003/annotate/1003-2021_03_20_214902.jpg,174.0,96.5,0.54375,0.40208333333333335,0.03125,0.04583333333333333
1003-2021_03_20_214902.jpg,car,16,129,320,16,240,117,1,145,133,LTAdatasets/1003/annotate/1003-2021_03_20_214902.jpg,137.0,125.0,0.428125,0.5208333333333334,0.05,0.06666666666666667
1003-2021_03_20_214902.jpg,lorry_truck,31,223,320,45,240,152,2,254,197,LTAdatasets/1003/annotate/1003-2021_03_20_214902.jpg,238.5,174.5,0.7453125,0.7270833333333333,0.096875,0.1875
1003-2021_03_20_214902.jpg,car,15,133,320,10,240,106,1,148,116,LTAdatasets/1003/annotate/1003-2021_03_20_214902.jpg,140.5,111.0,0.4390625,0.4625,0.046875,0.041666666666666664
1003-2021_03_20_214902.jpg,car,16,218,320,11,240,97,1,234,108,LTAdatasets/1003/annotate/1003-2021_03_20_214902.jpg,226.0,102.5,0.70625,0.4270833333333333,0.05,0.04583333333333333
1003-2021_03_20_204919.jpg,car,18,141,320,14,240,113,1,159,127,LTAdatasets/1003/annotate/1003-2021_03_20_204919.jpg,150.0,120.0,0.46875,0.5,0.05625,0.058333333333333334
1003-2021_03_20_204919.jpg,car,21,224,320,26,240,174,1,245,200,LTAdatasets/1003/annotate/1003-2021_03_20_204919.jpg,234.5,187.0,0.7328125,0.7791666666666667,0.065625,0.10833333333333334
1003-2021_03_20_204919.jpg,car,33,169,320,22,240,173,1,202,195,LTAdatasets/1003/annotate/1003-2021_03_20_204919.jpg,185.5,184.0,0.5796875,0.7666666666666667,0.103125,0.09166666666666666
1003-2021_03_20_204919.jpg,car,26,257,320,15,240,117,1,283,132,LTAdatasets/1003/annotate/1003-2021_03_20_204919.jpg,270.0,124.5,0.84375,0.51875,0.08125,0.0625
1003-2021_03_20_204919.jpg,car,15,122,320,11,240,112,1,137,123,LTAdatasets/1003/annotate/1003-2021_03_20_204919.jpg,129.5,117.5,0.4046875,0.4895833333333333,0.046875,0.04583333333333333
1003-2021_03_20_204919.jpg,car,16,68,320,15,240,128,1,84,143,LTAdatasets/1003/annotate/1003-2021_03_20_204919.jpg,76.0,135.5,0.2375,0.5645833333333333,0.05,0.0625
1003-2021_03_20_204919.jpg,car,16,62,320,11,240,112,1,78,123,LTAdatasets/1003/annotate/1003-2021_03_20_204919.jpg,70.0,117.5,0.21875,0.4895833333333333,0.05,0.04583333333333333
1003-2021_03_20_204919.jpg,lorry_truck,21,210,320,26,240,108,2,231,134,LTAdatasets/1003/annotate/1003-2021_03_20_204919.jpg,220.5,121.0,0.6890625,0.5041666666666667,0.065625,0.10833333333333334
1003-2021_03_20_204919.jpg,car,11,260,320,9,240,95,1,271,104,LTAdatasets/1003/annotate/1003-2021_03_20_204919.jpg,265.5,99.5,0.8296875,0.41458333333333336,0.034375,0.0375
1003-2021_03_20_184613.jpg,lorry_truck,22,168,320,18,240,135,2,190,153,LTAdatasets/1003/annotate/1003-2021_03_20_184613.jpg,179.0,144.0,0.559375,0.6,0.06875,0.075
1003-2021_03_20_184613.jpg,car,22,151,320,13,240,122,1,173,135,LTAdatasets/1003/annotate/1003-2021_03_20_184613.jpg,162.0,128.5,0.50625,0.5354166666666667,0.06875,0.05416666666666667
1003-2021_03_20_184613.jpg,car,30,232,320,21,240,187,1,262,208,LTAdatasets/1003/annotate/1003-2021_03_20_184613.jpg,247.0,197.5,0.771875,0.8229166666666666,0.09375,0.0875
1003-2021_03_20_184613.jpg,van,25,179,320,22,240,178,3,204,200,LTAdatasets/1003/annotate/1003-2021_03_20_184613.jpg,191.5,189.0,0.5984375,0.7875,0.078125,0.09166666666666666
1003-2021_03_20_184613.jpg,van,26,195,320,25,240,148,3,221,173,LTAdatasets/1003/annotate/1003-2021_03_20_184613.jpg,208.0,160.5,0.65,0.66875,0.08125,0.10416666666666667
1003-2021_03_20_184613.jpg,car,20,287,320,15,240,121,1,307,136,LTAdatasets/1003/annotate/1003-2021_03_20_184613.jpg,297.0,128.5,0.928125,0.5354166666666667,0.0625,0.0625
1003-2021_03_20_184613.jpg,car,15,175,320,9,240,103,1,190,112,LTAdatasets/1003/annotate/1003-2021_03_20_184613.jpg,182.5,107.5,0.5703125,0.4479166666666667,0.046875,0.0375
1003-2021_03_20_184613.jpg,car,27,141,320,18,240,145,1,168,163,LTAdatasets/1003/annotate/1003-2021_03_20_184613.jpg,154.5,154.0,0.4828125,0.6416666666666667,0.084375,0.075
1003-2021_03_20_184613.jpg,car,17,63,320,14,240,122,1,80,136,LTAdatasets/1003/annotate/1003-2021_03_20_184613.jpg,71.5,129.0,0.2234375,0.5375,0.053125,0.058333333333333334
1003-2021_03_20_184613.jpg,car,16,78,320,15,240,193,1,94,208,LTAdatasets/1003/annotate/1003-2021_03_20_184613.jpg,86.0,200.5,0.26875,0.8354166666666667,0.05,0.0625
1003-2021_03_20_184613.jpg,car,9,127,320,14,240,115,1,136,129,LTAdatasets/1003/annotate/1003-2021_03_20_184613.jpg,131.5,122.0,0.4109375,0.5083333333333333,0.028125,0.058333333333333334
1003-2021_03_20_184613.jpg,car,13,144,320,8,240,113,1,157,121,LTAdatasets/1003/annotate/1003-2021_03_20_184613.jpg,150.5,117.0,0.4703125,0.4875,0.040625,0.03333333333333333
1003-2021_03_20_184613.jpg,car,11,132,320,8,240,104,1,143,112,LTAdatasets/1003/annotate/1003-2021_03_20_184613.jpg,137.5,108.0,0.4296875,0.45,0.034375,0.03333333333333333
1003-2021_03_20_184613.jpg,car,13,211,320,12,240,95,1,224,107,LTAdatasets/1003/annotate/1003-2021_03_20_184613.jpg,217.5,101.0,0.6796875,0.42083333333333334,0.040625,0.05
1003-2021_03_20_185753.jpg,car,24,181,320,18,240,145,1,205,163,LTAdatasets/1003/annotate/1003-2021_03_20_185753.jpg,193.0,154.0,0.603125,0.6416666666666667,0.075,0.075
1003-2021_03_20_185753.jpg,car,18,223,320,14,240,124,1,241,138,LTAdatasets/1003/annotate/1003-2021_03_20_185753.jpg,232.0,131.0,0.725,0.5458333333333333,0.05625,0.058333333333333334
1003-2021_03_20_185753.jpg,car,17,72,320,15,240,145,1,89,160,LTAdatasets/1003/annotate/1003-2021_03_20_185753.jpg,80.5,152.5,0.2515625,0.6354166666666666,0.053125,0.0625
1003-2021_03_20_185753.jpg,car,21,76,320,19,240,197,1,97,216,LTAdatasets/1003/annotate/1003-2021_03_20_185753.jpg,86.5,206.5,0.2703125,0.8604166666666667,0.065625,0.07916666666666666
1003-2021_03_20_185753.jpg,lorry_truck,29,276,320,27,240,123,2,305,150,LTAdatasets/1003/annotate/1003-2021_03_20_185753.jpg,290.5,136.5,0.9078125,0.56875,0.090625,0.1125
1003-2021_03_20_185753.jpg,van,18,261,320,15,240,116,3,279,131,LTAdatasets/1003/annotate/1003-2021_03_20_185753.jpg,270.0,123.5,0.84375,0.5145833333333333,0.05625,0.0625
1003-2021_03_20_185753.jpg,car,16,244,320,11,240,107,1,260,118,LTAdatasets/1003/annotate/1003-2021_03_20_185753.jpg,252.0,112.5,0.7875,0.46875,0.05,0.04583333333333333
1003-2021_03_20_185753.jpg,lorry_truck,10,161,320,15,240,91,2,171,106,LTAdatasets/1003/annotate/1003-2021_03_20_185753.jpg,166.0,98.5,0.51875,0.41041666666666665,0.03125,0.0625
1003-2021_03_20_185753.jpg,car,11,178,320,9,240,94,1,189,103,LTAdatasets/1003/annotate/1003-2021_03_20_185753.jpg,183.5,98.5,0.5734375,0.41041666666666665,0.034375,0.0375
1003-2021_03_20_185753.jpg,car,15,271,320,11,240,103,1,286,114,LTAdatasets/1003/annotate/1003-2021_03_20_185753.jpg,278.5,108.5,0.8703125,0.45208333333333334,0.046875,0.04583333333333333
1003-2021_03_20_185753.jpg,car,12,279,320,9,240,96,1,291,105,LTAdatasets/1003/annotate/1003-2021_03_20_185753.jpg,285.0,100.5,0.890625,0.41875,0.0375,0.0375
1003-2021_03_20_185753.jpg,car,11,131,320,8,240,106,1,142,114,LTAdatasets/1003/annotate/1003-2021_03_20_185753.jpg,136.5,110.0,0.4265625,0.4583333333333333,0.034375,0.03333333333333333
1003-2021_03_20_185753.jpg,car,11,124,320,7,240,99,1,135,106,LTAdatasets/1003/annotate/1003-2021_03_20_185753.jpg,129.5,102.5,0.4046875,0.4270833333333333,0.034375,0.029166666666666667
1003-2021_03_20_185753.jpg,lorry_truck,11,265,320,6,240,96,2,276,102,LTAdatasets/1003/annotate/1003-2021_03_20_185753.jpg,270.5,99.0,0.8453125,0.4125,0.034375,0.025
1003-2021_03_20_183712.jpg,bus,33,130,320,31,240,114,5,163,145,LTAdatasets/1003/annotate/1003-2021_03_20_183712.jpg,146.5,129.5,0.4578125,0.5395833333333333,0.103125,0.12916666666666668
1003-2021_03_20_183712.jpg,car,31,180,320,22,240,146,1,211,168,LTAdatasets/1003/annotate/1003-2021_03_20_183712.jpg,195.5,157.0,0.6109375,0.6541666666666667,0.096875,0.09166666666666666
1003-2021_03_20_183712.jpg,car,26,279,320,21,240,152,1,305,173,LTAdatasets/1003/annotate/1003-2021_03_20_183712.jpg,292.0,162.5,0.9125,0.6770833333333334,0.08125,0.0875
1003-2021_03_20_183712.jpg,car,19,69,320,16,240,135,1,88,151,LTAdatasets/1003/annotate/1003-2021_03_20_183712.jpg,78.5,143.0,0.2453125,0.5958333333333333,0.059375,0.06666666666666667
1003-2021_03_20_183712.jpg,car,15,161,320,9,240,130,1,176,139,LTAdatasets/1003/annotate/1003-2021_03_20_183712.jpg,168.5,134.5,0.5265625,0.5604166666666667,0.046875,0.0375
1003-2021_03_20_183712.jpg,car,9,204,320,9,240,98,1,213,107,LTAdatasets/1003/annotate/1003-2021_03_20_183712.jpg,208.5,102.5,0.6515625,0.4270833333333333,0.028125,0.0375
1003-2021_03_20_183712.jpg,bus,29,270,320,15,240,86,5,299,101,LTAdatasets/1003/annotate/1003-2021_03_20_183712.jpg,284.5,93.5,0.8890625,0.38958333333333334,0.090625,0.0625
1003-2021_03_20_183712.jpg,van,11,127,320,10,240,99,3,138,109,LTAdatasets/1003/annotate/1003-2021_03_20_183712.jpg,132.5,104.0,0.4140625,0.43333333333333335,0.034375,0.041666666666666664
1003-2021_03_20_085141.jpg,lorry_truck,23,251,320,10,240,123,2,274,133,LTAdatasets/1003/annotate/1003-2021_03_20_085141.jpg,262.5,128.0,0.8203125,0.5333333333333333,0.071875,0.041666666666666664
1003-2021_03_20_085141.jpg,van,25,244,320,21,240,133,3,269,154,LTAdatasets/1003/annotate/1003-2021_03_20_085141.jpg,256.5,143.5,0.8015625,0.5979166666666667,0.078125,0.0875
1003-2021_03_20_085141.jpg,lorry_truck,23,133,320,27,240,117,2,156,144,LTAdatasets/1003/annotate/1003-2021_03_20_085141.jpg,144.5,130.5,0.4515625,0.54375,0.071875,0.1125
1003-2021_03_20_085141.jpg,bike,8,158,320,16,240,126,4,166,142,LTAdatasets/1003/annotate/1003-2021_03_20_085141.jpg,162.0,134.0,0.50625,0.5583333333333333,0.025,0.06666666666666667
1003-2021_03_20_085141.jpg,car,11,125,320,10,240,98,1,136,108,LTAdatasets/1003/annotate/1003-2021_03_20_085141.jpg,130.5,103.0,0.4078125,0.42916666666666664,0.034375,0.041666666666666664
1003-2021_03_20_085141.jpg,lorry_truck,21,169,320,20,240,92,2,190,112,LTAdatasets/1003/annotate/1003-2021_03_20_085141.jpg,179.5,102.0,0.5609375,0.425,0.065625,0.08333333333333333
1003-2021_03_20_085141.jpg,car,15,272,320,11,240,97,1,287,108,LTAdatasets/1003/annotate/1003-2021_03_20_085141.jpg,279.5,102.5,0.8734375,0.4270833333333333,0.046875,0.04583333333333333
1003-2021_03_20_085141.jpg,lorry_truck,14,275,320,13,240,85,2,289,98,LTAdatasets/1003/annotate/1003-2021_03_20_085141.jpg,282.0,91.5,0.88125,0.38125,0.04375,0.05416666666666667
1003-2021_03_20_085141.jpg,bus,16,151,320,20,240,77,5,167,97,LTAdatasets/1003/annotate/1003-2021_03_20_085141.jpg,159.0,87.0,0.496875,0.3625,0.05,0.08333333333333333
1003-2021_03_20_192214.jpg,bike,11,140,320,11,240,112,4,151,123,LTAdatasets/1003/annotate/1003-2021_03_20_192214.jpg,145.5,117.5,0.4546875,0.4895833333333333,0.034375,0.04583333333333333
1003-2021_03_20_192214.jpg,bike,9,125,320,13,240,98,4,134,111,LTAdatasets/1003/annotate/1003-2021_03_20_192214.jpg,129.5,104.5,0.4046875,0.4354166666666667,0.028125,0.05416666666666667
1003-2021_03_20_192214.jpg,car,17,264,320,11,240,112,1,281,123,LTAdatasets/1003/annotate/1003-2021_03_20_192214.jpg,272.5,117.5,0.8515625,0.4895833333333333,0.053125,0.04583333333333333
1003-2021_03_20_192214.jpg,car,24,272,320,14,240,124,1,296,138,LTAdatasets/1003/annotate/1003-2021_03_20_192214.jpg,284.0,131.0,0.8875,0.5458333333333333,0.075,0.058333333333333334
1003-2021_03_20_192214.jpg,car,8,122,320,9,240,111,1,130,120,LTAdatasets/1003/annotate/1003-2021_03_20_192214.jpg,126.0,115.5,0.39375,0.48125,0.025,0.0375
1003-2021_03_20_192214.jpg,car,15,273,320,11,240,97,1,288,108,LTAdatasets/1003/annotate/1003-2021_03_20_192214.jpg,280.5,102.5,0.8765625,0.4270833333333333,0.046875,0.04583333333333333
1003-2021_03_20_192214.jpg,car,12,200,320,9,240,92,1,212,101,LTAdatasets/1003/annotate/1003-2021_03_20_192214.jpg,206.0,96.5,0.64375,0.40208333333333335,0.0375,0.0375
1003-2021_03_20_192214.jpg,lorry_truck,11,160,320,8,240,88,2,171,96,LTAdatasets/1003/annotate/1003-2021_03_20_192214.jpg,165.5,92.0,0.5171875,0.38333333333333336,0.034375,0.03333333333333333
1003-2021_03_20_074918.jpg,lorry_truck,40,73,320,51,240,161,2,113,212,LTAdatasets/1003/annotate/1003-2021_03_20_074918.jpg,93.0,186.5,0.290625,0.7770833333333333,0.125,0.2125
1003-2021_03_20_074918.jpg,lorry_truck,22,298,320,40,240,145,2,320,185,LTAdatasets/1003/annotate/1003-2021_03_20_074918.jpg,309.0,165.0,0.965625,0.6875,0.06875,0.16666666666666666
1003-2021_03_20_074918.jpg,lorry_truck,12,159,320,13,240,88,2,171,101,LTAdatasets/1003/annotate/1003-2021_03_20_074918.jpg,165.0,94.5,0.515625,0.39375,0.0375,0.05416666666666667
1003-2021_03_20_074918.jpg,car,15,230,320,8,240,110,1,245,118,LTAdatasets/1003/annotate/1003-2021_03_20_074918.jpg,237.5,114.0,0.7421875,0.475,0.046875,0.03333333333333333
1003-2021_03_20_074918.jpg,car,12,243,320,7,240,108,1,255,115,LTAdatasets/1003/annotate/1003-2021_03_20_074918.jpg,249.0,111.5,0.778125,0.46458333333333335,0.0375,0.029166666666666667
1003-2021_03_20_074918.jpg,car,13,268,320,8,240,97,1,281,105,LTAdatasets/1003/annotate/1003-2021_03_20_074918.jpg,274.5,101.0,0.8578125,0.42083333333333334,0.040625,0.03333333333333333
1003-2021_03_20_074918.jpg,bus,14,138,320,13,240,79,5,152,92,LTAdatasets/1003/annotate/1003-2021_03_20_074918.jpg,145.0,85.5,0.453125,0.35625,0.04375,0.05416666666666667
1003-2021_03_20_060933.jpg,lorry_truck,28,230,320,25,240,106,2,258,131,LTAdatasets/1003/annotate/1003-2021_03_20_060933.jpg,244.0,118.5,0.7625,0.49375,0.0875,0.10416666666666667
1003-2021_03_20_060933.jpg,car,15,129,320,14,240,103,1,144,117,LTAdatasets/1003/annotate/1003-2021_03_20_060933.jpg,136.5,110.0,0.4265625,0.4583333333333333,0.046875,0.058333333333333334
1003-2021_03_20_182752.jpg,car,17,231,320,25,240,175,1,248,200,LTAdatasets/1003/annotate/1003-2021_03_20_182752.jpg,239.5,187.5,0.7484375,0.78125,0.053125,0.10416666666666667
1003-2021_03_20_182752.jpg,car,21,137,320,17,240,130,1,158,147,LTAdatasets/1003/annotate/1003-2021_03_20_182752.jpg,147.5,138.5,0.4609375,0.5770833333333333,0.065625,0.07083333333333333
1003-2021_03_20_182752.jpg,lorry_truck,20,229,320,15,240,123,2,249,138,LTAdatasets/1003/annotate/1003-2021_03_20_182752.jpg,239.0,130.5,0.746875,0.54375,0.0625,0.0625
1003-2021_03_20_182752.jpg,van,13,160,320,10,240,94,3,173,104,LTAdatasets/1003/annotate/1003-2021_03_20_182752.jpg,166.5,99.0,0.5203125,0.4125,0.040625,0.041666666666666664
1003-2021_03_20_182752.jpg,lorry_truck,16,229,320,9,240,112,2,245,121,LTAdatasets/1003/annotate/1003-2021_03_20_182752.jpg,237.0,116.5,0.740625,0.48541666666666666,0.05,0.0375
1003-2021_03_20_182752.jpg,car,21,253,320,12,240,117,1,274,129,LTAdatasets/1003/annotate/1003-2021_03_20_182752.jpg,263.5,123.0,0.8234375,0.5125,0.065625,0.05
1003-2021_03_20_182752.jpg,car,16,267,320,7,240,101,1,283,108,LTAdatasets/1003/annotate/1003-2021_03_20_182752.jpg,275.0,104.5,0.859375,0.4354166666666667,0.05,0.029166666666666667
1003-2021_03_20_182752.jpg,car,10,285,320,7,240,100,1,295,107,LTAdatasets/1003/annotate/1003-2021_03_20_182752.jpg,290.0,103.5,0.90625,0.43125,0.03125,0.029166666666666667
1003-2021_03_20_182752.jpg,car,10,123,320,9,240,96,1,133,105,LTAdatasets/1003/annotate/1003-2021_03_20_182752.jpg,128.0,100.5,0.4,0.41875,0.03125,0.0375
1003-2021_03_20_182752.jpg,car,11,67,320,12,240,107,1,78,119,LTAdatasets/1003/annotate/1003-2021_03_20_182752.jpg,72.5,113.0,0.2265625,0.4708333333333333,0.034375,0.05
1003-2021_03_20_182752.jpg,car,15,8,320,17,240,119,1,23,136,LTAdatasets/1003/annotate/1003-2021_03_20_182752.jpg,15.5,127.5,0.0484375,0.53125,0.046875,0.07083333333333333
1003-2021_03_20_203658.jpg,car,17,283,320,15,240,125,1,300,140,LTAdatasets/1003/annotate/1003-2021_03_20_203658.jpg,291.5,132.5,0.9109375,0.5520833333333334,0.053125,0.0625
1003-2021_03_20_203658.jpg,car,17,128,320,13,240,123,1,145,136,LTAdatasets/1003/annotate/1003-2021_03_20_203658.jpg,136.5,129.5,0.4265625,0.5395833333333333,0.053125,0.05416666666666667
1003-2021_03_20_203658.jpg,car,13,123,320,11,240,104,1,136,115,LTAdatasets/1003/annotate/1003-2021_03_20_203658.jpg,129.5,109.5,0.4046875,0.45625,0.040625,0.04583333333333333
1003-2021_03_20_203658.jpg,car,11,67,320,14,240,107,1,78,121,LTAdatasets/1003/annotate/1003-2021_03_20_203658.jpg,72.5,114.0,0.2265625,0.475,0.034375,0.058333333333333334
1003-2021_03_20_203658.jpg,car,23,199,320,14,240,161,1,222,175,LTAdatasets/1003/annotate/1003-2021_03_20_203658.jpg,210.5,168.0,0.6578125,0.7,0.071875,0.058333333333333334
1003-2021_03_20_203658.jpg,car,10,171,320,7,240,87,1,181,94,LTAdatasets/1003/annotate/1003-2021_03_20_203658.jpg,176.0,90.5,0.55,0.3770833333333333,0.03125,0.029166666666666667
1003-2021_03_20_203658.jpg,lorry_truck,15,302,320,34,240,132,2,317,166,LTAdatasets/1003/annotate/1003-2021_03_20_203658.jpg,309.5,149.0,0.9671875,0.6208333333333333,0.046875,0.14166666666666666
1003-2021_03_20_083340.jpg,lorry_truck,29,277,320,24,240,146,2,306,170,LTAdatasets/1003/annotate/1003-2021_03_20_083340.jpg,291.5,158.0,0.9109375,0.6583333333333333,0.090625,0.1
1003-2021_03_20_083340.jpg,car,21,297,320,14,240,122,1,318,136,LTAdatasets/1003/annotate/1003-2021_03_20_083340.jpg,307.5,129.0,0.9609375,0.5375,0.065625,0.058333333333333334
1003-2021_03_20_083340.jpg,lorry_truck,29,146,320,22,240,113,2,175,135,LTAdatasets/1003/annotate/1003-2021_03_20_083340.jpg,160.5,124.0,0.5015625,0.5166666666666667,0.090625,0.09166666666666666
1003-2021_03_20_083340.jpg,car,24,232,320,17,240,188,1,256,205,LTAdatasets/1003/annotate/1003-2021_03_20_083340.jpg,244.0,196.5,0.7625,0.81875,0.075,0.07083333333333333
1003-2021_03_20_083340.jpg,car,15,63,320,12,240,113,1,78,125,LTAdatasets/1003/annotate/1003-2021_03_20_083340.jpg,70.5,119.0,0.2203125,0.49583333333333335,0.046875,0.05
1003-2021_03_20_083340.jpg,lorry_truck,19,9,320,16,240,116,2,28,132,LTAdatasets/1003/annotate/1003-2021_03_20_083340.jpg,18.5,124.0,0.0578125,0.5166666666666667,0.059375,0.06666666666666667
1003-2021_03_20_083340.jpg,car,11,21,320,9,240,106,1,32,115,LTAdatasets/1003/annotate/1003-2021_03_20_083340.jpg,26.5,110.5,0.0828125,0.46041666666666664,0.034375,0.0375
1003-2021_03_20_083340.jpg,lorry_truck,14,169,320,10,240,93,2,183,103,LTAdatasets/1003/annotate/1003-2021_03_20_083340.jpg,176.0,98.0,0.55,0.4083333333333333,0.04375,0.041666666666666664
1003-2021_03_20_083340.jpg,lorry_truck,15,259,320,9,240,100,2,274,109,LTAdatasets/1003/annotate/1003-2021_03_20_083340.jpg,266.5,104.5,0.8328125,0.4354166666666667,0.046875,0.0375
1003-2021_03_20_091903.jpg,car,28,146,320,21,240,146,1,174,167,LTAdatasets/1003/annotate/1003-2021_03_20_091903.jpg,160.0,156.5,0.5,0.6520833333333333,0.0875,0.0875
1003-2021_03_20_091903.jpg,car,16,127,320,15,240,123,1,143,138,LTAdatasets/1003/annotate/1003-2021_03_20_091903.jpg,135.0,130.5,0.421875,0.54375,0.05,0.0625
1003-2021_03_20_091903.jpg,car,32,189,320,14,240,159,1,221,173,LTAdatasets/1003/annotate/1003-2021_03_20_091903.jpg,205.0,166.0,0.640625,0.6916666666666667,0.1,0.058333333333333334
1003-2021_03_20_091903.jpg,van,30,236,320,29,240,174,3,266,203,LTAdatasets/1003/annotate/1003-2021_03_20_091903.jpg,251.0,188.5,0.784375,0.7854166666666667,0.09375,0.12083333333333333
1003-2021_03_20_091903.jpg,car,24,278,320,21,240,150,1,302,171,LTAdatasets/1003/annotate/1003-2021_03_20_091903.jpg,290.0,160.5,0.90625,0.66875,0.075,0.0875
1003-2021_03_20_091903.jpg,lorry_truck,35,277,320,23,240,128,2,312,151,LTAdatasets/1003/annotate/1003-2021_03_20_091903.jpg,294.5,139.5,0.9203125,0.58125,0.109375,0.09583333333333334
1003-2021_03_20_091903.jpg,car,15,262,320,12,240,119,1,277,131,LTAdatasets/1003/annotate/1003-2021_03_20_091903.jpg,269.5,125.0,0.8421875,0.5208333333333334,0.046875,0.05
1003-2021_03_20_091903.jpg,car,18,263,320,7,240,113,1,281,120,LTAdatasets/1003/annotate/1003-2021_03_20_091903.jpg,272.0,116.5,0.85,0.48541666666666666,0.05625,0.029166666666666667
1003-2021_03_20_091903.jpg,van,16,168,320,20,240,130,3,184,150,LTAdatasets/1003/annotate/1003-2021_03_20_091903.jpg,176.0,140.0,0.55,0.5833333333333334,0.05,0.08333333333333333
1003-2021_03_20_091903.jpg,van,11,270,320,10,240,93,3,281,103,LTAdatasets/1003/annotate/1003-2021_03_20_091903.jpg,275.5,98.0,0.8609375,0.4083333333333333,0.034375,0.041666666666666664
1003-2021_03_20_091903.jpg,car,13,152,320,10,240,121,1,165,131,LTAdatasets/1003/annotate/1003-2021_03_20_091903.jpg,158.5,126.0,0.4953125,0.525,0.040625,0.041666666666666664
1003-2021_03_20_091903.jpg,car,11,137,320,8,240,113,1,148,121,LTAdatasets/1003/annotate/1003-2021_03_20_091903.jpg,142.5,117.0,0.4453125,0.4875,0.034375,0.03333333333333333
1003-2021_03_20_091903.jpg,car,11,135,320,11,240,104,1,146,115,LTAdatasets/1003/annotate/1003-2021_03_20_091903.jpg,140.5,109.5,0.4390625,0.45625,0.034375,0.04583333333333333
1003-2021_03_20_091903.jpg,car,12,124,320,7,240,101,1,136,108,LTAdatasets/1003/annotate/1003-2021_03_20_091903.jpg,130.0,104.5,0.40625,0.4354166666666667,0.0375,0.029166666666666667
1003-2021_03_20_091903.jpg,car,16,213,320,10,240,103,1,229,113,LTAdatasets/1003/annotate/1003-2021_03_20_091903.jpg,221.0,108.0,0.690625,0.45,0.05,0.041666666666666664
1003-2021_03_20_091903.jpg,car,12,205,320,9,240,95,1,217,104,LTAdatasets/1003/annotate/1003-2021_03_20_091903.jpg,211.0,99.5,0.659375,0.41458333333333336,0.0375,0.0375
1003-2021_03_20_091903.jpg,car,10,287,320,8,240,103,1,297,111,LTAdatasets/1003/annotate/1003-2021_03_20_091903.jpg,292.0,107.0,0.9125,0.44583333333333336,0.03125,0.03333333333333333
1003-2021_03_20_081319.jpg,car,22,73,320,24,240,175,1,95,199,LTAdatasets/1003/annotate/1003-2021_03_20_081319.jpg,84.0,187.0,0.2625,0.7791666666666667,0.06875,0.1
1003-2021_03_20_081319.jpg,lorry_truck,14,75,320,23,240,124,2,89,147,LTAdatasets/1003/annotate/1003-2021_03_20_081319.jpg,82.0,135.5,0.25625,0.5645833333333333,0.04375,0.09583333333333334
1003-2021_03_20_081319.jpg,car,11,65,320,12,240,115,1,76,127,LTAdatasets/1003/annotate/1003-2021_03_20_081319.jpg,70.5,121.0,0.2203125,0.5041666666666667,0.034375,0.05
1003-2021_03_20_081319.jpg,car,13,130,320,15,240,106,1,143,121,LTAdatasets/1003/annotate/1003-2021_03_20_081319.jpg,136.5,113.5,0.4265625,0.47291666666666665,0.040625,0.0625
1003-2021_03_20_081319.jpg,car,12,173,320,11,240,103,1,185,114,LTAdatasets/1003/annotate/1003-2021_03_20_081319.jpg,179.0,108.5,0.559375,0.45208333333333334,0.0375,0.04583333333333333
1003-2021_03_20_081319.jpg,car,18,259,320,11,240,112,1,277,123,LTAdatasets/1003/annotate/1003-2021_03_20_081319.jpg,268.0,117.5,0.8375,0.4895833333333333,0.05625,0.04583333333333333
1003-2021_03_20_081319.jpg,car,12,269,320,8,240,96,1,281,104,LTAdatasets/1003/annotate/1003-2021_03_20_081319.jpg,275.0,100.0,0.859375,0.4166666666666667,0.0375,0.03333333333333333
1003-2021_03_20_200116.jpg,car,20,215,320,22,240,168,1,235,190,LTAdatasets/1003/annotate/1003-2021_03_20_200116.jpg,225.0,179.0,0.703125,0.7458333333333333,0.0625,0.09166666666666666
1003-2021_03_20_200116.jpg,car,20,147,320,18,240,135,1,167,153,LTAdatasets/1003/annotate/1003-2021_03_20_200116.jpg,157.0,144.0,0.490625,0.6,0.0625,0.075
1003-2021_03_20_200116.jpg,lorry_truck,32,288,320,37,240,127,2,320,164,LTAdatasets/1003/annotate/1003-2021_03_20_200116.jpg,304.0,145.5,0.95,0.60625,0.1,0.15416666666666667
1003-2021_03_20_200116.jpg,car,13,2,320,13,240,107,1,15,120,LTAdatasets/1003/annotate/1003-2021_03_20_200116.jpg,8.5,113.5,0.0265625,0.47291666666666665,0.040625,0.05416666666666667
1003-2021_03_20_200116.jpg,car,15,292,320,12,240,108,1,307,120,LTAdatasets/1003/annotate/1003-2021_03_20_200116.jpg,299.5,114.0,0.9359375,0.475,0.046875,0.05
1003-2021_03_20_200116.jpg,car,14,304,320,9,240,101,1,318,110,LTAdatasets/1003/annotate/1003-2021_03_20_200116.jpg,311.0,105.5,0.971875,0.4395833333333333,0.04375,0.0375
1003-2021_03_20_065155.jpg,car,21,215,320,14,240,169,1,236,183,LTAdatasets/1003/annotate/1003-2021_03_20_065155.jpg,225.5,176.0,0.7046875,0.7333333333333333,0.065625,0.058333333333333334
1003-2021_03_20_065155.jpg,car,12,124,320,9,240,97,1,136,106,LTAdatasets/1003/annotate/1003-2021_03_20_065155.jpg,130.0,101.5,0.40625,0.42291666666666666,0.0375,0.0375
1003-2021_03_20_065155.jpg,car,10,205,320,6,240,96,1,215,102,LTAdatasets/1003/annotate/1003-2021_03_20_065155.jpg,210.0,99.0,0.65625,0.4125,0.03125,0.025
1003-2021_03_20_065155.jpg,car,7,182,320,7,240,93,1,189,100,LTAdatasets/1003/annotate/1003-2021_03_20_065155.jpg,185.5,96.5,0.5796875,0.40208333333333335,0.021875,0.029166666666666667
1003-2021_03_20_064254.jpg,van,19,212,320,12,240,106,3,231,118,LTAdatasets/1003/annotate/1003-2021_03_20_064254.jpg,221.5,112.0,0.6921875,0.4666666666666667,0.059375,0.05
1003-2021_03_20_064254.jpg,lorry_truck,23,282,320,23,240,121,2,305,144,LTAdatasets/1003/annotate/1003-2021_03_20_064254.jpg,293.5,132.5,0.9171875,0.5520833333333334,0.071875,0.09583333333333334
1003-2021_03_20_064254.jpg,car,14,260,320,12,240,95,1,274,107,LTAdatasets/1003/annotate/1003-2021_03_20_064254.jpg,267.0,101.0,0.834375,0.42083333333333334,0.04375,0.05
1003-2021_03_20_064254.jpg,car,15,294,320,9,240,105,1,309,114,LTAdatasets/1003/annotate/1003-2021_03_20_064254.jpg,301.5,109.5,0.9421875,0.45625,0.046875,0.0375
1003-2021_03_20_062754.jpg,car,19,267,320,13,240,123,1,286,136,LTAdatasets/1003/annotate/1003-2021_03_20_062754.jpg,276.5,129.5,0.8640625,0.5395833333333333,0.059375,0.05416666666666667
1003-2021_03_20_062754.jpg,car,16,221,320,8,240,107,1,237,115,LTAdatasets/1003/annotate/1003-2021_03_20_062754.jpg,229.0,111.0,0.715625,0.4625,0.05,0.03333333333333333
1003-2021_03_20_061313.jpg,bus,18,174,320,17,240,87,5,192,104,LTAdatasets/1003/annotate/1003-2021_03_20_061313.jpg,183.0,95.5,0.571875,0.39791666666666664,0.05625,0.07083333333333333
1003-2021_03_20_061313.jpg,car,7,164,320,5,240,85,1,171,90,LTAdatasets/1003/annotate/1003-2021_03_20_061313.jpg,167.5,87.5,0.5234375,0.3645833333333333,0.021875,0.020833333333333332
1003-2021_03_20_094904.jpg,van,22,147,320,17,240,121,3,169,138,LTAdatasets/1003/annotate/1003-2021_03_20_094904.jpg,158.0,129.5,0.49375,0.5395833333333333,0.06875,0.07083333333333333
1003-2021_03_20_094904.jpg,car,21,177,320,16,240,143,1,198,159,LTAdatasets/1003/annotate/1003-2021_03_20_094904.jpg,187.5,151.0,0.5859375,0.6291666666666667,0.065625,0.06666666666666667
1003-2021_03_20_094904.jpg,car,24,148,320,19,240,150,1,172,169,LTAdatasets/1003/annotate/1003-2021_03_20_094904.jpg,160.0,159.5,0.5,0.6645833333333333,0.075,0.07916666666666666
1003-2021_03_20_094904.jpg,lorry_truck,19,241,320,18,240,119,2,260,137,LTAdatasets/1003/annotate/1003-2021_03_20_094904.jpg,250.5,128.0,0.7828125,0.5333333333333333,0.059375,0.075
1003-2021_03_20_094904.jpg,car,15,219,320,12,240,106,1,234,118,LTAdatasets/1003/annotate/1003-2021_03_20_094904.jpg,226.5,112.0,0.7078125,0.4666666666666667,0.046875,0.05
1003-2021_03_20_094904.jpg,van,22,77,320,33,240,177,3,99,210,LTAdatasets/1003/annotate/1003-2021_03_20_094904.jpg,88.0,193.5,0.275,0.80625,0.06875,0.1375
1003-2021_03_20_094904.jpg,lorry_truck,48,272,320,26,240,214,2,320,240,LTAdatasets/1003/annotate/1003-2021_03_20_094904.jpg,296.0,227.0,0.925,0.9458333333333333,0.15,0.10833333333333334
1003-2021_03_20_094904.jpg,car,9,123,320,12,240,117,1,132,129,LTAdatasets/1003/annotate/1003-2021_03_20_094904.jpg,127.5,123.0,0.3984375,0.5125,0.028125,0.05
1003-2021_03_20_094904.jpg,car,8,140,320,9,240,114,1,148,123,LTAdatasets/1003/annotate/1003-2021_03_20_094904.jpg,144.0,118.5,0.45,0.49375,0.025,0.0375
1003-2021_03_20_094904.jpg,car,11,128,320,8,240,105,1,139,113,LTAdatasets/1003/annotate/1003-2021_03_20_094904.jpg,133.5,109.0,0.4171875,0.45416666666666666,0.034375,0.03333333333333333
1003-2021_03_20_094904.jpg,car,11,175,320,6,240,91,1,186,97,LTAdatasets/1003/annotate/1003-2021_03_20_094904.jpg,180.5,94.0,0.5640625,0.39166666666666666,0.034375,0.025
1003-2021_03_20_094904.jpg,car,13,268,320,10,240,95,1,281,105,LTAdatasets/1003/annotate/1003-2021_03_20_094904.jpg,274.5,100.0,0.8578125,0.4166666666666667,0.040625,0.041666666666666664
1003-2021_03_20_181851.jpg,car,18,148,320,13,240,117,1,166,130,LTAdatasets/1003/annotate/1003-2021_03_20_181851.jpg,157.0,123.5,0.490625,0.5145833333333333,0.05625,0.05416666666666667
1003-2021_03_20_181851.jpg,car,25,167,320,18,240,135,1,192,153,LTAdatasets/1003/annotate/1003-2021_03_20_181851.jpg,179.5,144.0,0.5609375,0.6,0.078125,0.075
1003-2021_03_20_181851.jpg,car,16,122,320,13,240,116,1,138,129,LTAdatasets/1003/annotate/1003-2021_03_20_181851.jpg,130.0,122.5,0.40625,0.5104166666666666,0.05,0.05416666666666667
1003-2021_03_20_181851.jpg,car,39,248,320,38,240,195,1,287,233,LTAdatasets/1003/annotate/1003-2021_03_20_181851.jpg,267.5,214.0,0.8359375,0.8916666666666667,0.121875,0.15833333333333333
1003-2021_03_20_181851.jpg,car,17,240,320,11,240,105,1,257,116,LTAdatasets/1003/annotate/1003-2021_03_20_181851.jpg,248.5,110.5,0.7765625,0.46041666666666664,0.053125,0.04583333333333333
1003-2021_03_20_181851.jpg,van,22,266,320,14,240,99,3,288,113,LTAdatasets/1003/annotate/1003-2021_03_20_181851.jpg,277.0,106.0,0.865625,0.44166666666666665,0.06875,0.058333333333333334
1003-2021_03_20_181851.jpg,bike,5,139,320,15,240,115,4,144,130,LTAdatasets/1003/annotate/1003-2021_03_20_181851.jpg,141.5,122.5,0.4421875,0.5104166666666666,0.015625,0.0625
1003-2021_03_20_213701.jpg,car,24,80,320,21,240,194,1,104,215,LTAdatasets/1003/annotate/1003-2021_03_20_213701.jpg,92.0,204.5,0.2875,0.8520833333333333,0.075,0.0875
1003-2021_03_20_213701.jpg,car,29,224,320,13,240,193,1,253,206,LTAdatasets/1003/annotate/1003-2021_03_20_213701.jpg,238.5,199.5,0.7453125,0.83125,0.090625,0.05416666666666667
1003-2021_03_20_213701.jpg,car,22,251,320,15,240,108,1,273,123,LTAdatasets/1003/annotate/1003-2021_03_20_213701.jpg,262.0,115.5,0.81875,0.48125,0.06875,0.0625
1003-2021_03_20_213701.jpg,car,15,123,320,8,240,97,1,138,105,LTAdatasets/1003/annotate/1003-2021_03_20_213701.jpg,130.5,101.0,0.4078125,0.42083333333333334,0.046875,0.03333333333333333
1003-2021_03_20_213701.jpg,car,14,7,320,13,240,120,1,21,133,LTAdatasets/1003/annotate/1003-2021_03_20_213701.jpg,14.0,126.5,0.04375,0.5270833333333333,0.04375,0.05416666666666667
1003-2021_03_20_213701.jpg,lorry_truck,6,24,320,7,240,93,2,30,100,LTAdatasets/1003/annotate/1003-2021_03_20_213701.jpg,27.0,96.5,0.084375,0.40208333333333335,0.01875,0.029166666666666667
1003-2021_03_20_213701.jpg,car,11,168,320,6,240,91,1,179,97,LTAdatasets/1003/annotate/1003-2021_03_20_213701.jpg,173.5,94.0,0.5421875,0.39166666666666666,0.034375,0.025
1003-2021_03_20_213701.jpg,car,10,276,320,11,240,98,1,286,109,LTAdatasets/1003/annotate/1003-2021_03_20_213701.jpg,281.0,103.5,0.878125,0.43125,0.03125,0.04583333333333333
1003-2021_03_20_213701.jpg,car,15,292,320,8,240,101,1,307,109,LTAdatasets/1003/annotate/1003-2021_03_20_213701.jpg,299.5,105.0,0.9359375,0.4375,0.046875,0.03333333333333333
1003-2021_03_20_100405.jpg,car,16,133,320,14,240,127,1,149,141,LTAdatasets/1003/annotate/1003-2021_03_20_100405.jpg,141.0,134.0,0.440625,0.5583333333333333,0.05,0.058333333333333334
1003-2021_03_20_100405.jpg,car,16,60,320,12,240,126,1,76,138,LTAdatasets/1003/annotate/1003-2021_03_20_100405.jpg,68.0,132.0,0.2125,0.55,0.05,0.05
1003-2021_03_20_100405.jpg,car,14,6,320,14,240,127,1,20,141,LTAdatasets/1003/annotate/1003-2021_03_20_100405.jpg,13.0,134.0,0.040625,0.5583333333333333,0.04375,0.058333333333333334
1003-2021_03_20_100405.jpg,car,21,293,320,16,240,131,1,314,147,LTAdatasets/1003/annotate/1003-2021_03_20_100405.jpg,303.5,139.0,0.9484375,0.5791666666666667,0.065625,0.06666666666666667
1003-2021_03_20_100405.jpg,car,14,193,320,10,240,115,1,207,125,LTAdatasets/1003/annotate/1003-2021_03_20_100405.jpg,200.0,120.0,0.625,0.5,0.04375,0.041666666666666664
1003-2021_03_20_100405.jpg,lorry_truck,14,206,320,15,240,107,2,220,122,LTAdatasets/1003/annotate/1003-2021_03_20_100405.jpg,213.0,114.5,0.665625,0.47708333333333336,0.04375,0.0625
1003-2021_03_20_190413.jpg,car,14,254,320,10,240,92,1,268,102,LTAdatasets/1003/annotate/1003-2021_03_20_190413.jpg,261.0,97.0,0.815625,0.4041666666666667,0.04375,0.041666666666666664
1003-2021_03_20_190413.jpg,car,27,176,320,17,240,149,1,203,166,LTAdatasets/1003/annotate/1003-2021_03_20_190413.jpg,189.5,157.5,0.5921875,0.65625,0.084375,0.07083333333333333
1003-2021_03_20_190413.jpg,car,18,134,320,14,240,129,1,152,143,LTAdatasets/1003/annotate/1003-2021_03_20_190413.jpg,143.0,136.0,0.446875,0.5666666666666667,0.05625,0.058333333333333334
1003-2021_03_20_190413.jpg,car,23,250,320,23,240,198,1,273,221,LTAdatasets/1003/annotate/1003-2021_03_20_190413.jpg,261.5,209.5,0.8171875,0.8729166666666667,0.071875,0.09583333333333334
1003-2021_03_20_190413.jpg,car,20,297,320,13,240,131,1,317,144,LTAdatasets/1003/annotate/1003-2021_03_20_190413.jpg,307.0,137.5,0.959375,0.5729166666666666,0.0625,0.05416666666666667
1003-2021_03_20_190413.jpg,lorry_truck,18,151,320,17,240,112,2,169,129,LTAdatasets/1003/annotate/1003-2021_03_20_190413.jpg,160.0,120.5,0.5,0.5020833333333333,0.05625,0.07083333333333333
1003-2021_03_20_190413.jpg,car,15,65,320,15,240,117,1,80,132,LTAdatasets/1003/annotate/1003-2021_03_20_190413.jpg,72.5,124.5,0.2265625,0.51875,0.046875,0.0625
1003-2021_03_20_190413.jpg,car,14,134,320,9,240,108,1,148,117,LTAdatasets/1003/annotate/1003-2021_03_20_190413.jpg,141.0,112.5,0.440625,0.46875,0.04375,0.0375
1003-2021_03_20_190413.jpg,car,13,175,320,10,240,99,1,188,109,LTAdatasets/1003/annotate/1003-2021_03_20_190413.jpg,181.5,104.0,0.5671875,0.43333333333333335,0.040625,0.041666666666666664
1003-2021_03_20_190413.jpg,car,17,226,320,8,240,102,1,243,110,LTAdatasets/1003/annotate/1003-2021_03_20_190413.jpg,234.5,106.0,0.7328125,0.44166666666666665,0.053125,0.03333333333333333
1003-2021_03_20_190413.jpg,car,11,206,320,10,240,96,1,217,106,LTAdatasets/1003/annotate/1003-2021_03_20_190413.jpg,211.5,101.0,0.6609375,0.42083333333333334,0.034375,0.041666666666666664
1003-2021_03_20_192735.jpg,car,18,254,320,14,240,115,1,272,129,LTAdatasets/1003/annotate/1003-2021_03_20_192735.jpg,263.0,122.0,0.821875,0.5083333333333333,0.05625,0.058333333333333334
1003-2021_03_20_192735.jpg,car,18,284,320,9,240,120,1,302,129,LTAdatasets/1003/annotate/1003-2021_03_20_192735.jpg,293.0,124.5,0.915625,0.51875,0.05625,0.0375
1003-2021_03_20_192735.jpg,car,16,214,320,12,240,111,1,230,123,LTAdatasets/1003/annotate/1003-2021_03_20_192735.jpg,222.0,117.0,0.69375,0.4875,0.05,0.05
1003-2021_03_20_192735.jpg,car,31,184,320,17,240,157,1,215,174,LTAdatasets/1003/annotate/1003-2021_03_20_192735.jpg,199.5,165.5,0.6234375,0.6895833333333333,0.096875,0.07083333333333333
1003-2021_03_20_192735.jpg,car,13,126,320,10,240,101,1,139,111,LTAdatasets/1003/annotate/1003-2021_03_20_192735.jpg,132.5,106.0,0.4140625,0.44166666666666665,0.040625,0.041666666666666664
1003-2021_03_20_192735.jpg,car,17,212,320,9,240,101,1,229,110,LTAdatasets/1003/annotate/1003-2021_03_20_192735.jpg,220.5,105.5,0.6890625,0.4395833333333333,0.053125,0.0375
1003-2021_03_20_192735.jpg,car,12,163,320,8,240,95,1,175,103,LTAdatasets/1003/annotate/1003-2021_03_20_192735.jpg,169.0,99.0,0.528125,0.4125,0.0375,0.03333333333333333
1003-2021_03_20_192735.jpg,car,14,267,320,10,240,101,1,281,111,LTAdatasets/1003/annotate/1003-2021_03_20_192735.jpg,274.0,106.0,0.85625,0.44166666666666665,0.04375,0.041666666666666664
1003-2021_03_20_192735.jpg,car,21,299,320,10,240,105,1,320,115,LTAdatasets/1003/annotate/1003-2021_03_20_192735.jpg,309.5,110.0,0.9671875,0.4583333333333333,0.065625,0.041666666666666664
1003-2021_03_20_192735.jpg,bike,8,111,320,11,240,103,4,119,114,LTAdatasets/1003/annotate/1003-2021_03_20_192735.jpg,115.0,108.5,0.359375,0.45208333333333334,0.025,0.04583333333333333
1003-2021_03_20_192735.jpg,lorry_truck,6,13,320,9,240,101,2,19,110,LTAdatasets/1003/annotate/1003-2021_03_20_192735.jpg,16.0,105.5,0.05,0.4395833333333333,0.01875,0.0375
1003-2021_03_20_215802.jpg,car,16,67,320,13,240,128,1,83,141,LTAdatasets/1003/annotate/1003-2021_03_20_215802.jpg,75.0,134.5,0.234375,0.5604166666666667,0.05,0.05416666666666667
1003-2021_03_20_215802.jpg,lorry_truck,45,260,320,34,240,120,2,305,154,LTAdatasets/1003/annotate/1003-2021_03_20_215802.jpg,282.5,137.0,0.8828125,0.5708333333333333,0.140625,0.14166666666666666
1003-2021_03_20_215802.jpg,van,12,123,320,9,240,97,3,135,106,LTAdatasets/1003/annotate/1003-2021_03_20_215802.jpg,129.0,101.5,0.403125,0.42291666666666666,0.0375,0.0375
1003-2021_03_20_215802.jpg,car,17,235,320,14,240,103,1,252,117,LTAdatasets/1003/annotate/1003-2021_03_20_215802.jpg,243.5,110.0,0.7609375,0.4583333333333333,0.053125,0.058333333333333334
1003-2021_03_20_215802.jpg,car,12,105,320,7,240,98,1,117,105,LTAdatasets/1003/annotate/1003-2021_03_20_215802.jpg,111.0,101.5,0.346875,0.42291666666666666,0.0375,0.029166666666666667
1003-2021_03_20_074318.jpg,car,19,282,320,12,240,125,1,301,137,LTAdatasets/1003/annotate/1003-2021_03_20_074318.jpg,291.5,131.0,0.9109375,0.5458333333333333,0.059375,0.05
1003-2021_03_20_074318.jpg,van,10,200,320,10,240,96,3,210,106,LTAdatasets/1003/annotate/1003-2021_03_20_074318.jpg,205.0,101.0,0.640625,0.42083333333333334,0.03125,0.041666666666666664
1003-2021_03_20_074318.jpg,lorry_truck,27,226,320,35,240,171,2,253,206,LTAdatasets/1003/annotate/1003-2021_03_20_074318.jpg,239.5,188.5,0.7484375,0.7854166666666667,0.084375,0.14583333333333334
1003-2021_03_20_074318.jpg,car,14,258,320,11,240,96,1,272,107,LTAdatasets/1003/annotate/1003-2021_03_20_074318.jpg,265.0,101.5,0.828125,0.42291666666666666,0.04375,0.04583333333333333
1003-2021_03_20_074318.jpg,car,13,1,320,15,240,106,1,14,121,LTAdatasets/1003/annotate/1003-2021_03_20_074318.jpg,7.5,113.5,0.0234375,0.47291666666666665,0.040625,0.0625
1003-2021_03_20_091302.jpg,van,18,225,320,10,240,108,3,243,118,LTAdatasets/1003/annotate/1003-2021_03_20_091302.jpg,234.0,113.0,0.73125,0.4708333333333333,0.05625,0.041666666666666664
1003-2021_03_20_091302.jpg,car,29,191,320,10,240,161,1,220,171,LTAdatasets/1003/annotate/1003-2021_03_20_091302.jpg,205.5,166.0,0.6421875,0.6916666666666667,0.090625,0.041666666666666664
1003-2021_03_20_091302.jpg,van,23,262,320,20,240,126,3,285,146,LTAdatasets/1003/annotate/1003-2021_03_20_091302.jpg,273.5,136.0,0.8546875,0.5666666666666667,0.071875,0.08333333333333333
1003-2021_03_20_091302.jpg,van,21,157,320,18,240,122,3,178,140,LTAdatasets/1003/annotate/1003-2021_03_20_091302.jpg,167.5,131.0,0.5234375,0.5458333333333333,0.065625,0.075
1003-2021_03_20_091302.jpg,car,18,73,320,21,240,161,1,91,182,LTAdatasets/1003/annotate/1003-2021_03_20_091302.jpg,82.0,171.5,0.25625,0.7145833333333333,0.05625,0.0875
1003-2021_03_20_091302.jpg,car,10,125,320,9,240,114,1,135,123,LTAdatasets/1003/annotate/1003-2021_03_20_091302.jpg,130.0,118.5,0.40625,0.49375,0.03125,0.0375
1003-2021_03_20_091302.jpg,lorry_truck,15,179,320,10,240,95,2,194,105,LTAdatasets/1003/annotate/1003-2021_03_20_091302.jpg,186.5,100.0,0.5828125,0.4166666666666667,0.046875,0.041666666666666664
1003-2021_03_20_091302.jpg,car,14,208,320,7,240,98,1,222,105,LTAdatasets/1003/annotate/1003-2021_03_20_091302.jpg,215.0,101.5,0.671875,0.42291666666666666,0.04375,0.029166666666666667
1003-2021_03_20_091302.jpg,car,13,127,320,10,240,103,1,140,113,LTAdatasets/1003/annotate/1003-2021_03_20_091302.jpg,133.5,108.0,0.4171875,0.45,0.040625,0.041666666666666664
1003-2021_03_20_091302.jpg,car,9,158,320,7,240,93,1,167,100,LTAdatasets/1003/annotate/1003-2021_03_20_091302.jpg,162.5,96.5,0.5078125,0.40208333333333335,0.028125,0.029166666666666667
1003-2021_03_20_091302.jpg,car,15,263,320,9,240,94,1,278,103,LTAdatasets/1003/annotate/1003-2021_03_20_091302.jpg,270.5,98.5,0.8453125,0.41041666666666665,0.046875,0.0375
1003-2021_03_20_080719.jpg,car,11,127,320,9,240,102,1,138,111,LTAdatasets/1003/annotate/1003-2021_03_20_080719.jpg,132.5,106.5,0.4140625,0.44375,0.034375,0.0375
1003-2021_03_20_080719.jpg,car,16,149,320,18,240,127,1,165,145,LTAdatasets/1003/annotate/1003-2021_03_20_080719.jpg,157.0,136.0,0.490625,0.5666666666666667,0.05,0.075
1003-2021_03_20_080719.jpg,car,19,242,320,10,240,106,1,261,116,LTAdatasets/1003/annotate/1003-2021_03_20_080719.jpg,251.5,111.0,0.7859375,0.4625,0.059375,0.041666666666666664
1003-2021_03_20_080719.jpg,car,12,168,320,9,240,91,1,180,100,LTAdatasets/1003/annotate/1003-2021_03_20_080719.jpg,174.0,95.5,0.54375,0.39791666666666664,0.0375,0.0375
1003-2021_03_20_080719.jpg,lorry_truck,12,180,320,12,240,101,2,192,113,LTAdatasets/1003/annotate/1003-2021_03_20_080719.jpg,186.0,107.0,0.58125,0.44583333333333336,0.0375,0.05
1003-2021_03_20_080719.jpg,bike,11,149,320,11,240,87,4,160,98,LTAdatasets/1003/annotate/1003-2021_03_20_080719.jpg,154.5,92.5,0.4828125,0.3854166666666667,0.034375,0.04583333333333333
1003-2021_03_20_204238.jpg,car,18,233,320,13,240,126,1,251,139,LTAdatasets/1003/annotate/1003-2021_03_20_204238.jpg,242.0,132.5,0.75625,0.5520833333333334,0.05625,0.05416666666666667
1003-2021_03_20_204238.jpg,car,14,220,320,11,240,98,1,234,109,LTAdatasets/1003/annotate/1003-2021_03_20_204238.jpg,227.0,103.5,0.709375,0.43125,0.04375,0.04583333333333333
1003-2021_03_20_204238.jpg,bike,8,110,320,11,240,97,4,118,108,LTAdatasets/1003/annotate/1003-2021_03_20_204238.jpg,114.0,102.5,0.35625,0.4270833333333333,0.025,0.04583333333333333
1003-2021_03_20_204238.jpg,bike,14,247,320,24,240,204,4,261,228,LTAdatasets/1003/annotate/1003-2021_03_20_204238.jpg,254.0,216.0,0.79375,0.9,0.04375,0.1
1003-2021_03_20_204238.jpg,car,13,307,320,11,240,99,1,320,110,LTAdatasets/1003/annotate/1003-2021_03_20_204238.jpg,313.5,104.5,0.9796875,0.4354166666666667,0.040625,0.04583333333333333
1003-2021_03_20_100105.jpg,van,35,254,320,51,240,188,3,289,239,LTAdatasets/1003/annotate/1003-2021_03_20_100105.jpg,271.5,213.5,0.8484375,0.8895833333333333,0.109375,0.2125
1003-2021_03_20_100105.jpg,van,14,212,320,17,240,105,3,226,122,LTAdatasets/1003/annotate/1003-2021_03_20_100105.jpg,219.0,113.5,0.684375,0.47291666666666665,0.04375,0.07083333333333333
1003-2021_03_20_100105.jpg,van,17,137,320,12,240,112,3,154,124,LTAdatasets/1003/annotate/1003-2021_03_20_100105.jpg,145.5,118.0,0.4546875,0.49166666666666664,0.053125,0.05
1003-2021_03_20_100105.jpg,van,15,14,320,21,240,110,3,29,131,LTAdatasets/1003/annotate/1003-2021_03_20_100105.jpg,21.5,120.5,0.0671875,0.5020833333333333,0.046875,0.0875
1003-2021_03_20_100105.jpg,bike,9,133,320,14,240,124,4,142,138,LTAdatasets/1003/annotate/1003-2021_03_20_100105.jpg,137.5,131.0,0.4296875,0.5458333333333333,0.028125,0.058333333333333334
1003-2021_03_20_100105.jpg,car,12,175,320,8,240,97,1,187,105,LTAdatasets/1003/annotate/1003-2021_03_20_100105.jpg,181.0,101.0,0.565625,0.42083333333333334,0.0375,0.03333333333333333
1003-2021_03_20_100105.jpg,car,13,150,320,9,240,92,1,163,101,LTAdatasets/1003/annotate/1003-2021_03_20_100105.jpg,156.5,96.5,0.4890625,0.40208333333333335,0.040625,0.0375
1003-2021_03_20_100105.jpg,car,16,294,320,13,240,109,1,310,122,LTAdatasets/1003/annotate/1003-2021_03_20_100105.jpg,302.0,115.5,0.94375,0.48125,0.05,0.05416666666666667
1003-2021_03_20_100105.jpg,lorry_truck,12,126,320,17,240,95,2,138,112,LTAdatasets/1003/annotate/1003-2021_03_20_100105.jpg,132.0,103.5,0.4125,0.43125,0.0375,0.07083333333333333
1003-2021_03_20_083640.jpg,car,16,140,320,15,240,112,1,156,127,LTAdatasets/1003/annotate/1003-2021_03_20_083640.jpg,148.0,119.5,0.4625,0.4979166666666667,0.05,0.0625
1003-2021_03_20_083640.jpg,car,11,123,320,14,240,97,1,134,111,LTAdatasets/1003/annotate/1003-2021_03_20_083640.jpg,128.5,104.0,0.4015625,0.43333333333333335,0.034375,0.058333333333333334
1003-2021_03_20_083640.jpg,car,18,233,320,10,240,111,1,251,121,LTAdatasets/1003/annotate/1003-2021_03_20_083640.jpg,242.0,116.0,0.75625,0.48333333333333334,0.05625,0.041666666666666664
1003-2021_03_20_083640.jpg,car,12,165,320,5,240,90,1,177,95,LTAdatasets/1003/annotate/1003-2021_03_20_083640.jpg,171.0,92.5,0.534375,0.3854166666666667,0.0375,0.020833333333333332
1003-2021_03_20_205739.jpg,car,22,295,320,20,240,120,1,317,140,LTAdatasets/1003/annotate/1003-2021_03_20_205739.jpg,306.0,130.0,0.95625,0.5416666666666666,0.06875,0.08333333333333333
1003-2021_03_20_205739.jpg,car,18,257,320,15,240,116,1,275,131,LTAdatasets/1003/annotate/1003-2021_03_20_205739.jpg,266.0,123.5,0.83125,0.5145833333333333,0.05625,0.0625
1003-2021_03_20_205739.jpg,bike,7,169,320,9,240,96,4,176,105,LTAdatasets/1003/annotate/1003-2021_03_20_205739.jpg,172.5,100.5,0.5390625,0.41875,0.021875,0.0375
1003-2021_03_20_205739.jpg,car,14,203,320,10,240,92,1,217,102,LTAdatasets/1003/annotate/1003-2021_03_20_205739.jpg,210.0,97.0,0.65625,0.4041666666666667,0.04375,0.041666666666666664
1003-2021_03_20_205739.jpg,car,12,181,320,8,240,93,1,193,101,LTAdatasets/1003/annotate/1003-2021_03_20_205739.jpg,187.0,97.0,0.584375,0.4041666666666667,0.0375,0.03333333333333333
1003-2021_03_20_071236.jpg,van,23,273,320,26,240,125,3,296,151,LTAdatasets/1003/annotate/1003-2021_03_20_071236.jpg,284.5,138.0,0.8890625,0.575,0.071875,0.10833333333333334
1003-2021_03_20_071236.jpg,car,9,178,320,5,240,90,1,187,95,LTAdatasets/1003/annotate/1003-2021_03_20_071236.jpg,182.5,92.5,0.5703125,0.3854166666666667,0.028125,0.020833333333333332
1003-2021_03_20_071236.jpg,car,15,269,320,11,240,100,1,284,111,LTAdatasets/1003/annotate/1003-2021_03_20_071236.jpg,276.5,105.5,0.8640625,0.4395833333333333,0.046875,0.04583333333333333
1003-2021_03_20_071236.jpg,bike,5,174,320,12,240,91,4,179,103,LTAdatasets/1003/annotate/1003-2021_03_20_071236.jpg,176.5,97.0,0.5515625,0.4041666666666667,0.015625,0.05
1003-2021_03_20_205139.jpg,car,27,168,320,16,240,169,1,195,185,LTAdatasets/1003/annotate/1003-2021_03_20_205139.jpg,181.5,177.0,0.5671875,0.7375,0.084375,0.06666666666666667
1003-2021_03_20_205139.jpg,car,17,149,320,16,240,123,1,166,139,LTAdatasets/1003/annotate/1003-2021_03_20_205139.jpg,157.5,131.0,0.4921875,0.5458333333333333,0.053125,0.06666666666666667
1003-2021_03_20_205139.jpg,car,21,237,320,12,240,111,1,258,123,LTAdatasets/1003/annotate/1003-2021_03_20_205139.jpg,247.5,117.0,0.7734375,0.4875,0.065625,0.05
1003-2021_03_20_205139.jpg,car,15,219,320,9,240,99,1,234,108,LTAdatasets/1003/annotate/1003-2021_03_20_205139.jpg,226.5,103.5,0.7078125,0.43125,0.046875,0.0375
1003-2021_03_20_205139.jpg,car,17,67,320,15,240,119,1,84,134,LTAdatasets/1003/annotate/1003-2021_03_20_205139.jpg,75.5,126.5,0.2359375,0.5270833333333333,0.053125,0.0625
1003-2021_03_20_205139.jpg,car,13,67,320,12,240,96,1,80,108,LTAdatasets/1003/annotate/1003-2021_03_20_205139.jpg,73.5,102.0,0.2296875,0.425,0.040625,0.05
1003-2021_03_20_205139.jpg,car,11,157,320,10,240,86,1,168,96,LTAdatasets/1003/annotate/1003-2021_03_20_205139.jpg,162.5,91.0,0.5078125,0.37916666666666665,0.034375,0.041666666666666664
1003-2021_03_20_205139.jpg,car,13,294,320,9,240,99,1,307,108,LTAdatasets/1003/annotate/1003-2021_03_20_205139.jpg,300.5,103.5,0.9390625,0.43125,0.040625,0.0375
1003-2021_03_20_064855.jpg,car,32,71,320,21,240,165,1,103,186,LTAdatasets/1003/annotate/1003-2021_03_20_064855.jpg,87.0,175.5,0.271875,0.73125,0.1,0.0875
1003-2021_03_20_064855.jpg,car,24,182,320,17,240,146,1,206,163,LTAdatasets/1003/annotate/1003-2021_03_20_064855.jpg,194.0,154.5,0.60625,0.64375,0.075,0.07083333333333333
1003-2021_03_20_064855.jpg,car,18,229,320,14,240,124,1,247,138,LTAdatasets/1003/annotate/1003-2021_03_20_064855.jpg,238.0,131.0,0.74375,0.5458333333333333,0.05625,0.058333333333333334
1003-2021_03_20_064855.jpg,car,19,227,320,14,240,106,1,246,120,LTAdatasets/1003/annotate/1003-2021_03_20_064855.jpg,236.5,113.0,0.7390625,0.4708333333333333,0.059375,0.058333333333333334
1003-2021_03_20_064855.jpg,bike,8,268,320,10,240,113,4,276,123,LTAdatasets/1003/annotate/1003-2021_03_20_064855.jpg,272.0,118.0,0.85,0.49166666666666664,0.025,0.041666666666666664
1003-2021_03_20_064855.jpg,lorry_truck,9,152,320,6,240,84,2,161,90,LTAdatasets/1003/annotate/1003-2021_03_20_064855.jpg,156.5,87.0,0.4890625,0.3625,0.028125,0.025
1003-2021_03_20_210420.jpg,bike,12,262,320,15,240,124,4,274,139,LTAdatasets/1003/annotate/1003-2021_03_20_210420.jpg,268.0,131.5,0.8375,0.5479166666666667,0.0375,0.0625
1003-2021_03_20_210420.jpg,car,11,125,320,12,240,113,1,136,125,LTAdatasets/1003/annotate/1003-2021_03_20_210420.jpg,130.5,119.0,0.4078125,0.49583333333333335,0.034375,0.05
1003-2021_03_20_210420.jpg,car,12,72,320,20,240,137,1,84,157,LTAdatasets/1003/annotate/1003-2021_03_20_210420.jpg,78.0,147.0,0.24375,0.6125,0.0375,0.08333333333333333
1003-2021_03_20_210420.jpg,van,11,67,320,9,240,101,3,78,110,LTAdatasets/1003/annotate/1003-2021_03_20_210420.jpg,72.5,105.5,0.2265625,0.4395833333333333,0.034375,0.0375
1003-2021_03_20_210420.jpg,bus,28,279,320,23,240,86,5,307,109,LTAdatasets/1003/annotate/1003-2021_03_20_210420.jpg,293.0,97.5,0.915625,0.40625,0.0875,0.09583333333333334
1003-2021_03_20_093724.jpg,car,15,148,320,12,240,117,1,163,129,LTAdatasets/1003/annotate/1003-2021_03_20_093724.jpg,155.5,123.0,0.4859375,0.5125,0.046875,0.05
1003-2021_03_20_093724.jpg,bus,11,166,320,14,240,129,5,177,143,LTAdatasets/1003/annotate/1003-2021_03_20_093724.jpg,171.5,136.0,0.5359375,0.5666666666666667,0.034375,0.058333333333333334
1003-2021_03_20_093724.jpg,bus,20,146,320,13,240,144,5,166,157,LTAdatasets/1003/annotate/1003-2021_03_20_093724.jpg,156.0,150.5,0.4875,0.6270833333333333,0.0625,0.05416666666666667
1003-2021_03_20_093724.jpg,bus,19,161,320,21,240,161,5,180,182,LTAdatasets/1003/annotate/1003-2021_03_20_093724.jpg,170.5,171.5,0.5328125,0.7145833333333333,0.059375,0.0875
1003-2021_03_20_093724.jpg,van,44,253,320,42,240,195,3,297,237,LTAdatasets/1003/annotate/1003-2021_03_20_093724.jpg,275.0,216.0,0.859375,0.9,0.1375,0.175
1003-2021_03_20_093724.jpg,lorry_truck,25,190,320,22,240,144,2,215,166,LTAdatasets/1003/annotate/1003-2021_03_20_093724.jpg,202.5,155.0,0.6328125,0.6458333333333334,0.078125,0.09166666666666666
1003-2021_03_20_093724.jpg,car,19,228,320,21,240,173,1,247,194,LTAdatasets/1003/annotate/1003-2021_03_20_093724.jpg,237.5,183.5,0.7421875,0.7645833333333333,0.059375,0.0875
1003-2021_03_20_093724.jpg,lorry_truck,14,125,320,12,240,118,2,139,130,LTAdatasets/1003/annotate/1003-2021_03_20_093724.jpg,132.0,124.0,0.4125,0.5166666666666667,0.04375,0.05
1003-2021_03_20_093724.jpg,bike,10,173,320,9,240,103,4,183,112,LTAdatasets/1003/annotate/1003-2021_03_20_093724.jpg,178.0,107.5,0.55625,0.4479166666666667,0.03125,0.0375
1003-2021_03_20_093724.jpg,car,10,137,320,9,240,110,1,147,119,LTAdatasets/1003/annotate/1003-2021_03_20_093724.jpg,142.0,114.5,0.44375,0.47708333333333336,0.03125,0.0375
1003-2021_03_20_093724.jpg,car,11,132,320,8,240,104,1,143,112,LTAdatasets/1003/annotate/1003-2021_03_20_093724.jpg,137.5,108.0,0.4296875,0.45,0.034375,0.03333333333333333
1003-2021_03_20_093724.jpg,van,13,67,320,11,240,100,3,80,111,LTAdatasets/1003/annotate/1003-2021_03_20_093724.jpg,73.5,105.5,0.2296875,0.4395833333333333,0.040625,0.04583333333333333
1003-2021_03_20_070416.jpg,car,15,158,320,13,240,124,1,173,137,LTAdatasets/1003/annotate/1003-2021_03_20_070416.jpg,165.5,130.5,0.5171875,0.54375,0.046875,0.05416666666666667
1003-2021_03_20_070416.jpg,lorry_truck,19,128,320,20,240,117,2,147,137,LTAdatasets/1003/annotate/1003-2021_03_20_070416.jpg,137.5,127.0,0.4296875,0.5291666666666667,0.059375,0.08333333333333333
1003-2021_03_20_070416.jpg,lorry_truck,19,169,320,20,240,83,2,188,103,LTAdatasets/1003/annotate/1003-2021_03_20_070416.jpg,178.5,93.0,0.5578125,0.3875,0.059375,0.08333333333333333
1003-2021_03_20_070416.jpg,lorry_truck,59,259,320,52,240,188,2,318,240,LTAdatasets/1003/annotate/1003-2021_03_20_070416.jpg,288.5,214.0,0.9015625,0.8916666666666667,0.184375,0.21666666666666667
1003-2021_03_20_073417.jpg,lorry_truck,22,213,320,18,240,116,2,235,134,LTAdatasets/1003/annotate/1003-2021_03_20_073417.jpg,224.0,125.0,0.7,0.5208333333333334,0.06875,0.075
1003-2021_03_20_073417.jpg,van,22,268,320,17,240,119,3,290,136,LTAdatasets/1003/annotate/1003-2021_03_20_073417.jpg,279.0,127.5,0.871875,0.53125,0.06875,0.07083333333333333
1003-2021_03_20_073417.jpg,car,14,209,320,11,240,101,1,223,112,LTAdatasets/1003/annotate/1003-2021_03_20_073417.jpg,216.0,106.5,0.675,0.44375,0.04375,0.04583333333333333
1003-2021_03_20_073417.jpg,car,15,123,320,12,240,99,1,138,111,LTAdatasets/1003/annotate/1003-2021_03_20_073417.jpg,130.5,105.0,0.4078125,0.4375,0.046875,0.05
1003-2021_03_20_073417.jpg,car,10,266,320,12,240,91,1,276,103,LTAdatasets/1003/annotate/1003-2021_03_20_073417.jpg,271.0,97.0,0.846875,0.4041666666666667,0.03125,0.05
1003-2021_03_20_073417.jpg,lorry_truck,11,286,320,12,240,100,2,297,112,LTAdatasets/1003/annotate/1003-2021_03_20_073417.jpg,291.5,106.0,0.9109375,0.44166666666666665,0.034375,0.05
1003-2021_03_20_073417.jpg,lorry_truck,16,153,320,16,240,81,2,169,97,LTAdatasets/1003/annotate/1003-2021_03_20_073417.jpg,161.0,89.0,0.503125,0.37083333333333335,0.05,0.06666666666666667
1003-2021_03_20_073417.jpg,bike,6,181,320,9,240,89,4,187,98,LTAdatasets/1003/annotate/1003-2021_03_20_073417.jpg,184.0,93.5,0.575,0.38958333333333334,0.01875,0.0375
1003-2021_03_20_073417.jpg,bike,8,174,320,7,240,88,4,182,95,LTAdatasets/1003/annotate/1003-2021_03_20_073417.jpg,178.0,91.5,0.55625,0.38125,0.025,0.029166666666666667
1003-2021_03_20_072817.jpg,bike,37,232,320,19,240,187,4,269,206,LTAdatasets/1003/annotate/1003-2021_03_20_072817.jpg,250.5,196.5,0.7828125,0.81875,0.115625,0.07916666666666666
1003-2021_03_20_072817.jpg,bike,11,216,320,11,240,111,4,227,122,LTAdatasets/1003/annotate/1003-2021_03_20_072817.jpg,221.5,116.5,0.6921875,0.48541666666666666,0.034375,0.04583333333333333
1003-2021_03_20_072817.jpg,bike,20,277,320,17,240,122,4,297,139,LTAdatasets/1003/annotate/1003-2021_03_20_072817.jpg,287.0,130.5,0.896875,0.54375,0.0625,0.07083333333333333
1003-2021_03_20_072817.jpg,lorry_truck,16,176,320,19,240,97,2,192,116,LTAdatasets/1003/annotate/1003-2021_03_20_072817.jpg,184.0,106.5,0.575,0.44375,0.05,0.07916666666666666
1003-2021_03_20_072817.jpg,car,11,21,320,10,240,105,1,32,115,LTAdatasets/1003/annotate/1003-2021_03_20_072817.jpg,26.5,110.0,0.0828125,0.4583333333333333,0.034375,0.041666666666666664
1003-2021_03_20_063654.jpg,lorry_truck,10,126,320,17,240,114,2,136,131,LTAdatasets/1003/annotate/1003-2021_03_20_063654.jpg,131.0,122.5,0.409375,0.5104166666666666,0.03125,0.07083333333333333
1003-2021_03_20_063654.jpg,car,19,256,320,11,240,129,1,275,140,LTAdatasets/1003/annotate/1003-2021_03_20_063654.jpg,265.5,134.5,0.8296875,0.5604166666666667,0.059375,0.04583333333333333
1003-2021_03_20_063654.jpg,lorry_truck,29,231,320,34,240,174,2,260,208,LTAdatasets/1003/annotate/1003-2021_03_20_063654.jpg,245.5,191.0,0.7671875,0.7958333333333333,0.090625,0.14166666666666666
1003-2021_03_20_063654.jpg,lorry_truck,16,169,320,17,240,87,2,185,104,LTAdatasets/1003/annotate/1003-2021_03_20_063654.jpg,177.0,95.5,0.553125,0.39791666666666664,0.05,0.07083333333333333
1003-2021_03_20_063654.jpg,van,9,126,320,11,240,95,3,135,106,LTAdatasets/1003/annotate/1003-2021_03_20_063654.jpg,130.5,100.5,0.4078125,0.41875,0.028125,0.04583333333333333
1003-2021_03_20_085822.jpg,lorry_truck,14,68,320,20,240,113,2,82,133,LTAdatasets/1003/annotate/1003-2021_03_20_085822.jpg,75.0,123.0,0.234375,0.5125,0.04375,0.08333333333333333
1003-2021_03_20_085822.jpg,lorry_truck,18,145,320,16,240,115,2,163,131,LTAdatasets/1003/annotate/1003-2021_03_20_085822.jpg,154.0,123.0,0.48125,0.5125,0.05625,0.06666666666666667
1003-2021_03_20_085822.jpg,lorry_truck,18,183,320,20,240,102,2,201,122,LTAdatasets/1003/annotate/1003-2021_03_20_085822.jpg,192.0,112.0,0.6,0.4666666666666667,0.05625,0.08333333333333333
1003-2021_03_20_085822.jpg,lorry_truck,18,181,320,33,240,167,2,199,200,LTAdatasets/1003/annotate/1003-2021_03_20_085822.jpg,190.0,183.5,0.59375,0.7645833333333333,0.05625,0.1375
1003-2021_03_20_085822.jpg,lorry_truck,17,230,320,16,240,106,2,247,122,LTAdatasets/1003/annotate/1003-2021_03_20_085822.jpg,238.5,114.0,0.7453125,0.475,0.053125,0.06666666666666667
1003-2021_03_20_085822.jpg,car,23,185,320,15,240,150,1,208,165,LTAdatasets/1003/annotate/1003-2021_03_20_085822.jpg,196.5,157.5,0.6140625,0.65625,0.071875,0.0625
1003-2021_03_20_085822.jpg,car,24,286,320,15,240,130,1,310,145,LTAdatasets/1003/annotate/1003-2021_03_20_085822.jpg,298.0,137.5,0.93125,0.5729166666666666,0.075,0.0625
1003-2021_03_20_085822.jpg,lorry_truck,15,269,320,16,240,87,2,284,103,LTAdatasets/1003/annotate/1003-2021_03_20_085822.jpg,276.5,95.0,0.8640625,0.3958333333333333,0.046875,0.06666666666666667
1003-2021_03_20_085822.jpg,van,10,288,320,10,240,92,3,298,102,LTAdatasets/1003/annotate/1003-2021_03_20_085822.jpg,293.0,97.0,0.915625,0.4041666666666667,0.03125,0.041666666666666664
1003-2021_03_20_085822.jpg,car,12,256,320,12,240,99,1,268,111,LTAdatasets/1003/annotate/1003-2021_03_20_085822.jpg,262.0,105.0,0.81875,0.4375,0.0375,0.05
1003-2021_03_20_090702.jpg,car,23,146,320,13,240,142,1,169,155,LTAdatasets/1003/annotate/1003-2021_03_20_090702.jpg,157.5,148.5,0.4921875,0.61875,0.071875,0.05416666666666667
1003-2021_03_20_090702.jpg,lorry_truck,15,212,320,13,240,109,2,227,122,LTAdatasets/1003/annotate/1003-2021_03_20_090702.jpg,219.5,115.5,0.6859375,0.48125,0.046875,0.05416666666666667
1003-2021_03_20_090702.jpg,lorry_truck,18,275,320,15,240,91,2,293,106,LTAdatasets/1003/annotate/1003-2021_03_20_090702.jpg,284.0,98.5,0.8875,0.41041666666666665,0.05625,0.0625
1003-2021_03_20_090702.jpg,lorry_truck,10,165,320,7,240,99,2,175,106,LTAdatasets/1003/annotate/1003-2021_03_20_090702.jpg,170.0,102.5,0.53125,0.4270833333333333,0.03125,0.029166666666666667
1003-2021_03_20_090702.jpg,lorry_truck,12,133,320,11,240,108,2,145,119,LTAdatasets/1003/annotate/1003-2021_03_20_090702.jpg,139.0,113.5,0.434375,0.47291666666666665,0.0375,0.04583333333333333
1003-2021_03_20_090702.jpg,bus,18,150,320,14,240,82,5,168,96,LTAdatasets/1003/annotate/1003-2021_03_20_090702.jpg,159.0,89.0,0.496875,0.37083333333333335,0.05625,0.058333333333333334
1003-2021_03_20_090702.jpg,lorry_truck,9,145,320,8,240,90,2,154,98,LTAdatasets/1003/annotate/1003-2021_03_20_090702.jpg,149.5,94.0,0.4671875,0.39166666666666666,0.028125,0.03333333333333333
1003-2021_03_20_200637.jpg,car,19,253,320,13,240,121,1,272,134,LTAdatasets/1003/annotate/1003-2021_03_20_200637.jpg,262.5,127.5,0.8203125,0.53125,0.059375,0.05416666666666667
1003-2021_03_20_200637.jpg,car,13,235,320,12,240,109,1,248,121,LTAdatasets/1003/annotate/1003-2021_03_20_200637.jpg,241.5,115.0,0.7546875,0.4791666666666667,0.040625,0.05
1003-2021_03_20_200637.jpg,van,16,205,320,6,240,112,3,221,118,LTAdatasets/1003/annotate/1003-2021_03_20_200637.jpg,213.0,115.0,0.665625,0.4791666666666667,0.05,0.025
1003-2021_03_20_200637.jpg,car,11,67,320,7,240,98,1,78,105,LTAdatasets/1003/annotate/1003-2021_03_20_200637.jpg,72.5,101.5,0.2265625,0.42291666666666666,0.034375,0.029166666666666667
1003-2021_03_20_200637.jpg,lorry_truck,10,179,320,11,240,95,2,189,106,LTAdatasets/1003/annotate/1003-2021_03_20_200637.jpg,184.0,100.5,0.575,0.41875,0.03125,0.04583333333333333
1003-2021_03_20_200637.jpg,car,10,255,320,9,240,98,1,265,107,LTAdatasets/1003/annotate/1003-2021_03_20_200637.jpg,260.0,102.5,0.8125,0.4270833333333333,0.03125,0.0375
1003-2021_03_20_200637.jpg,car,12,271,320,9,240,99,1,283,108,LTAdatasets/1003/annotate/1003-2021_03_20_200637.jpg,277.0,103.5,0.865625,0.43125,0.0375,0.0375
1003-2021_03_20_185153.jpg,car,22,151,320,16,240,123,1,173,139,LTAdatasets/1003/annotate/1003-2021_03_20_185153.jpg,162.0,131.0,0.50625,0.5458333333333333,0.06875,0.06666666666666667
1003-2021_03_20_185153.jpg,car,21,261,320,13,240,128,1,282,141,LTAdatasets/1003/annotate/1003-2021_03_20_185153.jpg,271.5,134.5,0.8484375,0.5604166666666667,0.065625,0.05416666666666667
1003-2021_03_20_185153.jpg,car,26,176,320,18,240,139,1,202,157,LTAdatasets/1003/annotate/1003-2021_03_20_185153.jpg,189.0,148.0,0.590625,0.6166666666666667,0.08125,0.075
1003-2021_03_20_185153.jpg,car,20,223,320,20,240,174,1,243,194,LTAdatasets/1003/annotate/1003-2021_03_20_185153.jpg,233.0,184.0,0.728125,0.7666666666666667,0.0625,0.08333333333333333
1003-2021_03_20_185153.jpg,car,20,292,320,13,240,119,1,312,132,LTAdatasets/1003/annotate/1003-2021_03_20_185153.jpg,302.0,125.5,0.94375,0.5229166666666667,0.0625,0.05416666666666667
1003-2021_03_20_185153.jpg,car,15,231,320,8,240,109,1,246,117,LTAdatasets/1003/annotate/1003-2021_03_20_185153.jpg,238.5,113.0,0.7453125,0.4708333333333333,0.046875,0.03333333333333333
1003-2021_03_20_185153.jpg,car,13,203,320,11,240,105,1,216,116,LTAdatasets/1003/annotate/1003-2021_03_20_185153.jpg,209.5,110.5,0.6546875,0.46041666666666664,0.040625,0.04583333333333333
1003-2021_03_20_185153.jpg,car,13,223,320,6,240,103,1,236,109,LTAdatasets/1003/annotate/1003-2021_03_20_185153.jpg,229.5,106.0,0.7171875,0.44166666666666665,0.040625,0.025
1003-2021_03_20_185153.jpg,car,17,142,320,13,240,112,1,159,125,LTAdatasets/1003/annotate/1003-2021_03_20_185153.jpg,150.5,118.5,0.4703125,0.49375,0.053125,0.05416666666666667
1003-2021_03_20_185153.jpg,car,10,133,320,7,240,105,1,143,112,LTAdatasets/1003/annotate/1003-2021_03_20_185153.jpg,138.0,108.5,0.43125,0.45208333333333334,0.03125,0.029166666666666667
1003-2021_03_20_100705.jpg,car,20,161,320,15,240,136,1,181,151,LTAdatasets/1003/annotate/1003-2021_03_20_100705.jpg,171.0,143.5,0.534375,0.5979166666666667,0.0625,0.0625
1003-2021_03_20_100705.jpg,car,25,229,320,24,240,183,1,254,207,LTAdatasets/1003/annotate/1003-2021_03_20_100705.jpg,241.5,195.0,0.7546875,0.8125,0.078125,0.1
1003-2021_03_20_100705.jpg,car,22,297,320,14,240,125,1,319,139,LTAdatasets/1003/annotate/1003-2021_03_20_100705.jpg,308.0,132.0,0.9625,0.55,0.06875,0.058333333333333334
1003-2021_03_20_100705.jpg,car,11,124,320,11,240,100,1,135,111,LTAdatasets/1003/annotate/1003-2021_03_20_100705.jpg,129.5,105.5,0.4046875,0.4395833333333333,0.034375,0.04583333333333333
1003-2021_03_20_100705.jpg,van,11,178,320,7,240,96,3,189,103,LTAdatasets/1003/annotate/1003-2021_03_20_100705.jpg,183.5,99.5,0.5734375,0.41458333333333336,0.034375,0.029166666666666667
1003-2021_03_20_100705.jpg,car,10,205,320,5,240,102,1,215,107,LTAdatasets/1003/annotate/1003-2021_03_20_100705.jpg,210.0,104.5,0.65625,0.4354166666666667,0.03125,0.020833333333333332
1003-2021_03_20_100705.jpg,van,20,241,320,17,240,117,3,261,134,LTAdatasets/1003/annotate/1003-2021_03_20_100705.jpg,251.0,125.5,0.784375,0.5229166666666667,0.0625,0.07083333333333333
1003-2021_03_20_212140.jpg,car,14,129,320,9,240,104,1,143,113,LTAdatasets/1003/annotate/1003-2021_03_20_212140.jpg,136.0,108.5,0.425,0.45208333333333334,0.04375,0.0375
1003-2021_03_20_212140.jpg,car,22,252,320,12,240,110,1,274,122,LTAdatasets/1003/annotate/1003-2021_03_20_212140.jpg,263.0,116.0,0.821875,0.48333333333333334,0.06875,0.05
1003-2021_03_20_212140.jpg,car,25,281,320,14,240,130,1,306,144,LTAdatasets/1003/annotate/1003-2021_03_20_212140.jpg,293.5,137.0,0.9171875,0.5708333333333333,0.078125,0.058333333333333334
1003-2021_03_20_212140.jpg,car,12,271,320,12,240,101,1,283,113,LTAdatasets/1003/annotate/1003-2021_03_20_212140.jpg,277.0,107.0,0.865625,0.44583333333333336,0.0375,0.05
1003-2021_03_20_212140.jpg,car,12,201,320,5,240,99,1,213,104,LTAdatasets/1003/annotate/1003-2021_03_20_212140.jpg,207.0,101.5,0.646875,0.42291666666666666,0.0375,0.020833333333333332
1003-2021_03_20_212140.jpg,lorry_truck,18,247,320,18,240,121,2,265,139,LTAdatasets/1003/annotate/1003-2021_03_20_212140.jpg,256.0,130.0,0.8,0.5416666666666666,0.05625,0.075
1003-2021_03_20_212140.jpg,car,11,145,320,5,240,81,1,156,86,LTAdatasets/1003/annotate/1003-2021_03_20_212140.jpg,150.5,83.5,0.4703125,0.34791666666666665,0.034375,0.020833333333333332
1003-2021_03_20_212140.jpg,car,13,270,320,6,240,93,1,283,99,LTAdatasets/1003/annotate/1003-2021_03_20_212140.jpg,276.5,96.0,0.8640625,0.4,0.040625,0.025
1003-2021_03_20_073717.jpg,car,19,160,320,21,240,127,1,179,148,LTAdatasets/1003/annotate/1003-2021_03_20_073717.jpg,169.5,137.5,0.5296875,0.5729166666666666,0.059375,0.0875
1003-2021_03_20_073717.jpg,car,13,5,320,13,240,127,1,18,140,LTAdatasets/1003/annotate/1003-2021_03_20_073717.jpg,11.5,133.5,0.0359375,0.55625,0.040625,0.05416666666666667
1003-2021_03_20_073717.jpg,van,13,23,320,15,240,94,3,36,109,LTAdatasets/1003/annotate/1003-2021_03_20_073717.jpg,29.5,101.5,0.0921875,0.42291666666666666,0.040625,0.0625
1003-2021_03_20_065755.jpg,car,23,280,320,14,240,126,1,303,140,LTAdatasets/1003/annotate/1003-2021_03_20_065755.jpg,291.5,133.0,0.9109375,0.5541666666666667,0.071875,0.058333333333333334
1003-2021_03_20_065755.jpg,lorry_truck,24,245,320,18,240,119,2,269,137,LTAdatasets/1003/annotate/1003-2021_03_20_065755.jpg,257.0,128.0,0.803125,0.5333333333333333,0.075,0.075
1003-2021_03_20_065755.jpg,lorry_truck,20,121,320,21,240,106,2,141,127,LTAdatasets/1003/annotate/1003-2021_03_20_065755.jpg,131.0,116.5,0.409375,0.48541666666666666,0.0625,0.0875
1003-2021_03_20_065755.jpg,lorry_truck,9,184,320,14,240,94,2,193,108,LTAdatasets/1003/annotate/1003-2021_03_20_065755.jpg,188.5,101.0,0.5890625,0.42083333333333334,0.028125,0.058333333333333334
1003-2021_03_20_065755.jpg,lorry_truck,20,298,320,18,240,94,2,318,112,LTAdatasets/1003/annotate/1003-2021_03_20_065755.jpg,308.0,103.0,0.9625,0.42916666666666664,0.0625,0.075
1003-2021_03_20_065755.jpg,bus,14,137,320,12,240,79,5,151,91,LTAdatasets/1003/annotate/1003-2021_03_20_065755.jpg,144.0,85.0,0.45,0.3541666666666667,0.04375,0.05
1003-2021_03_20_081920.jpg,bike,13,294,320,15,240,160,4,307,175,LTAdatasets/1003/annotate/1003-2021_03_20_081920.jpg,300.5,167.5,0.9390625,0.6979166666666666,0.040625,0.0625
1003-2021_03_20_081920.jpg,car,10,124,320,8,240,98,1,134,106,LTAdatasets/1003/annotate/1003-2021_03_20_081920.jpg,129.0,102.0,0.403125,0.425,0.03125,0.03333333333333333
1003-2021_03_20_081920.jpg,car,12,175,320,8,240,91,1,187,99,LTAdatasets/1003/annotate/1003-2021_03_20_081920.jpg,181.0,95.0,0.565625,0.3958333333333333,0.0375,0.03333333333333333
1003-2021_03_20_081920.jpg,car,15,68,320,9,240,120,1,83,129,LTAdatasets/1003/annotate/1003-2021_03_20_081920.jpg,75.5,124.5,0.2359375,0.51875,0.046875,0.0375
1003-2021_03_20_191234.jpg,car,20,278,320,13,240,136,1,298,149,LTAdatasets/1003/annotate/1003-2021_03_20_191234.jpg,288.0,142.5,0.9,0.59375,0.0625,0.05416666666666667
1003-2021_03_20_191234.jpg,car,26,234,320,19,240,127,1,260,146,LTAdatasets/1003/annotate/1003-2021_03_20_191234.jpg,247.0,136.5,0.771875,0.56875,0.08125,0.07916666666666666
1003-2021_03_20_191234.jpg,car,15,260,320,11,240,111,1,275,122,LTAdatasets/1003/annotate/1003-2021_03_20_191234.jpg,267.5,116.5,0.8359375,0.48541666666666666,0.046875,0.04583333333333333
1003-2021_03_20_191234.jpg,car,12,236,320,9,240,109,1,248,118,LTAdatasets/1003/annotate/1003-2021_03_20_191234.jpg,242.0,113.5,0.75625,0.47291666666666665,0.0375,0.0375
1003-2021_03_20_191234.jpg,bus,31,202,320,24,240,95,5,233,119,LTAdatasets/1003/annotate/1003-2021_03_20_191234.jpg,217.5,107.0,0.6796875,0.44583333333333336,0.096875,0.1
1003-2021_03_20_191234.jpg,car,9,171,320,9,240,87,1,180,96,LTAdatasets/1003/annotate/1003-2021_03_20_191234.jpg,175.5,91.5,0.5484375,0.38125,0.028125,0.0375
1003-2021_03_20_191234.jpg,car,9,263,320,5,240,95,1,272,100,LTAdatasets/1003/annotate/1003-2021_03_20_191234.jpg,267.5,97.5,0.8359375,0.40625,0.028125,0.020833333333333332
1003-2021_03_20_180410.jpg,car,22,162,320,17,240,128,1,184,145,LTAdatasets/1003/annotate/1003-2021_03_20_180410.jpg,173.0,136.5,0.540625,0.56875,0.06875,0.07083333333333333
1003-2021_03_20_180410.jpg,car,25,163,320,19,240,158,1,188,177,LTAdatasets/1003/annotate/1003-2021_03_20_180410.jpg,175.5,167.5,0.5484375,0.6979166666666666,0.078125,0.07916666666666666
1003-2021_03_20_180410.jpg,car,20,134,320,16,240,127,1,154,143,LTAdatasets/1003/annotate/1003-2021_03_20_180410.jpg,144.0,135.0,0.45,0.5625,0.0625,0.06666666666666667
1003-2021_03_20_180410.jpg,car,15,67,320,13,240,125,1,82,138,LTAdatasets/1003/annotate/1003-2021_03_20_180410.jpg,74.5,131.5,0.2328125,0.5479166666666667,0.046875,0.05416666666666667
1003-2021_03_20_180410.jpg,car,16,240,320,12,240,104,1,256,116,LTAdatasets/1003/annotate/1003-2021_03_20_180410.jpg,248.0,110.0,0.775,0.4583333333333333,0.05,0.05
1003-2021_03_20_180410.jpg,car,19,0,320,15,240,125,1,19,140,LTAdatasets/1003/annotate/1003-2021_03_20_180410.jpg,9.5,132.5,0.0296875,0.5520833333333334,0.059375,0.0625
1003-2021_03_20_180410.jpg,car,12,7,320,11,240,104,1,19,115,LTAdatasets/1003/annotate/1003-2021_03_20_180410.jpg,13.0,109.5,0.040625,0.45625,0.0375,0.04583333333333333
1003-2021_03_20_180410.jpg,car,12,126,320,8,240,101,1,138,109,LTAdatasets/1003/annotate/1003-2021_03_20_180410.jpg,132.0,105.0,0.4125,0.4375,0.0375,0.03333333333333333
1003-2021_03_20_180410.jpg,bike,11,297,320,13,240,129,4,308,142,LTAdatasets/1003/annotate/1003-2021_03_20_180410.jpg,302.5,135.5,0.9453125,0.5645833333333333,0.034375,0.05416666666666667
1003-2021_03_20_180410.jpg,car,10,178,320,10,240,91,1,188,101,LTAdatasets/1003/annotate/1003-2021_03_20_180410.jpg,183.0,96.0,0.571875,0.4,0.03125,0.041666666666666664
1003-2021_03_20_180410.jpg,car,12,150,320,9,240,91,1,162,100,LTAdatasets/1003/annotate/1003-2021_03_20_180410.jpg,156.0,95.5,0.4875,0.39791666666666664,0.0375,0.0375
1003-2021_03_20_072216.jpg,lorry_truck,24,215,320,21,240,103,2,239,124,LTAdatasets/1003/annotate/1003-2021_03_20_072216.jpg,227.0,113.5,0.709375,0.47291666666666665,0.075,0.0875
1003-2021_03_20_072216.jpg,lorry_truck,33,203,320,14,240,160,2,236,174,LTAdatasets/1003/annotate/1003-2021_03_20_072216.jpg,219.5,167.0,0.6859375,0.6958333333333333,0.103125,0.058333333333333334
1003-2021_03_20_072216.jpg,lorry_truck,17,275,320,17,240,88,2,292,105,LTAdatasets/1003/annotate/1003-2021_03_20_072216.jpg,283.5,96.5,0.8859375,0.40208333333333335,0.053125,0.07083333333333333
1003-2021_03_20_072216.jpg,van,22,248,320,22,240,128,3,270,150,LTAdatasets/1003/annotate/1003-2021_03_20_072216.jpg,259.0,139.0,0.809375,0.5791666666666667,0.06875,0.09166666666666666
1003-2021_03_20_094305.jpg,car,17,65,320,17,240,127,1,82,144,LTAdatasets/1003/annotate/1003-2021_03_20_094305.jpg,73.5,135.5,0.2296875,0.5645833333333333,0.053125,0.07083333333333333
1003-2021_03_20_094305.jpg,car,15,149,320,17,240,140,1,164,157,LTAdatasets/1003/annotate/1003-2021_03_20_094305.jpg,156.5,148.5,0.4890625,0.61875,0.046875,0.07083333333333333
1003-2021_03_20_094305.jpg,car,14,169,320,15,240,139,1,183,154,LTAdatasets/1003/annotate/1003-2021_03_20_094305.jpg,176.0,146.5,0.55,0.6104166666666667,0.04375,0.0625
1003-2021_03_20_094305.jpg,car,17,274,320,14,240,125,1,291,139,LTAdatasets/1003/annotate/1003-2021_03_20_094305.jpg,282.5,132.0,0.8828125,0.55,0.053125,0.058333333333333334
1003-2021_03_20_094305.jpg,car,12,69,320,9,240,102,1,81,111,LTAdatasets/1003/annotate/1003-2021_03_20_094305.jpg,75.0,106.5,0.234375,0.44375,0.0375,0.0375
1003-2021_03_20_094305.jpg,van,13,157,320,16,240,121,3,170,137,LTAdatasets/1003/annotate/1003-2021_03_20_094305.jpg,163.5,129.0,0.5109375,0.5375,0.040625,0.06666666666666667
1003-2021_03_20_094305.jpg,van,28,222,320,31,240,174,3,250,205,LTAdatasets/1003/annotate/1003-2021_03_20_094305.jpg,236.0,189.5,0.7375,0.7895833333333333,0.0875,0.12916666666666668
1003-2021_03_20_094305.jpg,van,12,287,320,13,240,102,3,299,115,LTAdatasets/1003/annotate/1003-2021_03_20_094305.jpg,293.0,108.5,0.915625,0.45208333333333334,0.0375,0.05416666666666667
1003-2021_03_20_094305.jpg,lorry_truck,20,133,320,23,240,117,2,153,140,LTAdatasets/1003/annotate/1003-2021_03_20_094305.jpg,143.0,128.5,0.446875,0.5354166666666667,0.0625,0.09583333333333334
1003-2021_03_20_094305.jpg,lorry_truck,51,253,320,42,240,198,2,304,240,LTAdatasets/1003/annotate/1003-2021_03_20_094305.jpg,278.5,219.0,0.8703125,0.9125,0.159375,0.175
1003-2021_03_20_094305.jpg,lorry_truck,25,187,320,21,240,147,2,212,168,LTAdatasets/1003/annotate/1003-2021_03_20_094305.jpg,199.5,157.5,0.6234375,0.65625,0.078125,0.0875
1003-2021_03_20_094305.jpg,lorry_truck,30,175,320,34,240,170,2,205,204,LTAdatasets/1003/annotate/1003-2021_03_20_094305.jpg,190.0,187.0,0.59375,0.7791666666666667,0.09375,0.14166666666666666
1003-2021_03_20_094305.jpg,car,9,123,320,15,240,115,1,132,130,LTAdatasets/1003/annotate/1003-2021_03_20_094305.jpg,127.5,122.5,0.3984375,0.5104166666666666,0.028125,0.0625
1003-2021_03_20_094305.jpg,car,9,152,320,9,240,86,1,161,95,LTAdatasets/1003/annotate/1003-2021_03_20_094305.jpg,156.5,90.5,0.4890625,0.3770833333333333,0.028125,0.0375
1003-2021_03_20_202758.jpg,car,19,247,320,12,240,116,1,266,128,LTAdatasets/1003/annotate/1003-2021_03_20_202758.jpg,256.5,122.0,0.8015625,0.5083333333333333,0.059375,0.05
1003-2021_03_20_202758.jpg,car,17,70,320,21,240,134,1,87,155,LTAdatasets/1003/annotate/1003-2021_03_20_202758.jpg,78.5,144.5,0.2453125,0.6020833333333333,0.053125,0.0875
1003-2021_03_20_202758.jpg,car,12,1,320,11,240,110,1,13,121,LTAdatasets/1003/annotate/1003-2021_03_20_202758.jpg,7.0,115.5,0.021875,0.48125,0.0375,0.04583333333333333
1003-2021_03_20_202758.jpg,car,14,27,320,10,240,87,1,41,97,LTAdatasets/1003/annotate/1003-2021_03_20_202758.jpg,34.0,92.0,0.10625,0.38333333333333336,0.04375,0.041666666666666664
1003-2021_03_20_202758.jpg,car,13,64,320,11,240,95,1,77,106,LTAdatasets/1003/annotate/1003-2021_03_20_202758.jpg,70.5,100.5,0.2203125,0.41875,0.040625,0.04583333333333333
1003-2021_03_20_202758.jpg,car,15,226,320,10,240,99,1,241,109,LTAdatasets/1003/annotate/1003-2021_03_20_202758.jpg,233.5,104.0,0.7296875,0.43333333333333335,0.046875,0.041666666666666664
1003-2021_03_20_202758.jpg,car,16,277,320,9,240,101,1,293,110,LTAdatasets/1003/annotate/1003-2021_03_20_202758.jpg,285.0,105.5,0.890625,0.4395833333333333,0.05,0.0375
1003-2021_03_20_202758.jpg,bike,9,64,320,11,240,110,4,73,121,LTAdatasets/1003/annotate/1003-2021_03_20_202758.jpg,68.5,115.5,0.2140625,0.48125,0.028125,0.04583333333333333
1003-2021_03_20_202758.jpg,bus,24,260,320,17,240,86,5,284,103,LTAdatasets/1003/annotate/1003-2021_03_20_202758.jpg,272.0,94.5,0.85,0.39375,0.075,0.07083333333333333
1003-2021_03_20_202217.jpg,lorry_truck,40,277,320,36,240,119,2,317,155,LTAdatasets/1003/annotate/1003-2021_03_20_202217.jpg,297.0,137.0,0.928125,0.5708333333333333,0.125,0.15
1003-2021_03_20_202217.jpg,van,14,67,320,18,240,133,3,81,151,LTAdatasets/1003/annotate/1003-2021_03_20_202217.jpg,74.0,142.0,0.23125,0.5916666666666667,0.04375,0.075
1003-2021_03_20_202217.jpg,van,12,271,320,13,240,88,3,283,101,LTAdatasets/1003/annotate/1003-2021_03_20_202217.jpg,277.0,94.5,0.865625,0.39375,0.0375,0.05416666666666667
1003-2021_03_20_202217.jpg,car,26,159,320,10,240,134,1,185,144,LTAdatasets/1003/annotate/1003-2021_03_20_202217.jpg,172.0,139.0,0.5375,0.5791666666666667,0.08125,0.041666666666666664
1003-2021_03_20_202217.jpg,car,24,201,320,9,240,165,1,225,174,LTAdatasets/1003/annotate/1003-2021_03_20_202217.jpg,213.0,169.5,0.665625,0.70625,0.075,0.0375
1003-2021_03_20_202217.jpg,car,30,245,320,21,240,217,1,275,238,LTAdatasets/1003/annotate/1003-2021_03_20_202217.jpg,260.0,227.5,0.8125,0.9479166666666666,0.09375,0.0875
1003-2021_03_20_202217.jpg,car,33,87,320,15,240,225,1,120,240,LTAdatasets/1003/annotate/1003-2021_03_20_202217.jpg,103.5,232.5,0.3234375,0.96875,0.103125,0.0625
1003-2021_03_20_202217.jpg,car,13,163,320,8,240,90,1,176,98,LTAdatasets/1003/annotate/1003-2021_03_20_202217.jpg,169.5,94.0,0.5296875,0.39166666666666666,0.040625,0.03333333333333333
1003-2021_03_20_215222.jpg,lorry_truck,22,245,320,20,240,111,2,267,131,LTAdatasets/1003/annotate/1003-2021_03_20_215222.jpg,256.0,121.0,0.8,0.5041666666666667,0.06875,0.08333333333333333
1003-2021_03_20_215222.jpg,car,18,150,320,15,240,123,1,168,138,LTAdatasets/1003/annotate/1003-2021_03_20_215222.jpg,159.0,130.5,0.496875,0.54375,0.05625,0.0625
1003-2021_03_20_215222.jpg,car,15,10,320,12,240,117,1,25,129,LTAdatasets/1003/annotate/1003-2021_03_20_215222.jpg,17.5,123.0,0.0546875,0.5125,0.046875,0.05
1003-2021_03_20_215222.jpg,car,12,11,320,7,240,101,1,23,108,LTAdatasets/1003/annotate/1003-2021_03_20_215222.jpg,17.0,104.5,0.053125,0.4354166666666667,0.0375,0.029166666666666667
1003-2021_03_20_215222.jpg,car,10,280,320,10,240,95,1,290,105,LTAdatasets/1003/annotate/1003-2021_03_20_215222.jpg,285.0,100.0,0.890625,0.4166666666666667,0.03125,0.041666666666666664
1003-2021_03_20_215222.jpg,car,10,158,320,9,240,91,1,168,100,LTAdatasets/1003/annotate/1003-2021_03_20_215222.jpg,163.0,95.5,0.509375,0.39791666666666664,0.03125,0.0375
1003-2021_03_20_190634.jpg,car,23,166,320,17,240,140,1,189,157,LTAdatasets/1003/annotate/1003-2021_03_20_190634.jpg,177.5,148.5,0.5546875,0.61875,0.071875,0.07083333333333333
1003-2021_03_20_190634.jpg,car,24,87,320,30,240,204,1,111,234,LTAdatasets/1003/annotate/1003-2021_03_20_190634.jpg,99.0,219.0,0.309375,0.9125,0.075,0.125
1003-2021_03_20_190634.jpg,car,33,244,320,31,240,191,1,277,222,LTAdatasets/1003/annotate/1003-2021_03_20_190634.jpg,260.5,206.5,0.8140625,0.8604166666666667,0.103125,0.12916666666666668
1003-2021_03_20_190634.jpg,car,9,5,320,9,240,105,1,14,114,LTAdatasets/1003/annotate/1003-2021_03_20_190634.jpg,9.5,109.5,0.0296875,0.45625,0.028125,0.0375
1003-2021_03_20_190634.jpg,car,9,4,320,9,240,125,1,13,134,LTAdatasets/1003/annotate/1003-2021_03_20_190634.jpg,8.5,129.5,0.0265625,0.5395833333333333,0.028125,0.0375
1003-2021_03_20_190634.jpg,van,9,19,320,13,240,104,3,28,117,LTAdatasets/1003/annotate/1003-2021_03_20_190634.jpg,23.5,110.5,0.0734375,0.46041666666666664,0.028125,0.05416666666666667
1003-2021_03_20_190634.jpg,car,11,65,320,7,240,96,1,76,103,LTAdatasets/1003/annotate/1003-2021_03_20_190634.jpg,70.5,99.5,0.2203125,0.41458333333333336,0.034375,0.029166666666666667
1003-2021_03_20_190634.jpg,car,8,32,320,9,240,92,1,40,101,LTAdatasets/1003/annotate/1003-2021_03_20_190634.jpg,36.0,96.5,0.1125,0.40208333333333335,0.025,0.0375
1003-2021_03_20_190634.jpg,car,13,261,320,10,240,92,1,274,102,LTAdatasets/1003/annotate/1003-2021_03_20_190634.jpg,267.5,97.0,0.8359375,0.4041666666666667,0.040625,0.041666666666666664
1003-2021_03_20_190634.jpg,car,9,289,320,5,240,97,1,298,102,LTAdatasets/1003/annotate/1003-2021_03_20_190634.jpg,293.5,99.5,0.9171875,0.41458333333333336,0.028125,0.020833333333333332
1003-2021_03_20_080119.jpg,van,18,126,320,16,240,114,3,144,130,LTAdatasets/1003/annotate/1003-2021_03_20_080119.jpg,135.0,122.0,0.421875,0.5083333333333333,0.05625,0.06666666666666667
1003-2021_03_20_080119.jpg,car,15,246,320,11,240,113,1,261,124,LTAdatasets/1003/annotate/1003-2021_03_20_080119.jpg,253.5,118.5,0.7921875,0.49375,0.046875,0.04583333333333333
1003-2021_03_20_080119.jpg,car,11,123,320,9,240,101,1,134,110,LTAdatasets/1003/annotate/1003-2021_03_20_080119.jpg,128.5,105.5,0.4015625,0.4395833333333333,0.034375,0.0375
1003-2021_03_20_080119.jpg,lorry_truck,11,200,320,9,240,97,2,211,106,LTAdatasets/1003/annotate/1003-2021_03_20_080119.jpg,205.5,101.5,0.6421875,0.42291666666666666,0.034375,0.0375
1003-2021_03_20_080119.jpg,car,14,276,320,8,240,103,1,290,111,LTAdatasets/1003/annotate/1003-2021_03_20_080119.jpg,283.0,107.0,0.884375,0.44583333333333336,0.04375,0.03333333333333333
1003-2021_03_20_080119.jpg,car,9,181,320,10,240,88,1,190,98,LTAdatasets/1003/annotate/1003-2021_03_20_080119.jpg,185.5,93.0,0.5796875,0.3875,0.028125,0.041666666666666664
1003-2021_03_20_194916.jpg,lorry_truck,16,149,320,21,240,115,2,165,136,LTAdatasets/1003/annotate/1003-2021_03_20_194916.jpg,157.0,125.5,0.490625,0.5229166666666667,0.05,0.0875
1003-2021_03_20_194916.jpg,car,21,259,320,14,240,119,1,280,133,LTAdatasets/1003/annotate/1003-2021_03_20_194916.jpg,269.5,126.0,0.8421875,0.525,0.065625,0.058333333333333334
1003-2021_03_20_194916.jpg,car,12,201,320,9,240,99,1,213,108,LTAdatasets/1003/annotate/1003-2021_03_20_194916.jpg,207.0,103.5,0.646875,0.43125,0.0375,0.0375
1003-2021_03_20_194916.jpg,car,16,275,320,12,240,98,1,291,110,LTAdatasets/1003/annotate/1003-2021_03_20_194916.jpg,283.0,104.0,0.884375,0.43333333333333335,0.05,0.05
1003-2021_03_20_194916.jpg,car,11,258,320,5,240,99,1,269,104,LTAdatasets/1003/annotate/1003-2021_03_20_194916.jpg,263.5,101.5,0.8234375,0.42291666666666666,0.034375,0.020833333333333332
1003-2021_03_20_211900.jpg,car,26,78,320,29,240,183,1,104,212,LTAdatasets/1003/annotate/1003-2021_03_20_211900.jpg,91.0,197.5,0.284375,0.8229166666666666,0.08125,0.12083333333333333
1003-2021_03_20_211900.jpg,car,17,231,320,26,240,176,1,248,202,LTAdatasets/1003/annotate/1003-2021_03_20_211900.jpg,239.5,189.0,0.7484375,0.7875,0.053125,0.10833333333333334
1003-2021_03_20_211900.jpg,car,19,261,320,10,240,112,1,280,122,LTAdatasets/1003/annotate/1003-2021_03_20_211900.jpg,270.5,117.0,0.8453125,0.4875,0.059375,0.041666666666666664
1003-2021_03_20_211900.jpg,lorry_truck,31,267,320,31,240,122,2,298,153,LTAdatasets/1003/annotate/1003-2021_03_20_211900.jpg,282.5,137.5,0.8828125,0.5729166666666666,0.096875,0.12916666666666668
1003-2021_03_20_211900.jpg,lorry_truck,15,21,320,12,240,98,2,36,110,LTAdatasets/1003/annotate/1003-2021_03_20_211900.jpg,28.5,104.0,0.0890625,0.43333333333333335,0.046875,0.05
1003-2021_03_20_211900.jpg,car,16,144,320,12,240,116,1,160,128,LTAdatasets/1003/annotate/1003-2021_03_20_211900.jpg,152.0,122.0,0.475,0.5083333333333333,0.05,0.05
1003-2021_03_20_211900.jpg,car,15,172,320,9,240,94,1,187,103,LTAdatasets/1003/annotate/1003-2021_03_20_211900.jpg,179.5,98.5,0.5609375,0.41041666666666665,0.046875,0.0375
1003-2021_03_20_211900.jpg,car,11,259,320,8,240,95,1,270,103,LTAdatasets/1003/annotate/1003-2021_03_20_211900.jpg,264.5,99.0,0.8265625,0.4125,0.034375,0.03333333333333333
9704-2021_03_20_195136.jpg,car,9,528,640,10,360,67,1,537,77,LTAdatasets/9704/annotate/9704-2021_03_20_195136.jpg,532.5,72.0,0.83203125,0.2,0.0140625,0.027777777777777776
9704-2021_03_20_195136.jpg,car,15,624,640,15,360,89,1,639,104,LTAdatasets/9704/annotate/9704-2021_03_20_195136.jpg,631.5,96.5,0.98671875,0.26805555555555555,0.0234375,0.041666666666666664
9704-2021_03_20_201317.jpg,car,21,337,640,16,360,114,1,358,130,LTAdatasets/9704/annotate/9704-2021_03_20_201317.jpg,347.5,122.0,0.54296875,0.3388888888888889,0.0328125,0.044444444444444446
9704-2021_03_20_201317.jpg,lorry_truck,24,346,640,22,360,90,2,370,112,LTAdatasets/9704/annotate/9704-2021_03_20_201317.jpg,358.0,101.0,0.559375,0.28055555555555556,0.0375,0.06111111111111111
9704-2021_03_20_094605.jpg,lorry_truck,22,517,640,41,360,123,2,539,164,LTAdatasets/9704/annotate/9704-2021_03_20_094605.jpg,528.0,143.5,0.825,0.39861111111111114,0.034375,0.11388888888888889
9704-2021_03_20_094605.jpg,car,33,423,640,38,360,192,1,456,230,LTAdatasets/9704/annotate/9704-2021_03_20_094605.jpg,439.5,211.0,0.68671875,0.5861111111111111,0.0515625,0.10555555555555556
9704-2021_03_20_094605.jpg,car,16,517,640,15,360,83,1,533,98,LTAdatasets/9704/annotate/9704-2021_03_20_094605.jpg,525.0,90.5,0.8203125,0.2513888888888889,0.025,0.041666666666666664
9704-2021_03_20_193415.jpg,car,38,159,640,21,360,167,1,197,188,LTAdatasets/9704/annotate/9704-2021_03_20_193415.jpg,178.0,177.5,0.278125,0.4930555555555556,0.059375,0.058333333333333334
9704-2021_03_20_193415.jpg,bike,11,334,640,17,360,116,4,345,133,LTAdatasets/9704/annotate/9704-2021_03_20_193415.jpg,339.5,124.5,0.53046875,0.3458333333333333,0.0171875,0.04722222222222222
9704-2021_03_20_193415.jpg,car,24,527,640,24,360,86,1,551,110,LTAdatasets/9704/annotate/9704-2021_03_20_193415.jpg,539.0,98.0,0.8421875,0.2722222222222222,0.0375,0.06666666666666667
9704-2021_03_20_193415.jpg,car,11,525,640,9,360,69,1,536,78,LTAdatasets/9704/annotate/9704-2021_03_20_193415.jpg,530.5,73.5,0.82890625,0.20416666666666666,0.0171875,0.025
9704-2021_03_20_073037.jpg,car,25,343,640,17,360,129,1,368,146,LTAdatasets/9704/annotate/9704-2021_03_20_073037.jpg,355.5,137.5,0.55546875,0.3819444444444444,0.0390625,0.04722222222222222
9704-2021_03_20_073037.jpg,lorry_truck,27,331,640,21,360,106,2,358,127,LTAdatasets/9704/annotate/9704-2021_03_20_073037.jpg,344.5,116.5,0.53828125,0.3236111111111111,0.0421875,0.058333333333333334
9704-2021_03_20_074318.jpg,lorry_truck,23,506,640,43,360,144,2,529,187,LTAdatasets/9704/annotate/9704-2021_03_20_074318.jpg,517.5,165.5,0.80859375,0.4597222222222222,0.0359375,0.11944444444444445
9704-2021_03_20_074318.jpg,van,15,503,640,18,360,91,3,518,109,LTAdatasets/9704/annotate/9704-2021_03_20_074318.jpg,510.5,100.0,0.79765625,0.2777777777777778,0.0234375,0.05
9704-2021_03_20_074318.jpg,lorry_truck,18,531,640,20,360,92,2,549,112,LTAdatasets/9704/annotate/9704-2021_03_20_074318.jpg,540.0,102.0,0.84375,0.2833333333333333,0.028125,0.05555555555555555
9704-2021_03_20_074318.jpg,car,37,281,640,17,360,138,1,318,155,LTAdatasets/9704/annotate/9704-2021_03_20_074318.jpg,299.5,146.5,0.46796875,0.40694444444444444,0.0578125,0.04722222222222222
9704-2021_03_20_074318.jpg,car,10,524,640,11,360,75,1,534,86,LTAdatasets/9704/annotate/9704-2021_03_20_074318.jpg,529.0,80.5,0.8265625,0.22361111111111112,0.015625,0.030555555555555555
9704-2021_03_20_081539.jpg,car,41,230,640,24,360,180,1,271,204,LTAdatasets/9704/annotate/9704-2021_03_20_081539.jpg,250.5,192.0,0.39140625,0.5333333333333333,0.0640625,0.06666666666666667
9704-2021_03_20_081539.jpg,car,14,504,640,24,360,96,1,518,120,LTAdatasets/9704/annotate/9704-2021_03_20_081539.jpg,511.0,108.0,0.7984375,0.3,0.021875,0.06666666666666667
9704-2021_03_20_081539.jpg,car,9,519,640,8,360,84,1,528,92,LTAdatasets/9704/annotate/9704-2021_03_20_081539.jpg,523.5,88.0,0.81796875,0.24444444444444444,0.0140625,0.022222222222222223
9704-2021_03_20_081539.jpg,car,11,498,640,8,360,81,1,509,89,LTAdatasets/9704/annotate/9704-2021_03_20_081539.jpg,503.5,85.0,0.78671875,0.2361111111111111,0.0171875,0.022222222222222223
9704-2021_03_20_081539.jpg,bike,15,453,640,28,360,162,4,468,190,LTAdatasets/9704/annotate/9704-2021_03_20_081539.jpg,460.5,176.0,0.71953125,0.4888888888888889,0.0234375,0.07777777777777778
9704-2021_03_20_081539.jpg,van,21,519,640,32,360,126,3,540,158,LTAdatasets/9704/annotate/9704-2021_03_20_081539.jpg,529.5,142.0,0.82734375,0.39444444444444443,0.0328125,0.08888888888888889
9704-2021_03_20_191234.jpg,car,17,524,640,14,360,90,1,541,104,LTAdatasets/9704/annotate/9704-2021_03_20_191234.jpg,532.5,97.0,0.83203125,0.26944444444444443,0.0265625,0.03888888888888889
9704-2021_03_20_200637.jpg,lorry_truck,22,517,640,39,360,123,2,539,162,LTAdatasets/9704/annotate/9704-2021_03_20_200637.jpg,528.0,142.5,0.825,0.3958333333333333,0.034375,0.10833333333333334
9704-2021_03_20_200637.jpg,lorry_truck,26,319,640,17,360,104,2,345,121,LTAdatasets/9704/annotate/9704-2021_03_20_200637.jpg,332.0,112.5,0.51875,0.3125,0.040625,0.04722222222222222
9704-2021_03_20_200637.jpg,car,24,459,640,38,360,147,1,483,185,LTAdatasets/9704/annotate/9704-2021_03_20_200637.jpg,471.0,166.0,0.7359375,0.46111111111111114,0.0375,0.10555555555555556
9704-2021_03_20_200637.jpg,car,42,363,640,39,360,189,1,405,228,LTAdatasets/9704/annotate/9704-2021_03_20_200637.jpg,384.0,208.5,0.6,0.5791666666666667,0.065625,0.10833333333333334
9704-2021_03_20_200416.jpg,car,46,378,640,40,360,219,1,424,259,LTAdatasets/9704/annotate/9704-2021_03_20_200416.jpg,401.0,239.0,0.6265625,0.6638888888888889,0.071875,0.1111111111111111
9704-2021_03_20_200416.jpg,lorry_truck,32,517,640,54,360,97,2,549,151,LTAdatasets/9704/annotate/9704-2021_03_20_200416.jpg,533.0,124.0,0.8328125,0.34444444444444444,0.05,0.15
9704-2021_03_20_200416.jpg,car,14,517,640,15,360,77,1,531,92,LTAdatasets/9704/annotate/9704-2021_03_20_200416.jpg,524.0,84.5,0.81875,0.23472222222222222,0.021875,0.041666666666666664
9704-2021_03_20_200416.jpg,car,11,621,640,13,360,91,1,632,104,LTAdatasets/9704/annotate/9704-2021_03_20_200416.jpg,626.5,97.5,0.97890625,0.2708333333333333,0.0171875,0.03611111111111111
9704-2021_03_20_091302.jpg,van,24,459,640,36,360,148,3,483,184,LTAdatasets/9704/annotate/9704-2021_03_20_091302.jpg,471.0,166.0,0.7359375,0.46111111111111114,0.0375,0.1
9704-2021_03_20_091302.jpg,van,39,330,640,29,360,120,3,369,149,LTAdatasets/9704/annotate/9704-2021_03_20_091302.jpg,349.5,134.5,0.54609375,0.3736111111111111,0.0609375,0.08055555555555556
9704-2021_03_20_091302.jpg,car,20,495,640,18,360,106,1,515,124,LTAdatasets/9704/annotate/9704-2021_03_20_091302.jpg,505.0,115.0,0.7890625,0.3194444444444444,0.03125,0.05
9704-2021_03_20_091302.jpg,car,15,532,640,19,360,94,1,547,113,LTAdatasets/9704/annotate/9704-2021_03_20_091302.jpg,539.5,103.5,0.84296875,0.2875,0.0234375,0.05277777777777778
9704-2021_03_20_091302.jpg,car,30,506,640,29,360,164,1,536,193,LTAdatasets/9704/annotate/9704-2021_03_20_091302.jpg,521.0,178.5,0.8140625,0.49583333333333335,0.046875,0.08055555555555556
9704-2021_03_20_081319.jpg,lorry_truck,75,309,640,65,360,294,2,384,359,LTAdatasets/9704/annotate/9704-2021_03_20_081319.jpg,346.5,326.5,0.54140625,0.9069444444444444,0.1171875,0.18055555555555555
9704-2021_03_20_081319.jpg,van,30,335,640,20,360,115,3,365,135,LTAdatasets/9704/annotate/9704-2021_03_20_081319.jpg,350.0,125.0,0.546875,0.3472222222222222,0.046875,0.05555555555555555
9704-2021_03_20_081319.jpg,bike,18,268,640,19,360,134,4,286,153,LTAdatasets/9704/annotate/9704-2021_03_20_081319.jpg,277.0,143.5,0.4328125,0.39861111111111114,0.028125,0.05277777777777778
9704-2021_03_20_081319.jpg,bike,23,463,640,37,360,271,4,486,308,LTAdatasets/9704/annotate/9704-2021_03_20_081319.jpg,474.5,289.5,0.74140625,0.8041666666666667,0.0359375,0.10277777777777777
9704-2021_03_20_081319.jpg,car,19,444,640,20,360,122,1,463,142,LTAdatasets/9704/annotate/9704-2021_03_20_081319.jpg,453.5,132.0,0.70859375,0.36666666666666664,0.0296875,0.05555555555555555
9704-2021_03_20_081319.jpg,lorry_truck,12,541,640,15,360,70,2,553,85,LTAdatasets/9704/annotate/9704-2021_03_20_081319.jpg,547.0,77.5,0.8546875,0.2152777777777778,0.01875,0.041666666666666664
9704-2021_03_20_181851.jpg,car,23,303,640,15,360,138,1,326,153,LTAdatasets/9704/annotate/9704-2021_03_20_181851.jpg,314.5,145.5,0.49140625,0.4041666666666667,0.0359375,0.041666666666666664
9704-2021_03_20_181851.jpg,car,26,355,640,17,360,124,1,381,141,LTAdatasets/9704/annotate/9704-2021_03_20_181851.jpg,368.0,132.5,0.575,0.3680555555555556,0.040625,0.04722222222222222
9704-2021_03_20_181851.jpg,lorry_truck,42,241,640,20,360,134,2,283,154,LTAdatasets/9704/annotate/9704-2021_03_20_181851.jpg,262.0,144.0,0.409375,0.4,0.065625,0.05555555555555555
9704-2021_03_20_181851.jpg,lorry_truck,47,483,640,89,360,158,2,530,247,LTAdatasets/9704/annotate/9704-2021_03_20_181851.jpg,506.5,202.5,0.79140625,0.5625,0.0734375,0.24722222222222223
9704-2021_03_20_181851.jpg,lorry_truck,42,151,640,28,360,163,2,193,191,LTAdatasets/9704/annotate/9704-2021_03_20_181851.jpg,172.0,177.0,0.26875,0.49166666666666664,0.065625,0.07777777777777778
9704-2021_03_20_181851.jpg,van,21,359,640,15,360,98,3,380,113,LTAdatasets/9704/annotate/9704-2021_03_20_181851.jpg,369.5,105.5,0.57734375,0.29305555555555557,0.0328125,0.041666666666666664
9704-2021_03_20_181851.jpg,car,15,474,640,16,360,98,1,489,114,LTAdatasets/9704/annotate/9704-2021_03_20_181851.jpg,481.5,106.0,0.75234375,0.29444444444444445,0.0234375,0.044444444444444446
9704-2021_03_20_181851.jpg,car,11,510,640,9,360,71,1,521,80,LTAdatasets/9704/annotate/9704-2021_03_20_181851.jpg,515.5,75.5,0.80546875,0.20972222222222223,0.0171875,0.025
9704-2021_03_20_092803.jpg,lorry_truck,22,473,640,26,360,126,2,495,152,LTAdatasets/9704/annotate/9704-2021_03_20_092803.jpg,484.0,139.0,0.75625,0.3861111111111111,0.034375,0.07222222222222222
9704-2021_03_20_092803.jpg,lorry_truck,28,522,640,36,360,103,2,550,139,LTAdatasets/9704/annotate/9704-2021_03_20_092803.jpg,536.0,121.0,0.8375,0.33611111111111114,0.04375,0.1
9704-2021_03_20_092803.jpg,van,34,325,640,18,360,116,3,359,134,LTAdatasets/9704/annotate/9704-2021_03_20_092803.jpg,342.0,125.0,0.534375,0.3472222222222222,0.053125,0.05
9704-2021_03_20_092803.jpg,lorry_truck,50,212,640,28,360,137,2,262,165,LTAdatasets/9704/annotate/9704-2021_03_20_092803.jpg,237.0,151.0,0.3703125,0.41944444444444445,0.078125,0.07777777777777778
9704-2021_03_20_092803.jpg,car,23,365,640,14,360,122,1,388,136,LTAdatasets/9704/annotate/9704-2021_03_20_092803.jpg,376.5,129.0,0.58828125,0.35833333333333334,0.0359375,0.03888888888888889
9704-2021_03_20_092803.jpg,car,15,536,640,15,360,88,1,551,103,LTAdatasets/9704/annotate/9704-2021_03_20_092803.jpg,543.5,95.5,0.84921875,0.2652777777777778,0.0234375,0.041666666666666664
9704-2021_03_20_090102.jpg,lorry_truck,60,297,640,31,360,92,2,357,123,LTAdatasets/9704/annotate/9704-2021_03_20_090102.jpg,327.0,107.5,0.5109375,0.2986111111111111,0.09375,0.08611111111111111
9704-2021_03_20_085141.jpg,car,27,343,640,20,360,108,1,370,128,LTAdatasets/9704/annotate/9704-2021_03_20_085141.jpg,356.5,118.0,0.55703125,0.3277777777777778,0.0421875,0.05555555555555555
9704-2021_03_20_085141.jpg,van,54,180,640,24,360,174,3,234,198,LTAdatasets/9704/annotate/9704-2021_03_20_085141.jpg,207.0,186.0,0.3234375,0.5166666666666667,0.084375,0.06666666666666667
9704-2021_03_20_085141.jpg,van,60,148,640,34,360,205,3,208,239,LTAdatasets/9704/annotate/9704-2021_03_20_085141.jpg,178.0,222.0,0.278125,0.6166666666666667,0.09375,0.09444444444444444
9704-2021_03_20_085141.jpg,bus,66,113,640,52,360,144,5,179,196,LTAdatasets/9704/annotate/9704-2021_03_20_085141.jpg,146.0,170.0,0.228125,0.4722222222222222,0.103125,0.14444444444444443
9704-2021_03_20_094305.jpg,lorry_truck,74,156,640,41,360,144,2,230,185,LTAdatasets/9704/annotate/9704-2021_03_20_094305.jpg,193.0,164.5,0.3015625,0.45694444444444443,0.115625,0.11388888888888889
9704-2021_03_20_094305.jpg,lorry_truck,44,419,640,33,360,186,2,463,219,LTAdatasets/9704/annotate/9704-2021_03_20_094305.jpg,441.0,202.5,0.6890625,0.5625,0.06875,0.09166666666666666
9704-2021_03_20_094305.jpg,lorry_truck,19,536,640,19,360,77,2,555,96,LTAdatasets/9704/annotate/9704-2021_03_20_094305.jpg,545.5,86.5,0.85234375,0.24027777777777778,0.0296875,0.05277777777777778
9704-2021_03_20_094305.jpg,van,17,489,640,30,360,116,3,506,146,LTAdatasets/9704/annotate/9704-2021_03_20_094305.jpg,497.5,131.0,0.77734375,0.3638888888888889,0.0265625,0.08333333333333333
9704-2021_03_20_094305.jpg,car,19,459,640,15,360,111,1,478,126,LTAdatasets/9704/annotate/9704-2021_03_20_094305.jpg,468.5,118.5,0.73203125,0.32916666666666666,0.0296875,0.041666666666666664
9704-2021_03_20_094305.jpg,car,63,199,640,44,360,316,1,262,360,LTAdatasets/9704/annotate/9704-2021_03_20_094305.jpg,230.5,338.0,0.36015625,0.9388888888888889,0.0984375,0.12222222222222222
9704-2021_03_20_094305.jpg,car,38,160,640,34,360,213,1,198,247,LTAdatasets/9704/annotate/9704-2021_03_20_094305.jpg,179.0,230.0,0.2796875,0.6388888888888888,0.059375,0.09444444444444444
9704-2021_03_20_094305.jpg,car,25,366,640,18,360,118,1,391,136,LTAdatasets/9704/annotate/9704-2021_03_20_094305.jpg,378.5,127.0,0.59140625,0.3527777777777778,0.0390625,0.05
9704-2021_03_20_094305.jpg,van,79,310,640,72,360,288,3,389,360,LTAdatasets/9704/annotate/9704-2021_03_20_094305.jpg,349.5,324.0,0.54609375,0.9,0.1234375,0.2
9704-2021_03_20_094305.jpg,car,16,491,640,9,360,88,1,507,97,LTAdatasets/9704/annotate/9704-2021_03_20_094305.jpg,499.0,92.5,0.7796875,0.2569444444444444,0.025,0.025
9704-2021_03_20_185153.jpg,lorry_truck,64,158,640,32,360,149,2,222,181,LTAdatasets/9704/annotate/9704-2021_03_20_185153.jpg,190.0,165.0,0.296875,0.4583333333333333,0.1,0.08888888888888889
9704-2021_03_20_185153.jpg,lorry_truck,29,484,640,35,360,108,2,513,143,LTAdatasets/9704/annotate/9704-2021_03_20_185153.jpg,498.5,125.5,0.77890625,0.3486111111111111,0.0453125,0.09722222222222222
9704-2021_03_20_185153.jpg,lorry_truck,20,535,640,21,360,77,2,555,98,LTAdatasets/9704/annotate/9704-2021_03_20_185153.jpg,545.0,87.5,0.8515625,0.24305555555555555,0.03125,0.058333333333333334
9704-2021_03_20_185153.jpg,car,24,361,640,17,360,101,1,385,118,LTAdatasets/9704/annotate/9704-2021_03_20_185153.jpg,373.0,109.5,0.5828125,0.30416666666666664,0.0375,0.04722222222222222
9704-2021_03_20_093424.jpg,lorry_truck,41,498,640,58,360,132,2,539,190,LTAdatasets/9704/annotate/9704-2021_03_20_093424.jpg,518.5,161.0,0.81015625,0.44722222222222224,0.0640625,0.16111111111111112
9704-2021_03_20_093424.jpg,van,41,228,640,18,360,154,3,269,172,LTAdatasets/9704/annotate/9704-2021_03_20_093424.jpg,248.5,163.0,0.38828125,0.4527777777777778,0.0640625,0.05
9704-2021_03_20_200116.jpg,car,24,430,640,21,360,128,1,454,149,LTAdatasets/9704/annotate/9704-2021_03_20_200116.jpg,442.0,138.5,0.690625,0.38472222222222224,0.0375,0.058333333333333334
9704-2021_03_20_200116.jpg,bike,10,484,640,20,360,121,4,494,141,LTAdatasets/9704/annotate/9704-2021_03_20_200116.jpg,489.0,131.0,0.7640625,0.3638888888888889,0.015625,0.05555555555555555
9704-2021_03_20_200116.jpg,car,28,317,640,15,360,108,1,345,123,LTAdatasets/9704/annotate/9704-2021_03_20_200116.jpg,331.0,115.5,0.5171875,0.32083333333333336,0.04375,0.041666666666666664
9704-2021_03_20_200116.jpg,car,15,517,640,12,360,80,1,532,92,LTAdatasets/9704/annotate/9704-2021_03_20_200116.jpg,524.5,86.0,0.81953125,0.2388888888888889,0.0234375,0.03333333333333333
9704-2021_03_20_181551.jpg,bike,14,291,640,20,360,151,4,305,171,LTAdatasets/9704/annotate/9704-2021_03_20_181551.jpg,298.0,161.0,0.465625,0.44722222222222224,0.021875,0.05555555555555555
9704-2021_03_20_181551.jpg,car,28,310,640,16,360,123,1,338,139,LTAdatasets/9704/annotate/9704-2021_03_20_181551.jpg,324.0,131.0,0.50625,0.3638888888888889,0.04375,0.044444444444444446
9704-2021_03_20_181551.jpg,car,52,150,640,26,360,185,1,202,211,LTAdatasets/9704/annotate/9704-2021_03_20_181551.jpg,176.0,198.0,0.275,0.55,0.08125,0.07222222222222222
9704-2021_03_20_181551.jpg,lorry_truck,47,229,640,23,360,134,2,276,157,LTAdatasets/9704/annotate/9704-2021_03_20_181551.jpg,252.5,145.5,0.39453125,0.4041666666666667,0.0734375,0.06388888888888888
9704-2021_03_20_181551.jpg,lorry_truck,21,373,640,14,360,96,2,394,110,LTAdatasets/9704/annotate/9704-2021_03_20_181551.jpg,383.5,103.0,0.59921875,0.2861111111111111,0.0328125,0.03888888888888889
9704-2021_03_20_181551.jpg,bus,51,313,640,26,360,91,5,364,117,LTAdatasets/9704/annotate/9704-2021_03_20_181551.jpg,338.5,104.0,0.52890625,0.28888888888888886,0.0796875,0.07222222222222222
9704-2021_03_20_181551.jpg,car,9,518,640,18,360,80,1,527,98,LTAdatasets/9704/annotate/9704-2021_03_20_181551.jpg,522.5,89.0,0.81640625,0.24722222222222223,0.0140625,0.05
9704-2021_03_20_085501.jpg,car,18,478,640,23,360,134,1,496,157,LTAdatasets/9704/annotate/9704-2021_03_20_085501.jpg,487.0,145.5,0.7609375,0.4041666666666667,0.028125,0.06388888888888888
9704-2021_03_20_085501.jpg,bike,16,468,640,33,360,184,4,484,217,LTAdatasets/9704/annotate/9704-2021_03_20_085501.jpg,476.0,200.5,0.74375,0.5569444444444445,0.025,0.09166666666666666
9704-2021_03_20_085501.jpg,lorry_truck,19,530,640,34,360,88,2,549,122,LTAdatasets/9704/annotate/9704-2021_03_20_085501.jpg,539.5,105.0,0.84296875,0.2916666666666667,0.0296875,0.09444444444444444
9704-2021_03_20_085501.jpg,lorry_truck,44,230,640,25,360,148,2,274,173,LTAdatasets/9704/annotate/9704-2021_03_20_085501.jpg,252.0,160.5,0.39375,0.44583333333333336,0.06875,0.06944444444444445
9704-2021_03_20_085501.jpg,car,21,484,640,17,360,91,1,505,108,LTAdatasets/9704/annotate/9704-2021_03_20_085501.jpg,494.5,99.5,0.77265625,0.2763888888888889,0.0328125,0.04722222222222222
9704-2021_03_20_085501.jpg,car,15,515,640,14,360,81,1,530,95,LTAdatasets/9704/annotate/9704-2021_03_20_085501.jpg,522.5,88.0,0.81640625,0.24444444444444444,0.0234375,0.03888888888888889
9704-2021_03_20_202758.jpg,van,18,504,640,18,360,95,3,522,113,LTAdatasets/9704/annotate/9704-2021_03_20_202758.jpg,513.0,104.0,0.8015625,0.28888888888888886,0.028125,0.05
9704-2021_03_20_084301.jpg,car,41,353,640,44,360,192,1,394,236,LTAdatasets/9704/annotate/9704-2021_03_20_084301.jpg,373.5,214.0,0.58359375,0.5944444444444444,0.0640625,0.12222222222222222
9704-2021_03_20_084301.jpg,car,27,441,640,23,360,127,1,468,150,LTAdatasets/9704/annotate/9704-2021_03_20_084301.jpg,454.5,138.5,0.71015625,0.38472222222222224,0.0421875,0.06388888888888888
9704-2021_03_20_084301.jpg,car,15,515,640,15,360,89,1,530,104,LTAdatasets/9704/annotate/9704-2021_03_20_084301.jpg,522.5,96.5,0.81640625,0.26805555555555555,0.0234375,0.041666666666666664
9704-2021_03_20_084301.jpg,car,27,343,640,15,360,131,1,370,146,LTAdatasets/9704/annotate/9704-2021_03_20_084301.jpg,356.5,138.5,0.55703125,0.38472222222222224,0.0421875,0.041666666666666664
9704-2021_03_20_084301.jpg,car,30,351,640,16,360,111,1,381,127,LTAdatasets/9704/annotate/9704-2021_03_20_084301.jpg,366.0,119.0,0.571875,0.33055555555555555,0.046875,0.044444444444444446
9704-2021_03_20_084301.jpg,van,61,157,640,22,360,161,3,218,183,LTAdatasets/9704/annotate/9704-2021_03_20_084301.jpg,187.5,172.0,0.29296875,0.4777777777777778,0.0953125,0.06111111111111111
9704-2021_03_20_084301.jpg,lorry_truck,19,536,640,23,360,77,2,555,100,LTAdatasets/9704/annotate/9704-2021_03_20_084301.jpg,545.5,88.5,0.85234375,0.24583333333333332,0.0296875,0.06388888888888888
9704-2021_03_20_094904.jpg,car,33,389,640,39,360,166,1,422,205,LTAdatasets/9704/annotate/9704-2021_03_20_094904.jpg,405.5,185.5,0.63359375,0.5152777777777777,0.0515625,0.10833333333333334
9704-2021_03_20_094904.jpg,van,16,505,640,15,360,102,3,521,117,LTAdatasets/9704/annotate/9704-2021_03_20_094904.jpg,513.0,109.5,0.8015625,0.30416666666666664,0.025,0.041666666666666664
9704-2021_03_20_094904.jpg,car,14,485,640,12,360,96,1,499,108,LTAdatasets/9704/annotate/9704-2021_03_20_094904.jpg,492.0,102.0,0.76875,0.2833333333333333,0.021875,0.03333333333333333
9704-2021_03_20_094904.jpg,lorry_truck,12,539,640,28,360,73,2,551,101,LTAdatasets/9704/annotate/9704-2021_03_20_094904.jpg,545.0,87.0,0.8515625,0.24166666666666667,0.01875,0.07777777777777778
9704-2021_03_20_094904.jpg,lorry_truck,34,314,640,40,360,91,2,348,131,LTAdatasets/9704/annotate/9704-2021_03_20_094904.jpg,331.0,111.0,0.5171875,0.30833333333333335,0.053125,0.1111111111111111
9704-2021_03_20_094904.jpg,car,14,515,640,12,360,84,1,529,96,LTAdatasets/9704/annotate/9704-2021_03_20_094904.jpg,522.0,90.0,0.815625,0.25,0.021875,0.03333333333333333
9704-2021_03_20_200937.jpg,bike,17,436,640,45,360,214,4,453,259,LTAdatasets/9704/annotate/9704-2021_03_20_200937.jpg,444.5,236.5,0.69453125,0.6569444444444444,0.0265625,0.125
9704-2021_03_20_200937.jpg,lorry_truck,30,359,640,18,360,97,2,389,115,LTAdatasets/9704/annotate/9704-2021_03_20_200937.jpg,374.0,106.0,0.584375,0.29444444444444445,0.046875,0.05
9704-2021_03_20_184913.jpg,lorry_truck,22,525,640,30,360,101,2,547,131,LTAdatasets/9704/annotate/9704-2021_03_20_184913.jpg,536.0,116.0,0.8375,0.32222222222222224,0.034375,0.08333333333333333
9704-2021_03_20_184913.jpg,lorry_truck,16,533,640,21,360,79,2,549,100,LTAdatasets/9704/annotate/9704-2021_03_20_184913.jpg,541.0,89.5,0.8453125,0.24861111111111112,0.025,0.058333333333333334
9704-2021_03_20_184913.jpg,car,13,515,640,15,360,83,1,528,98,LTAdatasets/9704/annotate/9704-2021_03_20_184913.jpg,521.5,90.5,0.81484375,0.2513888888888889,0.0203125,0.041666666666666664
9704-2021_03_20_184913.jpg,car,66,193,640,42,360,318,1,259,360,LTAdatasets/9704/annotate/9704-2021_03_20_184913.jpg,226.0,339.0,0.353125,0.9416666666666667,0.103125,0.11666666666666667
9704-2021_03_20_082740.jpg,lorry_truck,38,500,640,64,360,141,2,538,205,LTAdatasets/9704/annotate/9704-2021_03_20_082740.jpg,519.0,173.0,0.8109375,0.48055555555555557,0.059375,0.17777777777777778
9704-2021_03_20_082740.jpg,van,42,223,640,21,360,137,3,265,158,LTAdatasets/9704/annotate/9704-2021_03_20_082740.jpg,244.0,147.5,0.38125,0.4097222222222222,0.065625,0.058333333333333334
9704-2021_03_20_082740.jpg,car,15,519,640,14,360,78,1,534,92,LTAdatasets/9704/annotate/9704-2021_03_20_082740.jpg,526.5,85.0,0.82265625,0.2361111111111111,0.0234375,0.03888888888888889
9704-2021_03_20_092143.jpg,bus,10,492,640,17,360,123,5,502,140,LTAdatasets/9704/annotate/9704-2021_03_20_092143.jpg,497.0,131.5,0.7765625,0.36527777777777776,0.015625,0.04722222222222222
9704-2021_03_20_092143.jpg,lorry_truck,33,276,640,21,360,134,2,309,155,LTAdatasets/9704/annotate/9704-2021_03_20_092143.jpg,292.5,144.5,0.45703125,0.4013888888888889,0.0515625,0.058333333333333334
9704-2021_03_20_092143.jpg,lorry_truck,34,485,640,51,360,190,2,519,241,LTAdatasets/9704/annotate/9704-2021_03_20_092143.jpg,502.0,215.5,0.784375,0.5986111111111111,0.053125,0.14166666666666666
9704-2021_03_20_092143.jpg,lorry_truck,19,534,640,30,360,78,2,553,108,LTAdatasets/9704/annotate/9704-2021_03_20_092143.jpg,543.5,93.0,0.84921875,0.25833333333333336,0.0296875,0.08333333333333333
9704-2021_03_20_201617.jpg,car,22,485,640,13,360,85,1,507,98,LTAdatasets/9704/annotate/9704-2021_03_20_201617.jpg,496.0,91.5,0.775,0.25416666666666665,0.034375,0.03611111111111111
9704-2021_03_20_201617.jpg,lorry_truck,15,539,640,21,360,67,2,554,88,LTAdatasets/9704/annotate/9704-2021_03_20_201617.jpg,546.5,77.5,0.85390625,0.2152777777777778,0.0234375,0.058333333333333334
9704-2021_03_20_193635.jpg,car,68,276,640,57,360,240,1,344,297,LTAdatasets/9704/annotate/9704-2021_03_20_193635.jpg,310.0,268.5,0.484375,0.7458333333333333,0.10625,0.15833333333333333
9704-2021_03_20_193635.jpg,van,21,523,640,24,360,109,3,544,133,LTAdatasets/9704/annotate/9704-2021_03_20_193635.jpg,533.5,121.0,0.83359375,0.33611111111111114,0.0328125,0.06666666666666667
9704-2021_03_20_193635.jpg,car,32,269,640,16,360,129,1,301,145,LTAdatasets/9704/annotate/9704-2021_03_20_193635.jpg,285.0,137.0,0.4453125,0.38055555555555554,0.05,0.044444444444444446
9704-2021_03_20_192515.jpg,lorry_truck,31,476,640,33,360,109,2,507,142,LTAdatasets/9704/annotate/9704-2021_03_20_192515.jpg,491.5,125.5,0.76796875,0.3486111111111111,0.0484375,0.09166666666666666
9704-2021_03_20_180710.jpg,car,70,357,640,72,360,262,1,427,334,LTAdatasets/9704/annotate/9704-2021_03_20_180710.jpg,392.0,298.0,0.6125,0.8277777777777777,0.109375,0.2
9704-2021_03_20_180710.jpg,car,30,444,640,38,360,161,1,474,199,LTAdatasets/9704/annotate/9704-2021_03_20_180710.jpg,459.0,180.0,0.7171875,0.5,0.046875,0.10555555555555556
9704-2021_03_20_180710.jpg,car,19,498,640,18,360,109,1,517,127,LTAdatasets/9704/annotate/9704-2021_03_20_180710.jpg,507.5,118.0,0.79296875,0.3277777777777778,0.0296875,0.05
9704-2021_03_20_180710.jpg,car,41,287,640,24,360,148,1,328,172,LTAdatasets/9704/annotate/9704-2021_03_20_180710.jpg,307.5,160.0,0.48046875,0.4444444444444444,0.0640625,0.06666666666666667
9704-2021_03_20_180710.jpg,car,72,241,640,62,360,270,1,313,332,LTAdatasets/9704/annotate/9704-2021_03_20_180710.jpg,277.0,301.0,0.4328125,0.8361111111111111,0.1125,0.17222222222222222
9704-2021_03_20_180710.jpg,lorry_truck,22,350,640,24,360,84,2,372,108,LTAdatasets/9704/annotate/9704-2021_03_20_180710.jpg,361.0,96.0,0.5640625,0.26666666666666666,0.034375,0.06666666666666667
9704-2021_03_20_180710.jpg,bike,12,498,640,17,360,86,4,510,103,LTAdatasets/9704/annotate/9704-2021_03_20_180710.jpg,504.0,94.5,0.7875,0.2625,0.01875,0.04722222222222222
9704-2021_03_20_193115.jpg,car,39,379,640,52,360,235,1,418,287,LTAdatasets/9704/annotate/9704-2021_03_20_193115.jpg,398.5,261.0,0.62265625,0.725,0.0609375,0.14444444444444443
9704-2021_03_20_193115.jpg,car,18,471,640,31,360,138,1,489,169,LTAdatasets/9704/annotate/9704-2021_03_20_193115.jpg,480.0,153.5,0.75,0.4263888888888889,0.028125,0.08611111111111111
9704-2021_03_20_193115.jpg,car,20,492,640,18,360,107,1,512,125,LTAdatasets/9704/annotate/9704-2021_03_20_193115.jpg,502.0,116.0,0.784375,0.32222222222222224,0.03125,0.05
9704-2021_03_20_193115.jpg,lorry_truck,22,530,640,37,360,77,2,552,114,LTAdatasets/9704/annotate/9704-2021_03_20_193115.jpg,541.0,95.5,0.8453125,0.2652777777777778,0.034375,0.10277777777777777
9704-2021_03_20_193115.jpg,van,12,514,640,15,360,85,3,526,100,LTAdatasets/9704/annotate/9704-2021_03_20_193115.jpg,520.0,92.5,0.8125,0.2569444444444444,0.01875,0.041666666666666664
9704-2021_03_20_073717.jpg,car,45,347,640,37,360,193,1,392,230,LTAdatasets/9704/annotate/9704-2021_03_20_073717.jpg,369.5,211.5,0.57734375,0.5875,0.0703125,0.10277777777777777
9704-2021_03_20_073717.jpg,bike,13,313,640,15,360,121,4,326,136,LTAdatasets/9704/annotate/9704-2021_03_20_073717.jpg,319.5,128.5,0.49921875,0.35694444444444445,0.0203125,0.041666666666666664
9704-2021_03_20_073717.jpg,lorry_truck,30,266,640,21,360,124,2,296,145,LTAdatasets/9704/annotate/9704-2021_03_20_073717.jpg,281.0,134.5,0.4390625,0.3736111111111111,0.046875,0.058333333333333334
9704-2021_03_20_191614.jpg,car,57,155,640,32,360,215,1,212,247,LTAdatasets/9704/annotate/9704-2021_03_20_191614.jpg,183.5,231.0,0.28671875,0.6416666666666667,0.0890625,0.08888888888888889
9704-2021_03_20_191614.jpg,car,35,300,640,20,360,126,1,335,146,LTAdatasets/9704/annotate/9704-2021_03_20_191614.jpg,317.5,136.0,0.49609375,0.37777777777777777,0.0546875,0.05555555555555555
9704-2021_03_20_191614.jpg,car,18,364,640,18,360,118,1,382,136,LTAdatasets/9704/annotate/9704-2021_03_20_191614.jpg,373.0,127.0,0.5828125,0.3527777777777778,0.028125,0.05
9704-2021_03_20_074918.jpg,bike,17,441,640,46,360,201,4,458,247,LTAdatasets/9704/annotate/9704-2021_03_20_074918.jpg,449.5,224.0,0.70234375,0.6222222222222222,0.0265625,0.12777777777777777
9704-2021_03_20_074918.jpg,car,38,231,640,17,360,152,1,269,169,LTAdatasets/9704/annotate/9704-2021_03_20_074918.jpg,250.0,160.5,0.390625,0.44583333333333336,0.059375,0.04722222222222222
9704-2021_03_20_074918.jpg,car,20,372,640,20,360,116,1,392,136,LTAdatasets/9704/annotate/9704-2021_03_20_074918.jpg,382.0,126.0,0.596875,0.35,0.03125,0.05555555555555555
9704-2021_03_20_074918.jpg,car,28,317,640,19,360,122,1,345,141,LTAdatasets/9704/annotate/9704-2021_03_20_074918.jpg,331.0,131.5,0.5171875,0.36527777777777776,0.04375,0.05277777777777778
9704-2021_03_20_074918.jpg,bike,14,299,640,20,360,114,4,313,134,LTAdatasets/9704/annotate/9704-2021_03_20_074918.jpg,306.0,124.0,0.478125,0.34444444444444444,0.021875,0.05555555555555555
9704-2021_03_20_074918.jpg,car,22,485,640,21,360,118,1,507,139,LTAdatasets/9704/annotate/9704-2021_03_20_074918.jpg,496.0,128.5,0.775,0.35694444444444445,0.034375,0.058333333333333334
9704-2021_03_20_184613.jpg,bike,17,391,640,34,360,224,4,408,258,LTAdatasets/9704/annotate/9704-2021_03_20_184613.jpg,399.5,241.0,0.62421875,0.6694444444444444,0.0265625,0.09444444444444444
9704-2021_03_20_184613.jpg,car,32,319,640,17,360,134,1,351,151,LTAdatasets/9704/annotate/9704-2021_03_20_184613.jpg,335.0,142.5,0.5234375,0.3958333333333333,0.05,0.04722222222222222
9704-2021_03_20_184613.jpg,car,52,199,640,23,360,173,1,251,196,LTAdatasets/9704/annotate/9704-2021_03_20_184613.jpg,225.0,184.5,0.3515625,0.5125,0.08125,0.06388888888888888
9704-2021_03_20_184613.jpg,car,19,340,640,13,360,102,1,359,115,LTAdatasets/9704/annotate/9704-2021_03_20_184613.jpg,349.5,108.5,0.54609375,0.3013888888888889,0.0296875,0.03611111111111111
9704-2021_03_20_074618.jpg,car,44,191,640,30,360,171,1,235,201,LTAdatasets/9704/annotate/9704-2021_03_20_074618.jpg,213.0,186.0,0.3328125,0.5166666666666667,0.06875,0.08333333333333333
9704-2021_03_20_074618.jpg,lorry_truck,88,358,640,110,360,175,2,446,285,LTAdatasets/9704/annotate/9704-2021_03_20_074618.jpg,402.0,230.0,0.628125,0.6388888888888888,0.1375,0.3055555555555556
9704-2021_03_20_074618.jpg,car,20,466,640,25,360,103,1,486,128,LTAdatasets/9704/annotate/9704-2021_03_20_074618.jpg,476.0,115.5,0.74375,0.32083333333333336,0.03125,0.06944444444444445
9704-2021_03_20_190113.jpg,van,41,249,640,17,360,151,3,290,168,LTAdatasets/9704/annotate/9704-2021_03_20_190113.jpg,269.5,159.5,0.42109375,0.44305555555555554,0.0640625,0.04722222222222222
9704-2021_03_20_190113.jpg,bike,20,207,640,14,360,157,4,227,171,LTAdatasets/9704/annotate/9704-2021_03_20_190113.jpg,217.0,164.0,0.3390625,0.45555555555555555,0.03125,0.03888888888888889
9704-2021_03_20_190113.jpg,lorry_truck,42,483,640,75,360,163,2,525,238,LTAdatasets/9704/annotate/9704-2021_03_20_190113.jpg,504.0,200.5,0.7875,0.5569444444444445,0.065625,0.20833333333333334
9704-2021_03_20_190113.jpg,lorry_truck,28,516,640,44,360,115,2,544,159,LTAdatasets/9704/annotate/9704-2021_03_20_190113.jpg,530.0,137.0,0.828125,0.38055555555555554,0.04375,0.12222222222222222
9704-2021_03_20_190113.jpg,lorry_truck,20,508,640,25,360,80,2,528,105,LTAdatasets/9704/annotate/9704-2021_03_20_190113.jpg,518.0,92.5,0.809375,0.2569444444444444,0.03125,0.06944444444444445
9704-2021_03_20_190113.jpg,van,21,478,640,28,360,120,3,499,148,LTAdatasets/9704/annotate/9704-2021_03_20_190113.jpg,488.5,134.0,0.76328125,0.37222222222222223,0.0328125,0.07777777777777778
9704-2021_03_20_092543.jpg,car,22,482,640,20,360,119,1,504,139,LTAdatasets/9704/annotate/9704-2021_03_20_092543.jpg,493.0,129.0,0.7703125,0.35833333333333334,0.034375,0.05555555555555555
9704-2021_03_20_092543.jpg,car,21,454,640,17,360,116,1,475,133,LTAdatasets/9704/annotate/9704-2021_03_20_092543.jpg,464.5,124.5,0.72578125,0.3458333333333333,0.0328125,0.04722222222222222
9704-2021_03_20_092543.jpg,lorry_truck,34,127,640,23,360,178,2,161,201,LTAdatasets/9704/annotate/9704-2021_03_20_092543.jpg,144.0,189.5,0.225,0.5263888888888889,0.053125,0.06388888888888888
9704-2021_03_20_092543.jpg,lorry_truck,24,340,640,19,360,97,2,364,116,LTAdatasets/9704/annotate/9704-2021_03_20_092543.jpg,352.0,106.5,0.55,0.29583333333333334,0.0375,0.05277777777777778
9704-2021_03_20_084001.jpg,lorry_truck,26,523,640,38,360,106,2,549,144,LTAdatasets/9704/annotate/9704-2021_03_20_084001.jpg,536.0,125.0,0.8375,0.3472222222222222,0.040625,0.10555555555555556
9704-2021_03_20_084001.jpg,car,20,369,640,15,360,118,1,389,133,LTAdatasets/9704/annotate/9704-2021_03_20_084001.jpg,379.0,125.5,0.5921875,0.3486111111111111,0.03125,0.041666666666666664
9704-2021_03_20_084001.jpg,car,14,487,640,10,360,93,1,501,103,LTAdatasets/9704/annotate/9704-2021_03_20_084001.jpg,494.0,98.0,0.771875,0.2722222222222222,0.021875,0.027777777777777776
9704-2021_03_20_084001.jpg,car,44,380,640,60,360,245,1,424,305,LTAdatasets/9704/annotate/9704-2021_03_20_084001.jpg,402.0,275.0,0.628125,0.7638888888888888,0.06875,0.16666666666666666
9704-2021_03_20_183112.jpg,car,34,403,640,34,360,147,1,437,181,LTAdatasets/9704/annotate/9704-2021_03_20_183112.jpg,420.0,164.0,0.65625,0.45555555555555555,0.053125,0.09444444444444444
9704-2021_03_20_183112.jpg,car,60,316,640,48,360,312,1,376,360,LTAdatasets/9704/annotate/9704-2021_03_20_183112.jpg,346.0,336.0,0.540625,0.9333333333333333,0.09375,0.13333333333333333
9704-2021_03_20_183112.jpg,lorry_truck,26,523,640,34,360,94,2,549,128,LTAdatasets/9704/annotate/9704-2021_03_20_183112.jpg,536.0,111.0,0.8375,0.30833333333333335,0.040625,0.09444444444444444
9704-2021_03_20_183112.jpg,car,18,389,640,11,360,107,1,407,118,LTAdatasets/9704/annotate/9704-2021_03_20_183112.jpg,398.0,112.5,0.621875,0.3125,0.028125,0.030555555555555555
9704-2021_03_20_182451.jpg,lorry_truck,38,499,640,55,360,124,2,537,179,LTAdatasets/9704/annotate/9704-2021_03_20_182451.jpg,518.0,151.5,0.809375,0.42083333333333334,0.059375,0.1527777777777778
9704-2021_03_20_182451.jpg,van,10,528,640,20,360,93,3,538,113,LTAdatasets/9704/annotate/9704-2021_03_20_182451.jpg,533.0,103.0,0.8328125,0.2861111111111111,0.015625,0.05555555555555555
9704-2021_03_20_182451.jpg,car,24,353,640,13,360,106,1,377,119,LTAdatasets/9704/annotate/9704-2021_03_20_182451.jpg,365.0,112.5,0.5703125,0.3125,0.0375,0.03611111111111111
9704-2021_03_20_182451.jpg,car,9,501,640,8,360,81,1,510,89,LTAdatasets/9704/annotate/9704-2021_03_20_182451.jpg,505.5,85.0,0.78984375,0.2361111111111111,0.0140625,0.022222222222222223
9704-2021_03_20_203058.jpg,lorry_truck,44,233,640,25,360,132,2,277,157,LTAdatasets/9704/annotate/9704-2021_03_20_203058.jpg,255.0,144.5,0.3984375,0.4013888888888889,0.06875,0.06944444444444445
9704-2021_03_20_203058.jpg,car,15,513,640,13,360,82,1,528,95,LTAdatasets/9704/annotate/9704-2021_03_20_203058.jpg,520.5,88.5,0.81328125,0.24583333333333332,0.0234375,0.03611111111111111
9704-2021_03_20_082220.jpg,lorry_truck,51,276,640,37,360,117,2,327,154,LTAdatasets/9704/annotate/9704-2021_03_20_082220.jpg,301.5,135.5,0.47109375,0.3763888888888889,0.0796875,0.10277777777777777
9704-2021_03_20_082220.jpg,lorry_truck,29,306,640,11,360,102,2,335,113,LTAdatasets/9704/annotate/9704-2021_03_20_082220.jpg,320.5,107.5,0.50078125,0.2986111111111111,0.0453125,0.030555555555555555
9704-2021_03_20_082220.jpg,lorry_truck,16,540,640,15,360,68,2,556,83,LTAdatasets/9704/annotate/9704-2021_03_20_082220.jpg,548.0,75.5,0.85625,0.20972222222222223,0.025,0.041666666666666664
9704-2021_03_20_082220.jpg,car,11,507,640,12,360,73,1,518,85,LTAdatasets/9704/annotate/9704-2021_03_20_082220.jpg,512.5,79.0,0.80078125,0.21944444444444444,0.0171875,0.03333333333333333
9704-2021_03_20_082220.jpg,car,15,433,640,13,360,85,1,448,98,LTAdatasets/9704/annotate/9704-2021_03_20_082220.jpg,440.5,91.5,0.68828125,0.25416666666666665,0.0234375,0.03611111111111111
9704-2021_03_20_190413.jpg,car,44,247,640,19,360,165,1,291,184,LTAdatasets/9704/annotate/9704-2021_03_20_190413.jpg,269.0,174.5,0.4203125,0.4847222222222222,0.06875,0.05277777777777778
9704-2021_03_20_190413.jpg,car,29,423,640,22,360,142,1,452,164,LTAdatasets/9704/annotate/9704-2021_03_20_190413.jpg,437.5,153.0,0.68359375,0.425,0.0453125,0.06111111111111111
9704-2021_03_20_190413.jpg,car,15,505,640,17,360,90,1,520,107,LTAdatasets/9704/annotate/9704-2021_03_20_190413.jpg,512.5,98.5,0.80078125,0.27361111111111114,0.0234375,0.04722222222222222
9704-2021_03_20_190413.jpg,lorry_truck,21,533,640,19,360,75,2,554,94,LTAdatasets/9704/annotate/9704-2021_03_20_190413.jpg,543.5,84.5,0.84921875,0.23472222222222222,0.0328125,0.05277777777777778
9704-2021_03_20_190413.jpg,lorry_truck,56,380,640,66,360,218,2,436,284,LTAdatasets/9704/annotate/9704-2021_03_20_190413.jpg,408.0,251.0,0.6375,0.6972222222222222,0.0875,0.18333333333333332
9704-2021_03_20_190413.jpg,van,22,367,640,21,360,92,3,389,113,LTAdatasets/9704/annotate/9704-2021_03_20_190413.jpg,378.0,102.5,0.590625,0.2847222222222222,0.034375,0.058333333333333334
9704-2021_03_20_075818.jpg,car,20,475,640,17,360,97,1,495,114,LTAdatasets/9704/annotate/9704-2021_03_20_075818.jpg,485.0,105.5,0.7578125,0.29305555555555557,0.03125,0.04722222222222222
9704-2021_03_20_075818.jpg,lorry_truck,37,233,640,21,360,139,2,270,160,LTAdatasets/9704/annotate/9704-2021_03_20_075818.jpg,251.5,149.5,0.39296875,0.4152777777777778,0.0578125,0.058333333333333334
9704-2021_03_20_201917.jpg,bus,89,153,640,48,360,134,5,242,182,LTAdatasets/9704/annotate/9704-2021_03_20_201917.jpg,197.5,158.0,0.30859375,0.4388888888888889,0.1390625,0.13333333333333333
9704-2021_03_20_201917.jpg,car,31,306,640,18,360,127,1,337,145,LTAdatasets/9704/annotate/9704-2021_03_20_201917.jpg,321.5,136.0,0.50234375,0.37777777777777777,0.0484375,0.05
9704-2021_03_20_182151.jpg,car,56,154,640,30,360,205,1,210,235,LTAdatasets/9704/annotate/9704-2021_03_20_182151.jpg,182.0,220.0,0.284375,0.6111111111111112,0.0875,0.08333333333333333
9704-2021_03_20_182151.jpg,car,16,384,640,10,360,107,1,400,117,LTAdatasets/9704/annotate/9704-2021_03_20_182151.jpg,392.0,112.0,0.6125,0.3111111111111111,0.025,0.027777777777777776
9704-2021_03_20_182151.jpg,car,21,360,640,16,360,101,1,381,117,LTAdatasets/9704/annotate/9704-2021_03_20_182151.jpg,370.5,109.0,0.57890625,0.30277777777777776,0.0328125,0.044444444444444446
9704-2021_03_20_182151.jpg,lorry_truck,62,212,640,31,360,131,2,274,162,LTAdatasets/9704/annotate/9704-2021_03_20_182151.jpg,243.0,146.5,0.3796875,0.40694444444444444,0.096875,0.08611111111111111
9704-2021_03_20_182151.jpg,car,21,476,640,18,360,101,1,497,119,LTAdatasets/9704/annotate/9704-2021_03_20_182151.jpg,486.5,110.0,0.76015625,0.3055555555555556,0.0328125,0.05
9704-2021_03_20_182151.jpg,car,16,483,640,11,360,92,1,499,103,LTAdatasets/9704/annotate/9704-2021_03_20_182151.jpg,491.0,97.5,0.7671875,0.2708333333333333,0.025,0.030555555555555555
9704-2021_03_20_182151.jpg,van,13,512,640,14,360,84,3,525,98,LTAdatasets/9704/annotate/9704-2021_03_20_182151.jpg,518.5,91.0,0.81015625,0.25277777777777777,0.0203125,0.03888888888888889
9704-2021_03_20_093724.jpg,car,47,358,640,71,360,257,1,405,328,LTAdatasets/9704/annotate/9704-2021_03_20_093724.jpg,381.5,292.5,0.59609375,0.8125,0.0734375,0.19722222222222222
9704-2021_03_20_093724.jpg,car,50,306,640,43,360,227,1,356,270,LTAdatasets/9704/annotate/9704-2021_03_20_093724.jpg,331.0,248.5,0.5171875,0.6902777777777778,0.078125,0.11944444444444445
9704-2021_03_20_093724.jpg,bike,15,433,640,30,360,157,4,448,187,LTAdatasets/9704/annotate/9704-2021_03_20_093724.jpg,440.5,172.0,0.68828125,0.4777777777777778,0.0234375,0.08333333333333333
9704-2021_03_20_093724.jpg,car,28,301,640,17,360,131,1,329,148,LTAdatasets/9704/annotate/9704-2021_03_20_093724.jpg,315.0,139.5,0.4921875,0.3875,0.04375,0.04722222222222222
9704-2021_03_20_093724.jpg,car,22,375,640,18,360,115,1,397,133,LTAdatasets/9704/annotate/9704-2021_03_20_093724.jpg,386.0,124.0,0.603125,0.34444444444444444,0.034375,0.05
9704-2021_03_20_093724.jpg,lorry_truck,91,421,640,109,360,251,2,512,360,LTAdatasets/9704/annotate/9704-2021_03_20_093724.jpg,466.5,305.5,0.72890625,0.8486111111111111,0.1421875,0.30277777777777776
9704-2021_03_20_194315.jpg,lorry_truck,35,462,640,47,360,123,2,497,170,LTAdatasets/9704/annotate/9704-2021_03_20_194315.jpg,479.5,146.5,0.74921875,0.40694444444444444,0.0546875,0.13055555555555556
9704-2021_03_20_194315.jpg,car,35,151,640,30,360,189,1,186,219,LTAdatasets/9704/annotate/9704-2021_03_20_194315.jpg,168.5,204.0,0.26328125,0.5666666666666667,0.0546875,0.08333333333333333
9704-2021_03_20_194315.jpg,bus,112,406,640,124,360,236,5,518,360,LTAdatasets/9704/annotate/9704-2021_03_20_194315.jpg,462.0,298.0,0.721875,0.8277777777777777,0.175,0.34444444444444444
9704-2021_03_20_183712.jpg,car,20,491,640,16,360,112,1,511,128,LTAdatasets/9704/annotate/9704-2021_03_20_183712.jpg,501.0,120.0,0.7828125,0.3333333333333333,0.03125,0.044444444444444446
9704-2021_03_20_183712.jpg,car,25,334,640,19,360,132,1,359,151,LTAdatasets/9704/annotate/9704-2021_03_20_183712.jpg,346.5,141.5,0.54140625,0.39305555555555555,0.0390625,0.05277777777777778
9704-2021_03_20_183712.jpg,car,23,313,640,12,360,127,1,336,139,LTAdatasets/9704/annotate/9704-2021_03_20_183712.jpg,324.5,133.0,0.50703125,0.36944444444444446,0.0359375,0.03333333333333333
9704-2021_03_20_183712.jpg,car,42,202,640,26,360,190,1,244,216,LTAdatasets/9704/annotate/9704-2021_03_20_183712.jpg,223.0,203.0,0.3484375,0.5638888888888889,0.065625,0.07222222222222222
9704-2021_03_20_183712.jpg,car,14,512,640,11,360,89,1,526,100,LTAdatasets/9704/annotate/9704-2021_03_20_183712.jpg,519.0,94.5,0.8109375,0.2625,0.021875,0.030555555555555555
9704-2021_03_20_183712.jpg,car,22,364,640,14,360,101,1,386,115,LTAdatasets/9704/annotate/9704-2021_03_20_183712.jpg,375.0,108.0,0.5859375,0.3,0.034375,0.03888888888888889
9704-2021_03_20_183712.jpg,van,14,493,640,11,360,78,3,507,89,LTAdatasets/9704/annotate/9704-2021_03_20_183712.jpg,500.0,83.5,0.78125,0.23194444444444445,0.021875,0.030555555555555555
9704-2021_03_20_080719.jpg,car,19,519,640,18,360,109,1,538,127,LTAdatasets/9704/annotate/9704-2021_03_20_080719.jpg,528.5,118.0,0.82578125,0.3277777777777778,0.0296875,0.05
9704-2021_03_20_080719.jpg,lorry_truck,32,309,640,22,360,121,2,341,143,LTAdatasets/9704/annotate/9704-2021_03_20_080719.jpg,325.0,132.0,0.5078125,0.36666666666666664,0.05,0.06111111111111111
9704-2021_03_20_080719.jpg,lorry_truck,49,224,640,26,360,133,2,273,159,LTAdatasets/9704/annotate/9704-2021_03_20_080719.jpg,248.5,146.0,0.38828125,0.40555555555555556,0.0765625,0.07222222222222222
9704-2021_03_20_091002.jpg,lorry_truck,29,518,640,46,360,107,2,547,153,LTAdatasets/9704/annotate/9704-2021_03_20_091002.jpg,532.5,130.0,0.83203125,0.3611111111111111,0.0453125,0.12777777777777777
9704-2021_03_20_091002.jpg,car,17,496,640,15,360,113,1,513,128,LTAdatasets/9704/annotate/9704-2021_03_20_091002.jpg,504.5,120.5,0.78828125,0.3347222222222222,0.0265625,0.041666666666666664
9704-2021_03_20_202437.jpg,lorry_truck,26,466,640,43,360,137,2,492,180,LTAdatasets/9704/annotate/9704-2021_03_20_202437.jpg,479.0,158.5,0.7484375,0.44027777777777777,0.040625,0.11944444444444445
9704-2021_03_20_202437.jpg,car,22,519,640,28,360,127,1,541,155,LTAdatasets/9704/annotate/9704-2021_03_20_202437.jpg,530.0,141.0,0.828125,0.39166666666666666,0.034375,0.07777777777777778
9704-2021_03_20_202437.jpg,car,44,369,640,41,360,175,1,413,216,LTAdatasets/9704/annotate/9704-2021_03_20_202437.jpg,391.0,195.5,0.6109375,0.5430555555555555,0.06875,0.11388888888888889
9704-2021_03_20_202437.jpg,bike,11,375,640,12,360,100,4,386,112,LTAdatasets/9704/annotate/9704-2021_03_20_202437.jpg,380.5,106.0,0.59453125,0.29444444444444445,0.0171875,0.03333333333333333
9704-2021_03_20_202437.jpg,bike,9,362,640,17,360,94,4,371,111,LTAdatasets/9704/annotate/9704-2021_03_20_202437.jpg,366.5,102.5,0.57265625,0.2847222222222222,0.0140625,0.04722222222222222
9704-2021_03_20_202437.jpg,van,19,524,640,20,360,96,3,543,116,LTAdatasets/9704/annotate/9704-2021_03_20_202437.jpg,533.5,106.0,0.83359375,0.29444444444444445,0.0296875,0.05555555555555555
9704-2021_03_20_090402.jpg,lorry_truck,50,217,640,28,360,134,2,267,162,LTAdatasets/9704/annotate/9704-2021_03_20_090402.jpg,242.0,148.0,0.378125,0.4111111111111111,0.078125,0.07777777777777778
9704-2021_03_20_090402.jpg,car,15,505,640,18,360,98,1,520,116,LTAdatasets/9704/annotate/9704-2021_03_20_090402.jpg,512.5,107.0,0.80078125,0.2972222222222222,0.0234375,0.05
9704-2021_03_20_090402.jpg,van,30,319,640,21,360,120,3,349,141,LTAdatasets/9704/annotate/9704-2021_03_20_090402.jpg,334.0,130.5,0.521875,0.3625,0.046875,0.058333333333333334
9704-2021_03_20_083340.jpg,lorry_truck,21,513,640,21,360,81,2,534,102,LTAdatasets/9704/annotate/9704-2021_03_20_083340.jpg,523.5,91.5,0.81796875,0.25416666666666665,0.0328125,0.058333333333333334
9704-2021_03_20_083340.jpg,lorry_truck,43,265,640,32,360,112,2,308,144,LTAdatasets/9704/annotate/9704-2021_03_20_083340.jpg,286.5,128.0,0.44765625,0.35555555555555557,0.0671875,0.08888888888888889
9704-2021_03_20_083340.jpg,bike,23,205,640,19,360,175,4,228,194,LTAdatasets/9704/annotate/9704-2021_03_20_083340.jpg,216.5,184.5,0.33828125,0.5125,0.0359375,0.05277777777777778
9704-2021_03_20_203358.jpg,lorry_truck,24,342,640,16,360,95,2,366,111,LTAdatasets/9704/annotate/9704-2021_03_20_203358.jpg,354.0,103.0,0.553125,0.2861111111111111,0.0375,0.044444444444444446
9704-2021_03_20_203358.jpg,van,24,517,640,31,360,133,3,541,164,LTAdatasets/9704/annotate/9704-2021_03_20_203358.jpg,529.0,148.5,0.8265625,0.4125,0.0375,0.08611111111111111
9704-2021_03_20_203358.jpg,bike,13,317,640,26,360,109,4,330,135,LTAdatasets/9704/annotate/9704-2021_03_20_203358.jpg,323.5,122.0,0.50546875,0.3388888888888889,0.0203125,0.07222222222222222
9704-2021_03_20_203358.jpg,car,18,492,640,17,360,106,1,510,123,LTAdatasets/9704/annotate/9704-2021_03_20_203358.jpg,501.0,114.5,0.7828125,0.31805555555555554,0.028125,0.04722222222222222
9704-2021_03_20_203358.jpg,car,15,510,640,15,360,80,1,525,95,LTAdatasets/9704/annotate/9704-2021_03_20_203358.jpg,517.5,87.5,0.80859375,0.24305555555555555,0.0234375,0.041666666666666664
9704-2021_03_20_180110.jpg,car,26,464,640,25,360,142,1,490,167,LTAdatasets/9704/annotate/9704-2021_03_20_180110.jpg,477.0,154.5,0.7453125,0.42916666666666664,0.040625,0.06944444444444445
9704-2021_03_20_180110.jpg,car,15,500,640,21,360,109,1,515,130,LTAdatasets/9704/annotate/9704-2021_03_20_180110.jpg,507.5,119.5,0.79296875,0.33194444444444443,0.0234375,0.058333333333333334
9704-2021_03_20_180110.jpg,bike,17,405,640,26,360,156,4,422,182,LTAdatasets/9704/annotate/9704-2021_03_20_180110.jpg,413.5,169.0,0.64609375,0.46944444444444444,0.0265625,0.07222222222222222
9704-2021_03_20_180110.jpg,car,32,325,640,15,360,117,1,357,132,LTAdatasets/9704/annotate/9704-2021_03_20_180110.jpg,341.0,124.5,0.5328125,0.3458333333333333,0.05,0.041666666666666664
9704-2021_03_20_180110.jpg,car,39,286,640,21,360,147,1,325,168,LTAdatasets/9704/annotate/9704-2021_03_20_180110.jpg,305.5,157.5,0.47734375,0.4375,0.0609375,0.058333333333333334
9704-2021_03_20_180110.jpg,car,41,221,640,18,360,162,1,262,180,LTAdatasets/9704/annotate/9704-2021_03_20_180110.jpg,241.5,171.0,0.37734375,0.475,0.0640625,0.05
9704-2021_03_20_180110.jpg,car,46,197,640,23,360,183,1,243,206,LTAdatasets/9704/annotate/9704-2021_03_20_180110.jpg,220.0,194.5,0.34375,0.5402777777777777,0.071875,0.06388888888888888
9704-2021_03_20_180110.jpg,lorry_truck,54,228,640,30,360,128,2,282,158,LTAdatasets/9704/annotate/9704-2021_03_20_180110.jpg,255.0,143.0,0.3984375,0.3972222222222222,0.084375,0.08333333333333333
9704-2021_03_20_085822.jpg,car,88,193,640,50,360,310,1,281,360,LTAdatasets/9704/annotate/9704-2021_03_20_085822.jpg,237.0,335.0,0.3703125,0.9305555555555556,0.1375,0.1388888888888889
9704-2021_03_20_085822.jpg,bus,25,521,640,51,360,98,5,546,149,LTAdatasets/9704/annotate/9704-2021_03_20_085822.jpg,533.5,123.5,0.83359375,0.34305555555555556,0.0390625,0.14166666666666666
9704-2021_03_20_085822.jpg,lorry_truck,15,511,640,26,360,81,2,526,107,LTAdatasets/9704/annotate/9704-2021_03_20_085822.jpg,518.5,94.0,0.81015625,0.2611111111111111,0.0234375,0.07222222222222222
9704-2021_03_20_085822.jpg,car,15,473,640,17,360,98,1,488,115,LTAdatasets/9704/annotate/9704-2021_03_20_085822.jpg,480.5,106.5,0.75078125,0.29583333333333334,0.0234375,0.04722222222222222
9704-2021_03_20_073417.jpg,car,35,433,640,42,360,173,1,468,215,LTAdatasets/9704/annotate/9704-2021_03_20_073417.jpg,450.5,194.0,0.70390625,0.5388888888888889,0.0546875,0.11666666666666667
9704-2021_03_20_073417.jpg,car,40,294,640,23,360,147,1,334,170,LTAdatasets/9704/annotate/9704-2021_03_20_073417.jpg,314.0,158.5,0.490625,0.44027777777777777,0.0625,0.06388888888888888
9704-2021_03_20_073417.jpg,car,17,504,640,15,360,96,1,521,111,LTAdatasets/9704/annotate/9704-2021_03_20_073417.jpg,512.5,103.5,0.80078125,0.2875,0.0265625,0.041666666666666664
9704-2021_03_20_073417.jpg,car,11,496,640,9,360,78,1,507,87,LTAdatasets/9704/annotate/9704-2021_03_20_073417.jpg,501.5,82.5,0.78359375,0.22916666666666666,0.0171875,0.025
9704-2021_03_20_073417.jpg,bus,29,525,640,48,360,91,5,554,139,LTAdatasets/9704/annotate/9704-2021_03_20_073417.jpg,539.5,115.0,0.84296875,0.3194444444444444,0.0453125,0.13333333333333333
9704-2021_03_20_073417.jpg,lorry_truck,39,321,640,30,360,104,2,360,134,LTAdatasets/9704/annotate/9704-2021_03_20_073417.jpg,340.5,119.0,0.53203125,0.33055555555555555,0.0609375,0.08333333333333333
9704-2021_03_20_073417.jpg,van,14,514,640,15,360,81,3,528,96,LTAdatasets/9704/annotate/9704-2021_03_20_073417.jpg,521.0,88.5,0.8140625,0.24583333333333332,0.021875,0.041666666666666664
9704-2021_03_20_073417.jpg,bike,23,206,640,22,360,149,4,229,171,LTAdatasets/9704/annotate/9704-2021_03_20_073417.jpg,217.5,160.0,0.33984375,0.4444444444444444,0.0359375,0.06111111111111111
9704-2021_03_20_093103.jpg,bike,20,183,640,24,360,201,4,203,225,LTAdatasets/9704/annotate/9704-2021_03_20_093103.jpg,193.0,213.0,0.3015625,0.5916666666666667,0.03125,0.06666666666666667
9704-2021_03_20_093103.jpg,car,48,198,640,26,360,168,1,246,194,LTAdatasets/9704/annotate/9704-2021_03_20_093103.jpg,222.0,181.0,0.346875,0.5027777777777778,0.075,0.07222222222222222
9704-2021_03_20_093103.jpg,car,36,296,640,18,360,129,1,332,147,LTAdatasets/9704/annotate/9704-2021_03_20_093103.jpg,314.0,138.0,0.490625,0.38333333333333336,0.05625,0.05
9704-2021_03_20_093103.jpg,car,47,369,640,40,360,179,1,416,219,LTAdatasets/9704/annotate/9704-2021_03_20_093103.jpg,392.5,199.0,0.61328125,0.5527777777777778,0.0734375,0.1111111111111111
9704-2021_03_20_093103.jpg,car,22,500,640,21,360,99,1,522,120,LTAdatasets/9704/annotate/9704-2021_03_20_093103.jpg,511.0,109.5,0.7984375,0.30416666666666664,0.034375,0.058333333333333334
9704-2021_03_20_191014.jpg,car,16,497,640,24,360,110,1,513,134,LTAdatasets/9704/annotate/9704-2021_03_20_191014.jpg,505.0,122.0,0.7890625,0.3388888888888889,0.025,0.06666666666666667
9704-2021_03_20_191014.jpg,car,31,327,640,23,360,130,1,358,153,LTAdatasets/9704/annotate/9704-2021_03_20_191014.jpg,342.5,141.5,0.53515625,0.39305555555555555,0.0484375,0.06388888888888888
9704-2021_03_20_084901.jpg,lorry_truck,39,425,640,57,360,174,2,464,231,LTAdatasets/9704/annotate/9704-2021_03_20_084901.jpg,444.5,202.5,0.69453125,0.5625,0.0609375,0.15833333333333333
9704-2021_03_20_084901.jpg,van,23,512,640,36,360,128,3,535,164,LTAdatasets/9704/annotate/9704-2021_03_20_084901.jpg,523.5,146.0,0.81796875,0.40555555555555556,0.0359375,0.1
9704-2021_03_20_084901.jpg,van,27,298,640,15,360,115,3,325,130,LTAdatasets/9704/annotate/9704-2021_03_20_084901.jpg,311.5,122.5,0.48671875,0.3402777777777778,0.0421875,0.041666666666666664
9704-2021_03_20_084901.jpg,lorry_truck,12,539,640,20,360,72,2,551,92,LTAdatasets/9704/annotate/9704-2021_03_20_084901.jpg,545.0,82.0,0.8515625,0.22777777777777777,0.01875,0.05555555555555555
9704-2021_03_20_084901.jpg,car,10,524,640,9,360,73,1,534,82,LTAdatasets/9704/annotate/9704-2021_03_20_084901.jpg,529.0,77.5,0.8265625,0.2152777777777778,0.015625,0.025
9704-2021_03_20_185753.jpg,lorry_truck,45,151,640,33,360,176,2,196,209,LTAdatasets/9704/annotate/9704-2021_03_20_185753.jpg,173.5,192.5,0.27109375,0.5347222222222222,0.0703125,0.09166666666666666
9704-2021_03_20_185753.jpg,car,23,335,640,18,360,125,1,358,143,LTAdatasets/9704/annotate/9704-2021_03_20_185753.jpg,346.5,134.0,0.54140625,0.37222222222222223,0.0359375,0.05
9704-2021_03_20_185753.jpg,lorry_truck,15,530,640,20,360,98,2,545,118,LTAdatasets/9704/annotate/9704-2021_03_20_185753.jpg,537.5,108.0,0.83984375,0.3,0.0234375,0.05555555555555555
9704-2021_03_20_185753.jpg,lorry_truck,9,540,640,20,360,67,2,549,87,LTAdatasets/9704/annotate/9704-2021_03_20_185753.jpg,544.5,77.0,0.85078125,0.21388888888888888,0.0140625,0.05555555555555555
9704-2021_03_20_185753.jpg,car,15,517,640,13,360,77,1,532,90,LTAdatasets/9704/annotate/9704-2021_03_20_185753.jpg,524.5,83.5,0.81953125,0.23194444444444445,0.0234375,0.03611111111111111
9704-2021_03_20_193935.jpg,car,43,236,640,31,360,168,1,279,199,LTAdatasets/9704/annotate/9704-2021_03_20_193935.jpg,257.5,183.5,0.40234375,0.5097222222222222,0.0671875,0.08611111111111111
9704-2021_03_20_193935.jpg,lorry_truck,37,195,640,25,360,147,2,232,172,LTAdatasets/9704/annotate/9704-2021_03_20_193935.jpg,213.5,159.5,0.33359375,0.44305555555555554,0.0578125,0.06944444444444445
9704-2021_03_20_193935.jpg,car,23,514,640,26,360,129,1,537,155,LTAdatasets/9704/annotate/9704-2021_03_20_193935.jpg,525.5,142.0,0.82109375,0.39444444444444443,0.0359375,0.07222222222222222
9704-2021_03_20_193935.jpg,car,13,498,640,16,360,103,1,511,119,LTAdatasets/9704/annotate/9704-2021_03_20_193935.jpg,504.5,111.0,0.78828125,0.30833333333333335,0.0203125,0.044444444444444446
9704-2021_03_20_193935.jpg,car,27,428,640,23,360,132,1,455,155,LTAdatasets/9704/annotate/9704-2021_03_20_193935.jpg,441.5,143.5,0.68984375,0.39861111111111114,0.0421875,0.06388888888888888
9704-2021_03_20_192214.jpg,van,44,168,640,31,360,155,3,212,186,LTAdatasets/9704/annotate/9704-2021_03_20_192214.jpg,190.0,170.5,0.296875,0.4736111111111111,0.06875,0.08611111111111111
9704-2021_03_20_192214.jpg,van,36,142,640,33,360,186,3,178,219,LTAdatasets/9704/annotate/9704-2021_03_20_192214.jpg,160.0,202.5,0.25,0.5625,0.05625,0.09166666666666666
9704-2021_03_20_192214.jpg,lorry_truck,29,490,640,45,360,95,2,519,140,LTAdatasets/9704/annotate/9704-2021_03_20_192214.jpg,504.5,117.5,0.78828125,0.3263888888888889,0.0453125,0.125
9704-2021_03_20_192214.jpg,bike,18,378,640,33,360,182,4,396,215,LTAdatasets/9704/annotate/9704-2021_03_20_192214.jpg,387.0,198.5,0.6046875,0.5513888888888889,0.028125,0.09166666666666666
9704-2021_03_20_192214.jpg,car,14,497,640,12,360,76,1,511,88,LTAdatasets/9704/annotate/9704-2021_03_20_192214.jpg,504.0,82.0,0.7875,0.22777777777777777,0.021875,0.03333333333333333
9704-2021_03_20_080419.jpg,car,44,395,640,35,360,174,1,439,209,LTAdatasets/9704/annotate/9704-2021_03_20_080419.jpg,417.0,191.5,0.6515625,0.5319444444444444,0.06875,0.09722222222222222
9704-2021_03_20_080419.jpg,car,48,188,640,30,360,192,1,236,222,LTAdatasets/9704/annotate/9704-2021_03_20_080419.jpg,212.0,207.0,0.33125,0.575,0.075,0.08333333333333333
9704-2021_03_20_080419.jpg,bike,29,512,640,35,360,149,4,541,184,LTAdatasets/9704/annotate/9704-2021_03_20_080419.jpg,526.5,166.5,0.82265625,0.4625,0.0453125,0.09722222222222222
9704-2021_03_20_190634.jpg,car,12,471,640,17,360,99,1,483,116,LTAdatasets/9704/annotate/9704-2021_03_20_190634.jpg,477.0,107.5,0.7453125,0.2986111111111111,0.01875,0.04722222222222222
9704-2021_03_20_190634.jpg,car,29,357,640,14,360,121,1,386,135,LTAdatasets/9704/annotate/9704-2021_03_20_190634.jpg,371.5,128.0,0.58046875,0.35555555555555557,0.0453125,0.03888888888888889
9704-2021_03_20_190634.jpg,van,22,372,640,16,360,96,3,394,112,LTAdatasets/9704/annotate/9704-2021_03_20_190634.jpg,383.0,104.0,0.5984375,0.28888888888888886,0.034375,0.044444444444444446
9704-2021_03_20_190634.jpg,bus,22,527,640,35,360,73,5,549,108,LTAdatasets/9704/annotate/9704-2021_03_20_190634.jpg,538.0,90.5,0.840625,0.2513888888888889,0.034375,0.09722222222222222
9704-2021_03_20_095505.jpg,bus,24,524,640,35,360,83,5,548,118,LTAdatasets/9704/annotate/9704-2021_03_20_095505.jpg,536.0,100.5,0.8375,0.2791666666666667,0.0375,0.09722222222222222
9704-2021_03_20_095505.jpg,car,23,481,640,28,360,111,1,504,139,LTAdatasets/9704/annotate/9704-2021_03_20_095505.jpg,492.5,125.0,0.76953125,0.3472222222222222,0.0359375,0.07777777777777778
9704-2021_03_20_095505.jpg,van,25,462,640,40,360,145,3,487,185,LTAdatasets/9704/annotate/9704-2021_03_20_095505.jpg,474.5,165.0,0.74140625,0.4583333333333333,0.0390625,0.1111111111111111
9704-2021_03_20_095505.jpg,car,26,411,640,30,360,144,1,437,174,LTAdatasets/9704/annotate/9704-2021_03_20_095505.jpg,424.0,159.0,0.6625,0.44166666666666665,0.040625,0.08333333333333333
9704-2021_03_20_095505.jpg,car,69,299,640,45,360,228,1,368,273,LTAdatasets/9704/annotate/9704-2021_03_20_095505.jpg,333.5,250.5,0.52109375,0.6958333333333333,0.1078125,0.125
9704-2021_03_20_095505.jpg,car,15,502,640,27,360,97,1,517,124,LTAdatasets/9704/annotate/9704-2021_03_20_095505.jpg,509.5,110.5,0.79609375,0.30694444444444446,0.0234375,0.075
9704-2021_03_20_095505.jpg,car,29,292,640,19,360,131,1,321,150,LTAdatasets/9704/annotate/9704-2021_03_20_095505.jpg,306.5,140.5,0.47890625,0.3902777777777778,0.0453125,0.05277777777777778
9704-2021_03_20_095505.jpg,car,34,309,640,22,360,142,1,343,164,LTAdatasets/9704/annotate/9704-2021_03_20_095505.jpg,326.0,153.0,0.509375,0.425,0.053125,0.06111111111111111
9704-2021_03_20_095505.jpg,car,42,180,640,25,360,160,1,222,185,LTAdatasets/9704/annotate/9704-2021_03_20_095505.jpg,201.0,172.5,0.3140625,0.4791666666666667,0.065625,0.06944444444444445
9704-2021_03_20_095505.jpg,lorry_truck,42,304,640,25,360,103,2,346,128,LTAdatasets/9704/annotate/9704-2021_03_20_095505.jpg,325.0,115.5,0.5078125,0.32083333333333336,0.065625,0.06944444444444445
9704-2021_03_20_083640.jpg,car,59,338,640,47,360,199,1,397,246,LTAdatasets/9704/annotate/9704-2021_03_20_083640.jpg,367.5,222.5,0.57421875,0.6180555555555556,0.0921875,0.13055555555555556
9704-2021_03_20_083640.jpg,van,36,262,640,29,360,135,3,298,164,LTAdatasets/9704/annotate/9704-2021_03_20_083640.jpg,280.0,149.5,0.4375,0.4152777777777778,0.05625,0.08055555555555556
9704-2021_03_20_083640.jpg,car,18,477,640,15,360,98,1,495,113,LTAdatasets/9704/annotate/9704-2021_03_20_083640.jpg,486.0,105.5,0.759375,0.29305555555555557,0.028125,0.041666666666666664
9704-2021_03_20_180410.jpg,car,41,386,640,38,360,177,1,427,215,LTAdatasets/9704/annotate/9704-2021_03_20_180410.jpg,406.5,196.0,0.63515625,0.5444444444444444,0.0640625,0.10555555555555556
9704-2021_03_20_180410.jpg,car,59,352,640,65,360,276,1,411,341,LTAdatasets/9704/annotate/9704-2021_03_20_180410.jpg,381.5,308.5,0.59609375,0.8569444444444444,0.0921875,0.18055555555555555
9704-2021_03_20_180410.jpg,car,91,194,640,68,360,292,1,285,360,LTAdatasets/9704/annotate/9704-2021_03_20_180410.jpg,239.5,326.0,0.37421875,0.9055555555555556,0.1421875,0.18888888888888888
9704-2021_03_20_180410.jpg,lorry_truck,28,287,640,22,360,113,2,315,135,LTAdatasets/9704/annotate/9704-2021_03_20_180410.jpg,301.0,124.0,0.4703125,0.34444444444444444,0.04375,0.06111111111111111
9704-2021_03_20_080939.jpg,car,47,377,640,52,360,201,1,424,253,LTAdatasets/9704/annotate/9704-2021_03_20_080939.jpg,400.5,227.0,0.62578125,0.6305555555555555,0.0734375,0.14444444444444443
9704-2021_03_20_080939.jpg,lorry_truck,22,531,640,33,360,83,2,553,116,LTAdatasets/9704/annotate/9704-2021_03_20_080939.jpg,542.0,99.5,0.846875,0.2763888888888889,0.034375,0.09166666666666666
9704-2021_03_20_080939.jpg,lorry_truck,17,511,640,27,360,80,2,528,107,LTAdatasets/9704/annotate/9704-2021_03_20_080939.jpg,519.5,93.5,0.81171875,0.25972222222222224,0.0265625,0.075
9704-2021_03_20_080939.jpg,bike,14,482,640,16,360,94,4,496,110,LTAdatasets/9704/annotate/9704-2021_03_20_080939.jpg,489.0,102.0,0.7640625,0.2833333333333333,0.021875,0.044444444444444446
9704-2021_03_20_080939.jpg,car,34,340,640,19,360,123,1,374,142,LTAdatasets/9704/annotate/9704-2021_03_20_080939.jpg,357.0,132.5,0.5578125,0.3680555555555556,0.053125,0.05277777777777778
9704-2021_03_20_080939.jpg,bike,13,319,640,21,360,106,4,332,127,LTAdatasets/9704/annotate/9704-2021_03_20_080939.jpg,325.5,116.5,0.50859375,0.3236111111111111,0.0203125,0.058333333333333334
9704-2021_03_20_181251.jpg,car,85,237,640,69,360,279,1,322,348,LTAdatasets/9704/annotate/9704-2021_03_20_181251.jpg,279.5,313.5,0.43671875,0.8708333333333333,0.1328125,0.19166666666666668
9704-2021_03_20_181251.jpg,car,53,388,640,61,360,223,1,441,284,LTAdatasets/9704/annotate/9704-2021_03_20_181251.jpg,414.5,253.5,0.64765625,0.7041666666666667,0.0828125,0.16944444444444445
9704-2021_03_20_181251.jpg,car,47,148,640,28,360,188,1,195,216,LTAdatasets/9704/annotate/9704-2021_03_20_181251.jpg,171.5,202.0,0.26796875,0.5611111111111111,0.0734375,0.07777777777777778
9704-2021_03_20_181251.jpg,van,19,488,640,25,360,112,3,507,137,LTAdatasets/9704/annotate/9704-2021_03_20_181251.jpg,497.5,124.5,0.77734375,0.3458333333333333,0.0296875,0.06944444444444445
9704-2021_03_20_100105.jpg,van,27,322,640,21,360,115,3,349,136,LTAdatasets/9704/annotate/9704-2021_03_20_100105.jpg,335.5,125.5,0.52421875,0.3486111111111111,0.0421875,0.058333333333333334
9704-2021_03_20_100105.jpg,car,18,480,640,12,360,94,1,498,106,LTAdatasets/9704/annotate/9704-2021_03_20_100105.jpg,489.0,100.0,0.7640625,0.2777777777777778,0.028125,0.03333333333333333
9704-2021_03_20_100105.jpg,car,8,521,640,13,360,80,1,529,93,LTAdatasets/9704/annotate/9704-2021_03_20_100105.jpg,525.0,86.5,0.8203125,0.24027777777777778,0.0125,0.03611111111111111
9704-2021_03_20_100105.jpg,lorry_truck,39,199,640,18,360,155,2,238,173,LTAdatasets/9704/annotate/9704-2021_03_20_100105.jpg,218.5,164.0,0.34140625,0.45555555555555555,0.0609375,0.05
9704-2021_03_20_091623.jpg,lorry_truck,43,218,640,20,360,141,2,261,161,LTAdatasets/9704/annotate/9704-2021_03_20_091623.jpg,239.5,151.0,0.37421875,0.41944444444444445,0.0671875,0.05555555555555555
9704-2021_03_20_091623.jpg,car,19,485,640,27,360,121,1,504,148,LTAdatasets/9704/annotate/9704-2021_03_20_091623.jpg,494.5,134.5,0.77265625,0.3736111111111111,0.0296875,0.075
9704-2021_03_20_073937.jpg,car,27,442,640,25,360,119,1,469,144,LTAdatasets/9704/annotate/9704-2021_03_20_073937.jpg,455.5,131.5,0.71171875,0.36527777777777776,0.0421875,0.06944444444444445
9704-2021_03_20_073937.jpg,van,28,318,640,20,360,119,3,346,139,LTAdatasets/9704/annotate/9704-2021_03_20_073937.jpg,332.0,129.0,0.51875,0.35833333333333334,0.04375,0.05555555555555555
9704-2021_03_20_194616.jpg,lorry_truck,42,407,640,61,360,190,2,449,251,LTAdatasets/9704/annotate/9704-2021_03_20_194616.jpg,428.0,220.5,0.66875,0.6125,0.065625,0.16944444444444445
9704-2021_03_20_194616.jpg,car,55,442,640,57,360,303,1,497,360,LTAdatasets/9704/annotate/9704-2021_03_20_194616.jpg,469.5,331.5,0.73359375,0.9208333333333333,0.0859375,0.15833333333333333
9704-2021_03_20_192735.jpg,car,29,461,640,36,360,143,1,490,179,LTAdatasets/9704/annotate/9704-2021_03_20_192735.jpg,475.5,161.0,0.74296875,0.44722222222222224,0.0453125,0.1
9704-2021_03_20_192735.jpg,car,55,152,640,24,360,186,1,207,210,LTAdatasets/9704/annotate/9704-2021_03_20_192735.jpg,179.5,198.0,0.28046875,0.55,0.0859375,0.06666666666666667
9704-2021_03_20_192735.jpg,car,20,346,640,16,360,111,1,366,127,LTAdatasets/9704/annotate/9704-2021_03_20_192735.jpg,356.0,119.0,0.55625,0.33055555555555555,0.03125,0.044444444444444446
9704-2021_03_20_091903.jpg,car,17,470,640,18,360,107,1,487,125,LTAdatasets/9704/annotate/9704-2021_03_20_091903.jpg,478.5,116.0,0.74765625,0.32222222222222224,0.0265625,0.05
9704-2021_03_20_091903.jpg,lorry_truck,116,417,640,154,360,206,2,533,360,LTAdatasets/9704/annotate/9704-2021_03_20_091903.jpg,475.0,283.0,0.7421875,0.7861111111111111,0.18125,0.42777777777777776
9704-2021_03_20_090702.jpg,car,21,488,640,28,360,119,1,509,147,LTAdatasets/9704/annotate/9704-2021_03_20_090702.jpg,498.5,133.0,0.77890625,0.36944444444444446,0.0328125,0.07777777777777778
9704-2021_03_20_090702.jpg,lorry_truck,48,313,640,36,360,85,2,361,121,LTAdatasets/9704/annotate/9704-2021_03_20_090702.jpg,337.0,103.0,0.5265625,0.2861111111111111,0.075,0.1
9704-2021_03_20_081920.jpg,car,31,472,640,48,360,191,1,503,239,LTAdatasets/9704/annotate/9704-2021_03_20_081920.jpg,487.5,215.0,0.76171875,0.5972222222222222,0.0484375,0.13333333333333333
9704-2021_03_20_081920.jpg,car,31,352,640,23,360,121,1,383,144,LTAdatasets/9704/annotate/9704-2021_03_20_081920.jpg,367.5,132.5,0.57421875,0.3680555555555556,0.0484375,0.06388888888888888
9704-2021_03_20_183952.jpg,lorry_truck,57,230,640,20,360,131,2,287,151,LTAdatasets/9704/annotate/9704-2021_03_20_183952.jpg,258.5,141.0,0.40390625,0.39166666666666666,0.0890625,0.05555555555555555
9704-2021_03_20_183952.jpg,lorry_truck,18,536,640,25,360,72,2,554,97,LTAdatasets/9704/annotate/9704-2021_03_20_183952.jpg,545.0,84.5,0.8515625,0.23472222222222222,0.028125,0.06944444444444445
9704-2021_03_20_183952.jpg,car,19,484,640,18,360,86,1,503,104,LTAdatasets/9704/annotate/9704-2021_03_20_183952.jpg,493.5,95.0,0.77109375,0.2638888888888889,0.0296875,0.05
9704-2021_03_20_082440.jpg,car,22,461,640,38,360,146,1,483,184,LTAdatasets/9704/annotate/9704-2021_03_20_082440.jpg,472.0,165.0,0.7375,0.4583333333333333,0.034375,0.10555555555555556
9704-2021_03_20_082440.jpg,lorry_truck,42,502,640,63,360,145,2,544,208,LTAdatasets/9704/annotate/9704-2021_03_20_082440.jpg,523.0,176.5,0.8171875,0.49027777777777776,0.065625,0.175
9704-2021_03_20_082440.jpg,car,15,537,640,19,360,104,1,552,123,LTAdatasets/9704/annotate/9704-2021_03_20_082440.jpg,544.5,113.5,0.85078125,0.31527777777777777,0.0234375,0.05277777777777778
9704-2021_03_20_182752.jpg,car,49,386,640,61,360,226,1,435,287,LTAdatasets/9704/annotate/9704-2021_03_20_182752.jpg,410.5,256.5,0.64140625,0.7125,0.0765625,0.16944444444444445
9704-2021_03_20_182752.jpg,car,25,430,640,32,360,121,1,455,153,LTAdatasets/9704/annotate/9704-2021_03_20_182752.jpg,442.5,137.0,0.69140625,0.38055555555555554,0.0390625,0.08888888888888889
9704-2021_03_20_182752.jpg,car,30,328,640,22,360,130,1,358,152,LTAdatasets/9704/annotate/9704-2021_03_20_182752.jpg,343.0,141.0,0.5359375,0.39166666666666666,0.046875,0.06111111111111111
9704-2021_03_20_182752.jpg,car,24,360,640,17,360,103,1,384,120,LTAdatasets/9704/annotate/9704-2021_03_20_182752.jpg,372.0,111.5,0.58125,0.30972222222222223,0.0375,0.04722222222222222
9704-2021_03_20_182752.jpg,bike,18,238,640,18,360,139,4,256,157,LTAdatasets/9704/annotate/9704-2021_03_20_182752.jpg,247.0,148.0,0.3859375,0.4111111111111111,0.028125,0.05
9704-2021_03_20_182752.jpg,lorry_truck,20,532,640,24,360,78,2,552,102,LTAdatasets/9704/annotate/9704-2021_03_20_182752.jpg,542.0,90.0,0.846875,0.25,0.03125,0.06666666666666667
9704-2021_03_20_182752.jpg,bike,32,317,640,17,360,80,4,349,97,LTAdatasets/9704/annotate/9704-2021_03_20_182752.jpg,333.0,88.5,0.5203125,0.24583333333333332,0.05,0.04722222222222222
9704-2021_03_20_181011.jpg,car,23,453,640,31,360,155,1,476,186,LTAdatasets/9704/annotate/9704-2021_03_20_181011.jpg,464.5,170.5,0.72578125,0.4736111111111111,0.0359375,0.08611111111111111
9704-2021_03_20_181011.jpg,car,41,268,640,30,360,146,1,309,176,LTAdatasets/9704/annotate/9704-2021_03_20_181011.jpg,288.5,161.0,0.45078125,0.44722222222222224,0.0640625,0.08333333333333333
9704-2021_03_20_181011.jpg,car,17,479,640,16,360,93,1,496,109,LTAdatasets/9704/annotate/9704-2021_03_20_181011.jpg,487.5,101.0,0.76171875,0.28055555555555556,0.0265625,0.044444444444444446
9704-2021_03_20_181011.jpg,bike,9,506,640,15,360,88,4,515,103,LTAdatasets/9704/annotate/9704-2021_03_20_181011.jpg,510.5,95.5,0.79765625,0.2652777777777778,0.0140625,0.041666666666666664
9704-2021_03_20_181011.jpg,bike,12,532,640,19,360,127,4,544,146,LTAdatasets/9704/annotate/9704-2021_03_20_181011.jpg,538.0,136.5,0.840625,0.37916666666666665,0.01875,0.05277777777777778
9704-2021_03_20_181011.jpg,lorry_truck,15,539,640,25,360,66,2,554,91,LTAdatasets/9704/annotate/9704-2021_03_20_181011.jpg,546.5,78.5,0.85390625,0.21805555555555556,0.0234375,0.06944444444444445
9704-2021_03_20_181011.jpg,bus,74,457,640,97,360,186,5,531,283,LTAdatasets/9704/annotate/9704-2021_03_20_181011.jpg,494.0,234.5,0.771875,0.6513888888888889,0.115625,0.26944444444444443
9704-2021_03_20_080119.jpg,lorry_truck,45,506,640,45,360,148,2,551,193,LTAdatasets/9704/annotate/9704-2021_03_20_080119.jpg,528.5,170.5,0.82578125,0.4736111111111111,0.0703125,0.125
9704-2021_03_20_080119.jpg,van,18,498,640,23,360,103,3,516,126,LTAdatasets/9704/annotate/9704-2021_03_20_080119.jpg,507.0,114.5,0.7921875,0.31805555555555554,0.028125,0.06388888888888888
9704-2021_03_20_080119.jpg,bus,21,529,640,38,360,84,5,550,122,LTAdatasets/9704/annotate/9704-2021_03_20_080119.jpg,539.5,103.0,0.84296875,0.2861111111111111,0.0328125,0.10555555555555556
9704-2021_03_20_080119.jpg,car,17,293,640,21,360,156,1,310,177,LTAdatasets/9704/annotate/9704-2021_03_20_080119.jpg,301.5,166.5,0.47109375,0.4625,0.0265625,0.058333333333333334
9704-2021_03_20_084601.jpg,car,30,354,640,20,360,124,1,384,144,LTAdatasets/9704/annotate/9704-2021_03_20_084601.jpg,369.0,134.0,0.5765625,0.37222222222222223,0.046875,0.05555555555555555
9704-2021_03_20_084601.jpg,bike,19,260,640,29,360,141,4,279,170,LTAdatasets/9704/annotate/9704-2021_03_20_084601.jpg,269.5,155.5,0.42109375,0.43194444444444446,0.0296875,0.08055555555555556
9704-2021_03_20_084601.jpg,lorry_truck,32,331,640,26,360,94,2,363,120,LTAdatasets/9704/annotate/9704-2021_03_20_084601.jpg,347.0,107.0,0.5421875,0.2972222222222222,0.05,0.07222222222222222
9704-2021_03_20_084601.jpg,car,16,512,640,14,360,89,1,528,103,LTAdatasets/9704/annotate/9704-2021_03_20_084601.jpg,520.0,96.0,0.8125,0.26666666666666666,0.025,0.03888888888888889
9704-2021_03_20_195736.jpg,bike,35,326,640,43,360,223,4,361,266,LTAdatasets/9704/annotate/9704-2021_03_20_195736.jpg,343.5,244.5,0.53671875,0.6791666666666667,0.0546875,0.11944444444444445
9704-2021_03_20_195736.jpg,bike,9,508,640,14,360,106,4,517,120,LTAdatasets/9704/annotate/9704-2021_03_20_195736.jpg,512.5,113.0,0.80078125,0.3138888888888889,0.0140625,0.03888888888888889
9704-2021_03_20_195736.jpg,van,19,518,640,32,360,126,3,537,158,LTAdatasets/9704/annotate/9704-2021_03_20_195736.jpg,527.5,142.0,0.82421875,0.39444444444444443,0.0296875,0.08888888888888889
9704-2021_03_20_195736.jpg,lorry_truck,68,452,640,93,360,267,2,520,360,LTAdatasets/9704/annotate/9704-2021_03_20_195736.jpg,486.0,313.5,0.759375,0.8708333333333333,0.10625,0.25833333333333336
9704-2021_03_20_195736.jpg,car,41,264,640,19,360,144,1,305,163,LTAdatasets/9704/annotate/9704-2021_03_20_195736.jpg,284.5,153.5,0.44453125,0.4263888888888889,0.0640625,0.05277777777777778
9704-2021_03_20_195736.jpg,car,27,365,640,13,360,100,1,392,113,LTAdatasets/9704/annotate/9704-2021_03_20_195736.jpg,378.5,106.5,0.59140625,0.29583333333333334,0.0421875,0.03611111111111111
9704-2021_03_20_183412.jpg,car,47,187,640,24,360,174,1,234,198,LTAdatasets/9704/annotate/9704-2021_03_20_183412.jpg,210.5,186.0,0.32890625,0.5166666666666667,0.0734375,0.06666666666666667
9704-2021_03_20_183412.jpg,car,22,443,640,21,360,122,1,465,143,LTAdatasets/9704/annotate/9704-2021_03_20_183412.jpg,454.0,132.5,0.709375,0.3680555555555556,0.034375,0.058333333333333334
9704-2021_03_20_183412.jpg,car,14,496,640,17,360,108,1,510,125,LTAdatasets/9704/annotate/9704-2021_03_20_183412.jpg,503.0,116.5,0.7859375,0.3236111111111111,0.021875,0.04722222222222222
9704-2021_03_20_183412.jpg,car,18,482,640,12,360,93,1,500,105,LTAdatasets/9704/annotate/9704-2021_03_20_183412.jpg,491.0,99.0,0.7671875,0.275,0.028125,0.03333333333333333
9704-2021_03_20_183412.jpg,car,11,516,640,16,360,86,1,527,102,LTAdatasets/9704/annotate/9704-2021_03_20_183412.jpg,521.5,94.0,0.81484375,0.2611111111111111,0.0171875,0.044444444444444446
9704-2021_03_20_075138.jpg,car,52,326,640,45,360,214,1,378,259,LTAdatasets/9704/annotate/9704-2021_03_20_075138.jpg,352.0,236.5,0.55,0.6569444444444444,0.08125,0.125
9704-2021_03_20_075138.jpg,car,16,486,640,16,360,110,1,502,126,LTAdatasets/9704/annotate/9704-2021_03_20_075138.jpg,494.0,118.0,0.771875,0.3277777777777778,0.025,0.044444444444444446
9704-2021_03_20_075138.jpg,lorry_truck,67,176,640,47,360,133,2,243,180,LTAdatasets/9704/annotate/9704-2021_03_20_075138.jpg,209.5,156.5,0.32734375,0.43472222222222223,0.1046875,0.13055555555555556
9704-2021_03_20_075138.jpg,lorry_truck,30,304,640,22,360,108,2,334,130,LTAdatasets/9704/annotate/9704-2021_03_20_075138.jpg,319.0,119.0,0.4984375,0.33055555555555555,0.046875,0.06111111111111111
9704-2021_03_20_075138.jpg,car,19,485,640,11,360,94,1,504,105,LTAdatasets/9704/annotate/9704-2021_03_20_075138.jpg,494.5,99.5,0.77265625,0.2763888888888889,0.0296875,0.030555555555555555
9704-2021_03_20_095205.jpg,car,32,386,640,36,360,168,1,418,204,LTAdatasets/9704/annotate/9704-2021_03_20_095205.jpg,402.0,186.0,0.628125,0.5166666666666667,0.05,0.1
9704-2021_03_20_095205.jpg,car,22,490,640,19,360,134,1,512,153,LTAdatasets/9704/annotate/9704-2021_03_20_095205.jpg,501.0,143.5,0.7828125,0.39861111111111114,0.034375,0.05277777777777778
9704-2021_03_20_095205.jpg,car,22,459,640,21,360,114,1,481,135,LTAdatasets/9704/annotate/9704-2021_03_20_095205.jpg,470.0,124.5,0.734375,0.3458333333333333,0.034375,0.058333333333333334
9704-2021_03_20_095205.jpg,car,39,283,640,22,360,152,1,322,174,LTAdatasets/9704/annotate/9704-2021_03_20_095205.jpg,302.5,163.0,0.47265625,0.4527777777777778,0.0609375,0.06111111111111111
9704-2021_03_20_095205.jpg,car,25,351,640,18,360,108,1,376,126,LTAdatasets/9704/annotate/9704-2021_03_20_095205.jpg,363.5,117.0,0.56796875,0.325,0.0390625,0.05
9704-2021_03_20_095205.jpg,lorry_truck,97,416,640,105,360,255,2,513,360,LTAdatasets/9704/annotate/9704-2021_03_20_095205.jpg,464.5,307.5,0.72578125,0.8541666666666666,0.1515625,0.2916666666666667
9704-2021_03_20_095205.jpg,lorry_truck,32,322,640,25,360,95,2,354,120,LTAdatasets/9704/annotate/9704-2021_03_20_095205.jpg,338.0,107.5,0.528125,0.2986111111111111,0.05,0.06944444444444445
9704-2021_03_20_083120.jpg,car,52,389,640,66,360,235,1,441,301,LTAdatasets/9704/annotate/9704-2021_03_20_083120.jpg,415.0,268.0,0.6484375,0.7444444444444445,0.08125,0.18333333333333332
9704-2021_03_20_075518.jpg,car,32,356,640,16,360,118,1,388,134,LTAdatasets/9704/annotate/9704-2021_03_20_075518.jpg,372.0,126.0,0.58125,0.35,0.05,0.044444444444444446
9704-2021_03_20_075518.jpg,car,16,509,640,16,360,95,1,525,111,LTAdatasets/9704/annotate/9704-2021_03_20_075518.jpg,517.0,103.0,0.8078125,0.2861111111111111,0.025,0.044444444444444446
9704-2021_03_20_075518.jpg,bike,14,352,640,17,360,101,4,366,118,LTAdatasets/9704/annotate/9704-2021_03_20_075518.jpg,359.0,109.5,0.5609375,0.30416666666666664,0.021875,0.04722222222222222
9704-2021_03_20_075518.jpg,lorry_truck,55,205,640,35,360,137,2,260,172,LTAdatasets/9704/annotate/9704-2021_03_20_075518.jpg,232.5,154.5,0.36328125,0.42916666666666664,0.0859375,0.09722222222222222
9704-2021_03_20_185453.jpg,lorry_truck,49,491,640,99,360,150,2,540,249,LTAdatasets/9704/annotate/9704-2021_03_20_185453.jpg,515.5,199.5,0.80546875,0.5541666666666667,0.0765625,0.275
9704-2021_03_20_185453.jpg,lorry_truck,18,484,640,22,360,117,2,502,139,LTAdatasets/9704/annotate/9704-2021_03_20_185453.jpg,493.0,128.0,0.7703125,0.35555555555555557,0.028125,0.06111111111111111
9704-2021_03_20_185453.jpg,lorry_truck,16,531,640,18,360,85,2,547,103,LTAdatasets/9704/annotate/9704-2021_03_20_185453.jpg,539.0,94.0,0.8421875,0.2611111111111111,0.025,0.05
9704-2021_03_20_185453.jpg,bike,15,335,640,12,360,119,4,350,131,LTAdatasets/9704/annotate/9704-2021_03_20_185453.jpg,342.5,125.0,0.53515625,0.3472222222222222,0.0234375,0.03333333333333333
9704-2021_03_20_185453.jpg,car,19,386,640,14,360,108,1,405,122,LTAdatasets/9704/annotate/9704-2021_03_20_185453.jpg,395.5,115.0,0.61796875,0.3194444444444444,0.0296875,0.03888888888888889
9704-2021_03_20_094024.jpg,car,29,160,640,27,360,219,1,189,246,LTAdatasets/9704/annotate/9704-2021_03_20_094024.jpg,174.5,232.5,0.27265625,0.6458333333333334,0.0453125,0.075
9704-2021_03_20_094024.jpg,lorry_truck,73,117,640,43,360,152,2,190,195,LTAdatasets/9704/annotate/9704-2021_03_20_094024.jpg,153.5,173.5,0.23984375,0.48194444444444445,0.1140625,0.11944444444444445
9704-2021_03_20_094024.jpg,bike,8,493,640,18,360,92,4,501,110,LTAdatasets/9704/annotate/9704-2021_03_20_094024.jpg,497.0,101.0,0.7765625,0.28055555555555556,0.0125,0.05
1002-2021_03_20_060933.jpg,car,19,258,320,16,240,151,1,277,167,LTAdatasets/1002/annotate/1002-2021_03_20_060933.jpg,267.5,159.0,0.8359375,0.6625,0.059375,0.06666666666666667
1002-2021_03_20_073717.jpg,lorry_truck,24,84,320,29,240,131,2,108,160,LTAdatasets/1002/annotate/1002-2021_03_20_073717.jpg,96.0,145.5,0.3,0.60625,0.075,0.12083333333333333
1002-2021_03_20_073717.jpg,car,11,55,320,11,240,92,1,66,103,LTAdatasets/1002/annotate/1002-2021_03_20_073717.jpg,60.5,97.5,0.1890625,0.40625,0.034375,0.04583333333333333
1002-2021_03_20_073717.jpg,car,11,176,320,9,240,107,1,187,116,LTAdatasets/1002/annotate/1002-2021_03_20_073717.jpg,181.5,111.5,0.5671875,0.46458333333333335,0.034375,0.0375
1002-2021_03_20_073717.jpg,lorry_truck,34,286,320,31,240,120,2,320,151,LTAdatasets/1002/annotate/1002-2021_03_20_073717.jpg,303.0,135.5,0.946875,0.5645833333333333,0.10625,0.12916666666666668
1002-2021_03_20_073717.jpg,car,15,190,320,9,240,111,1,205,120,LTAdatasets/1002/annotate/1002-2021_03_20_073717.jpg,197.5,115.5,0.6171875,0.48125,0.046875,0.0375
1002-2021_03_20_062153.jpg,bike,10,54,320,10,240,86,4,64,96,LTAdatasets/1002/annotate/1002-2021_03_20_062153.jpg,59.0,91.0,0.184375,0.37916666666666665,0.03125,0.041666666666666664
1002-2021_03_20_062153.jpg,car,13,264,320,16,240,144,1,277,160,LTAdatasets/1002/annotate/1002-2021_03_20_062153.jpg,270.5,152.0,0.8453125,0.6333333333333333,0.040625,0.06666666666666667
1002-2021_03_20_062153.jpg,car,19,265,320,13,240,127,1,284,140,LTAdatasets/1002/annotate/1002-2021_03_20_062153.jpg,274.5,133.5,0.8578125,0.55625,0.059375,0.05416666666666667
1002-2021_03_20_062153.jpg,van,12,234,320,14,240,108,3,246,122,LTAdatasets/1002/annotate/1002-2021_03_20_062153.jpg,240.0,115.0,0.75,0.4791666666666667,0.0375,0.058333333333333334
1002-2021_03_20_100705.jpg,car,31,101,320,35,240,181,1,132,216,LTAdatasets/1002/annotate/1002-2021_03_20_100705.jpg,116.5,198.5,0.3640625,0.8270833333333333,0.096875,0.14583333333333334
1002-2021_03_20_100705.jpg,car,22,60,320,29,240,160,1,82,189,LTAdatasets/1002/annotate/1002-2021_03_20_100705.jpg,71.0,174.5,0.221875,0.7270833333333333,0.06875,0.12083333333333333
1002-2021_03_20_100705.jpg,van,11,54,320,12,240,99,3,65,111,LTAdatasets/1002/annotate/1002-2021_03_20_100705.jpg,59.5,105.0,0.1859375,0.4375,0.034375,0.05
1002-2021_03_20_100705.jpg,car,16,265,320,16,240,146,1,281,162,LTAdatasets/1002/annotate/1002-2021_03_20_100705.jpg,273.0,154.0,0.853125,0.6416666666666667,0.05,0.06666666666666667
1002-2021_03_20_073417.jpg,van,12,58,320,9,240,119,3,70,128,LTAdatasets/1002/annotate/1002-2021_03_20_073417.jpg,64.0,123.5,0.2,0.5145833333333333,0.0375,0.0375
1002-2021_03_20_074918.jpg,car,12,73,320,16,240,106,1,85,122,LTAdatasets/1002/annotate/1002-2021_03_20_074918.jpg,79.0,114.0,0.246875,0.475,0.0375,0.06666666666666667
1002-2021_03_20_080719.jpg,bus,29,78,320,53,240,100,5,107,153,LTAdatasets/1002/annotate/1002-2021_03_20_080719.jpg,92.5,126.5,0.2890625,0.5270833333333333,0.090625,0.22083333333333333
1002-2021_03_20_080719.jpg,van,13,54,320,16,240,111,3,67,127,LTAdatasets/1002/annotate/1002-2021_03_20_080719.jpg,60.5,119.0,0.1890625,0.49583333333333335,0.040625,0.06666666666666667
1002-2021_03_20_080719.jpg,van,12,176,320,15,240,103,3,188,118,LTAdatasets/1002/annotate/1002-2021_03_20_080719.jpg,182.0,110.5,0.56875,0.46041666666666664,0.0375,0.0625
1002-2021_03_20_080719.jpg,lorry_truck,53,118,320,34,240,206,2,171,240,LTAdatasets/1002/annotate/1002-2021_03_20_080719.jpg,144.5,223.0,0.4515625,0.9291666666666667,0.165625,0.14166666666666666
1002-2021_03_20_181851.jpg,car,39,100,320,31,240,209,1,139,240,LTAdatasets/1002/annotate/1002-2021_03_20_181851.jpg,119.5,224.5,0.3734375,0.9354166666666667,0.121875,0.12916666666666668
1002-2021_03_20_181851.jpg,bike,7,74,320,11,240,100,4,81,111,LTAdatasets/1002/annotate/1002-2021_03_20_181851.jpg,77.5,105.5,0.2421875,0.4395833333333333,0.021875,0.04583333333333333
1002-2021_03_20_181851.jpg,lorry_truck,17,229,320,21,240,102,2,246,123,LTAdatasets/1002/annotate/1002-2021_03_20_181851.jpg,237.5,112.5,0.7421875,0.46875,0.053125,0.0875
1002-2021_03_20_085141.jpg,car,21,56,320,23,240,140,1,77,163,LTAdatasets/1002/annotate/1002-2021_03_20_085141.jpg,66.5,151.5,0.2078125,0.63125,0.065625,0.09583333333333334
1002-2021_03_20_085141.jpg,car,15,180,320,9,240,106,1,195,115,LTAdatasets/1002/annotate/1002-2021_03_20_085141.jpg,187.5,110.5,0.5859375,0.46041666666666664,0.046875,0.0375
1002-2021_03_20_085141.jpg,car,14,306,320,16,240,137,1,320,153,LTAdatasets/1002/annotate/1002-2021_03_20_085141.jpg,313.0,145.0,0.978125,0.6041666666666666,0.04375,0.06666666666666667
1002-2021_03_20_085141.jpg,lorry_truck,16,253,320,22,240,149,2,269,171,LTAdatasets/1002/annotate/1002-2021_03_20_085141.jpg,261.0,160.0,0.815625,0.6666666666666666,0.05,0.09166666666666666
1002-2021_03_20_085141.jpg,lorry_truck,45,107,320,28,240,212,2,152,240,LTAdatasets/1002/annotate/1002-2021_03_20_085141.jpg,129.5,226.0,0.4046875,0.9416666666666667,0.140625,0.11666666666666667
1002-2021_03_20_203358.jpg,car,14,68,320,15,240,103,1,82,118,LTAdatasets/1002/annotate/1002-2021_03_20_203358.jpg,75.0,110.5,0.234375,0.46041666666666664,0.04375,0.0625
1002-2021_03_20_203358.jpg,car,12,288,320,9,240,143,1,300,152,LTAdatasets/1002/annotate/1002-2021_03_20_203358.jpg,294.0,147.5,0.91875,0.6145833333333334,0.0375,0.0375
1002-2021_03_20_203358.jpg,bike,12,261,320,7,240,126,4,273,133,LTAdatasets/1002/annotate/1002-2021_03_20_203358.jpg,267.0,129.5,0.834375,0.5395833333333333,0.0375,0.029166666666666667
1002-2021_03_20_203358.jpg,car,15,251,320,13,240,148,1,266,161,LTAdatasets/1002/annotate/1002-2021_03_20_203358.jpg,258.5,154.5,0.8078125,0.64375,0.046875,0.05416666666666667
1002-2021_03_20_203358.jpg,car,10,242,320,12,240,115,1,252,127,LTAdatasets/1002/annotate/1002-2021_03_20_203358.jpg,247.0,121.0,0.771875,0.5041666666666667,0.03125,0.05
1002-2021_03_20_194315.jpg,car,17,177,320,10,240,111,1,194,121,LTAdatasets/1002/annotate/1002-2021_03_20_194315.jpg,185.5,116.0,0.5796875,0.48333333333333334,0.053125,0.041666666666666664
1002-2021_03_20_194315.jpg,car,17,264,320,12,240,130,1,281,142,LTAdatasets/1002/annotate/1002-2021_03_20_194315.jpg,272.5,136.0,0.8515625,0.5666666666666667,0.053125,0.05
1002-2021_03_20_194315.jpg,lorry_truck,36,284,320,27,240,121,2,320,148,LTAdatasets/1002/annotate/1002-2021_03_20_194315.jpg,302.0,134.5,0.94375,0.5604166666666667,0.1125,0.1125
1002-2021_03_20_210720.jpg,car,13,184,320,8,240,108,1,197,116,LTAdatasets/1002/annotate/1002-2021_03_20_210720.jpg,190.5,112.0,0.5953125,0.4666666666666667,0.040625,0.03333333333333333
1002-2021_03_20_203658.jpg,car,17,76,320,13,240,115,1,93,128,LTAdatasets/1002/annotate/1002-2021_03_20_203658.jpg,84.5,121.5,0.2640625,0.50625,0.053125,0.05416666666666667
1002-2021_03_20_203658.jpg,car,18,55,320,17,240,112,1,73,129,LTAdatasets/1002/annotate/1002-2021_03_20_203658.jpg,64.0,120.5,0.2,0.5020833333333333,0.05625,0.07083333333333333
1002-2021_03_20_203658.jpg,van,18,302,320,30,240,184,3,320,214,LTAdatasets/1002/annotate/1002-2021_03_20_203658.jpg,311.0,199.0,0.971875,0.8291666666666667,0.05625,0.125
1002-2021_03_20_184913.jpg,car,42,112,320,28,240,212,1,154,240,LTAdatasets/1002/annotate/1002-2021_03_20_184913.jpg,133.0,226.0,0.415625,0.9416666666666667,0.13125,0.11666666666666667
1002-2021_03_20_184913.jpg,lorry_truck,29,66,320,41,240,105,2,95,146,LTAdatasets/1002/annotate/1002-2021_03_20_184913.jpg,80.5,125.5,0.2515625,0.5229166666666667,0.090625,0.17083333333333334
1002-2021_03_20_184913.jpg,car,18,258,320,16,240,153,1,276,169,LTAdatasets/1002/annotate/1002-2021_03_20_184913.jpg,267.0,161.0,0.834375,0.6708333333333333,0.05625,0.06666666666666667
1002-2021_03_20_184913.jpg,car,12,173,320,9,240,101,1,185,110,LTAdatasets/1002/annotate/1002-2021_03_20_184913.jpg,179.0,105.5,0.559375,0.4395833333333333,0.0375,0.0375
1002-2021_03_20_184913.jpg,bike,11,50,320,15,240,122,4,61,137,LTAdatasets/1002/annotate/1002-2021_03_20_184913.jpg,55.5,129.5,0.1734375,0.5395833333333333,0.034375,0.0625
1002-2021_03_20_191614.jpg,lorry_truck,25,85,320,34,240,131,2,110,165,LTAdatasets/1002/annotate/1002-2021_03_20_191614.jpg,97.5,148.0,0.3046875,0.6166666666666667,0.078125,0.14166666666666666
1002-2021_03_20_191614.jpg,car,39,119,320,28,240,212,1,158,240,LTAdatasets/1002/annotate/1002-2021_03_20_191614.jpg,138.5,226.0,0.4328125,0.9416666666666667,0.121875,0.11666666666666667
1002-2021_03_20_191614.jpg,car,9,184,320,11,240,103,1,193,114,LTAdatasets/1002/annotate/1002-2021_03_20_191614.jpg,188.5,108.5,0.5890625,0.45208333333333334,0.028125,0.04583333333333333
1002-2021_03_20_191614.jpg,car,13,173,320,13,240,105,1,186,118,LTAdatasets/1002/annotate/1002-2021_03_20_191614.jpg,179.5,111.5,0.5609375,0.46458333333333335,0.040625,0.05416666666666667
1002-2021_03_20_082220.jpg,car,20,58,320,27,240,152,1,78,179,LTAdatasets/1002/annotate/1002-2021_03_20_082220.jpg,68.0,165.5,0.2125,0.6895833333333333,0.0625,0.1125
1002-2021_03_20_082220.jpg,car,9,179,320,12,240,102,1,188,114,LTAdatasets/1002/annotate/1002-2021_03_20_082220.jpg,183.5,108.0,0.5734375,0.45,0.028125,0.05
1002-2021_03_20_082220.jpg,van,16,304,320,17,240,134,3,320,151,LTAdatasets/1002/annotate/1002-2021_03_20_082220.jpg,312.0,142.5,0.975,0.59375,0.05,0.07083333333333333
1002-2021_03_20_070716.jpg,bike,15,60,320,16,240,139,4,75,155,LTAdatasets/1002/annotate/1002-2021_03_20_070716.jpg,67.5,147.0,0.2109375,0.6125,0.046875,0.06666666666666667
1002-2021_03_20_070716.jpg,car,25,253,320,19,240,150,1,278,169,LTAdatasets/1002/annotate/1002-2021_03_20_070716.jpg,265.5,159.5,0.8296875,0.6645833333333333,0.078125,0.07916666666666666
1002-2021_03_20_070716.jpg,van,17,237,320,13,240,105,3,254,118,LTAdatasets/1002/annotate/1002-2021_03_20_070716.jpg,245.5,111.5,0.7671875,0.46458333333333335,0.053125,0.05416666666666667
1002-2021_03_20_081319.jpg,van,44,88,320,46,240,174,3,132,220,LTAdatasets/1002/annotate/1002-2021_03_20_081319.jpg,110.0,197.0,0.34375,0.8208333333333333,0.1375,0.19166666666666668
1002-2021_03_20_081319.jpg,van,15,249,320,12,240,119,3,264,131,LTAdatasets/1002/annotate/1002-2021_03_20_081319.jpg,256.5,125.0,0.8015625,0.5208333333333334,0.046875,0.05
1002-2021_03_20_081319.jpg,car,9,171,320,9,240,103,1,180,112,LTAdatasets/1002/annotate/1002-2021_03_20_081319.jpg,175.5,107.5,0.5484375,0.4479166666666667,0.028125,0.0375
1002-2021_03_20_064855.jpg,lorry_truck,39,54,320,69,240,138,2,93,207,LTAdatasets/1002/annotate/1002-2021_03_20_064855.jpg,73.5,172.5,0.2296875,0.71875,0.121875,0.2875
1002-2021_03_20_214602.jpg,car,13,307,320,14,240,141,1,320,155,LTAdatasets/1002/annotate/1002-2021_03_20_214602.jpg,313.5,148.0,0.9796875,0.6166666666666667,0.040625,0.058333333333333334
1002-2021_03_20_214602.jpg,car,15,273,320,8,240,128,1,288,136,LTAdatasets/1002/annotate/1002-2021_03_20_214602.jpg,280.5,132.0,0.8765625,0.55,0.046875,0.03333333333333333
1002-2021_03_20_214602.jpg,car,14,54,320,11,240,102,1,68,113,LTAdatasets/1002/annotate/1002-2021_03_20_214602.jpg,61.0,107.5,0.190625,0.4479166666666667,0.04375,0.04583333333333333
1002-2021_03_20_214602.jpg,car,18,302,320,27,240,183,1,320,210,LTAdatasets/1002/annotate/1002-2021_03_20_214602.jpg,311.0,196.5,0.971875,0.81875,0.05625,0.1125
1002-2021_03_20_214602.jpg,car,10,52,320,8,240,82,1,62,90,LTAdatasets/1002/annotate/1002-2021_03_20_214602.jpg,57.0,86.0,0.178125,0.35833333333333334,0.03125,0.03333333333333333
1002-2021_03_20_214602.jpg,car,11,65,320,9,240,81,1,76,90,LTAdatasets/1002/annotate/1002-2021_03_20_214602.jpg,70.5,85.5,0.2203125,0.35625,0.034375,0.0375
1002-2021_03_20_065755.jpg,car,12,64,320,10,240,88,1,76,98,LTAdatasets/1002/annotate/1002-2021_03_20_065755.jpg,70.0,93.0,0.21875,0.3875,0.0375,0.041666666666666664
1002-2021_03_20_065755.jpg,car,10,174,320,8,240,102,1,184,110,LTAdatasets/1002/annotate/1002-2021_03_20_065755.jpg,179.0,106.0,0.559375,0.44166666666666665,0.03125,0.03333333333333333
1002-2021_03_20_065755.jpg,car,13,190,320,8,240,94,1,203,102,LTAdatasets/1002/annotate/1002-2021_03_20_065755.jpg,196.5,98.0,0.6140625,0.4083333333333333,0.040625,0.03333333333333333
1002-2021_03_20_065155.jpg,bus,37,283,320,33,240,121,5,320,154,LTAdatasets/1002/annotate/1002-2021_03_20_065155.jpg,301.5,137.5,0.9421875,0.5729166666666666,0.115625,0.1375
1002-2021_03_20_065155.jpg,car,12,55,320,17,240,92,1,67,109,LTAdatasets/1002/annotate/1002-2021_03_20_065155.jpg,61.0,100.5,0.190625,0.41875,0.0375,0.07083333333333333
1002-2021_03_20_184613.jpg,car,15,57,320,20,240,126,1,72,146,LTAdatasets/1002/annotate/1002-2021_03_20_184613.jpg,64.5,136.0,0.2015625,0.5666666666666667,0.046875,0.08333333333333333
1002-2021_03_20_184613.jpg,car,13,255,320,13,240,123,1,268,136,LTAdatasets/1002/annotate/1002-2021_03_20_184613.jpg,261.5,129.5,0.8171875,0.5395833333333333,0.040625,0.05416666666666667
1002-2021_03_20_184613.jpg,car,15,277,320,15,240,128,1,292,143,LTAdatasets/1002/annotate/1002-2021_03_20_184613.jpg,284.5,135.5,0.8890625,0.5645833333333333,0.046875,0.0625
1002-2021_03_20_184613.jpg,car,11,172,320,10,240,98,1,183,108,LTAdatasets/1002/annotate/1002-2021_03_20_184613.jpg,177.5,103.0,0.5546875,0.42916666666666664,0.034375,0.041666666666666664
1002-2021_03_20_204238.jpg,car,22,84,320,22,240,138,1,106,160,LTAdatasets/1002/annotate/1002-2021_03_20_204238.jpg,95.0,149.0,0.296875,0.6208333333333333,0.06875,0.09166666666666666
1002-2021_03_20_204238.jpg,car,40,59,320,48,240,177,1,99,225,LTAdatasets/1002/annotate/1002-2021_03_20_204238.jpg,79.0,201.0,0.246875,0.8375,0.125,0.2
1002-2021_03_20_204238.jpg,car,16,295,320,12,240,133,1,311,145,LTAdatasets/1002/annotate/1002-2021_03_20_204238.jpg,303.0,139.0,0.946875,0.5791666666666667,0.05,0.05
1002-2021_03_20_204238.jpg,car,17,270,320,15,240,125,1,287,140,LTAdatasets/1002/annotate/1002-2021_03_20_204238.jpg,278.5,132.5,0.8703125,0.5520833333333334,0.053125,0.0625
1002-2021_03_20_204238.jpg,car,11,173,320,9,240,102,1,184,111,LTAdatasets/1002/annotate/1002-2021_03_20_204238.jpg,178.5,106.5,0.5578125,0.44375,0.034375,0.0375
1002-2021_03_20_213341.jpg,car,15,247,320,14,240,121,1,262,135,LTAdatasets/1002/annotate/1002-2021_03_20_213341.jpg,254.5,128.0,0.7953125,0.5333333333333333,0.046875,0.058333333333333334
1002-2021_03_20_213341.jpg,car,11,65,320,8,240,85,1,76,93,LTAdatasets/1002/annotate/1002-2021_03_20_213341.jpg,70.5,89.0,0.2203125,0.37083333333333335,0.034375,0.03333333333333333
1002-2021_03_20_195136.jpg,car,8,56,320,13,240,98,1,64,111,LTAdatasets/1002/annotate/1002-2021_03_20_195136.jpg,60.0,104.5,0.1875,0.4354166666666667,0.025,0.05416666666666667
1002-2021_03_20_195136.jpg,van,12,171,320,10,240,102,3,183,112,LTAdatasets/1002/annotate/1002-2021_03_20_195136.jpg,177.0,107.0,0.553125,0.44583333333333336,0.0375,0.041666666666666664
1002-2021_03_20_195136.jpg,car,16,282,320,11,240,129,1,298,140,LTAdatasets/1002/annotate/1002-2021_03_20_195136.jpg,290.0,134.5,0.90625,0.5604166666666667,0.05,0.04583333333333333
1002-2021_03_20_195136.jpg,car,16,264,320,12,240,133,1,280,145,LTAdatasets/1002/annotate/1002-2021_03_20_195136.jpg,272.0,139.0,0.85,0.5791666666666667,0.05,0.05
1002-2021_03_20_200116.jpg,car,20,86,320,21,240,143,1,106,164,LTAdatasets/1002/annotate/1002-2021_03_20_200116.jpg,96.0,153.5,0.3,0.6395833333333333,0.0625,0.0875
1002-2021_03_20_200116.jpg,car,19,58,320,20,240,145,1,77,165,LTAdatasets/1002/annotate/1002-2021_03_20_200116.jpg,67.5,155.0,0.2109375,0.6458333333333334,0.059375,0.08333333333333333
1002-2021_03_20_200116.jpg,lorry_truck,10,59,320,17,240,103,2,69,120,LTAdatasets/1002/annotate/1002-2021_03_20_200116.jpg,64.0,111.5,0.2,0.46458333333333335,0.03125,0.07083333333333333
1002-2021_03_20_200116.jpg,car,13,70,320,15,240,94,1,83,109,LTAdatasets/1002/annotate/1002-2021_03_20_200116.jpg,76.5,101.5,0.2390625,0.42291666666666666,0.040625,0.0625
1002-2021_03_20_200116.jpg,car,15,181,320,10,240,114,1,196,124,LTAdatasets/1002/annotate/1002-2021_03_20_200116.jpg,188.5,119.0,0.5890625,0.49583333333333335,0.046875,0.041666666666666664
1002-2021_03_20_063354.jpg,bike,14,98,320,27,240,174,4,112,201,LTAdatasets/1002/annotate/1002-2021_03_20_063354.jpg,105.0,187.5,0.328125,0.78125,0.04375,0.1125
1002-2021_03_20_063354.jpg,car,15,53,320,10,240,93,1,68,103,LTAdatasets/1002/annotate/1002-2021_03_20_063354.jpg,60.5,98.0,0.1890625,0.4083333333333333,0.046875,0.041666666666666664
1002-2021_03_20_084301.jpg,lorry_truck,17,291,320,15,240,129,2,308,144,LTAdatasets/1002/annotate/1002-2021_03_20_084301.jpg,299.5,136.5,0.9359375,0.56875,0.053125,0.0625
1002-2021_03_20_084301.jpg,lorry_truck,19,234,320,18,240,107,2,253,125,LTAdatasets/1002/annotate/1002-2021_03_20_084301.jpg,243.5,116.0,0.7609375,0.48333333333333334,0.059375,0.075
1002-2021_03_20_084301.jpg,car,9,72,320,9,240,98,1,81,107,LTAdatasets/1002/annotate/1002-2021_03_20_084301.jpg,76.5,102.5,0.2390625,0.4270833333333333,0.028125,0.0375
1002-2021_03_20_194916.jpg,van,23,89,320,28,240,137,3,112,165,LTAdatasets/1002/annotate/1002-2021_03_20_194916.jpg,100.5,151.0,0.3140625,0.6291666666666667,0.071875,0.11666666666666667
1002-2021_03_20_194916.jpg,van,10,54,320,14,240,90,3,64,104,LTAdatasets/1002/annotate/1002-2021_03_20_194916.jpg,59.0,97.0,0.184375,0.4041666666666667,0.03125,0.058333333333333334
1002-2021_03_20_194916.jpg,car,31,60,320,38,240,183,1,91,221,LTAdatasets/1002/annotate/1002-2021_03_20_194916.jpg,75.5,202.0,0.2359375,0.8416666666666667,0.096875,0.15833333333333333
1002-2021_03_20_194916.jpg,car,13,266,320,16,240,145,1,279,161,LTAdatasets/1002/annotate/1002-2021_03_20_194916.jpg,272.5,153.0,0.8515625,0.6375,0.040625,0.06666666666666667
1002-2021_03_20_194916.jpg,car,13,174,320,9,240,108,1,187,117,LTAdatasets/1002/annotate/1002-2021_03_20_194916.jpg,180.5,112.5,0.5640625,0.46875,0.040625,0.0375
1002-2021_03_20_074318.jpg,van,15,238,320,15,240,109,3,253,124,LTAdatasets/1002/annotate/1002-2021_03_20_074318.jpg,245.5,116.5,0.7671875,0.48541666666666666,0.046875,0.0625
1002-2021_03_20_192735.jpg,lorry_truck,31,60,320,49,240,166,2,91,215,LTAdatasets/1002/annotate/1002-2021_03_20_192735.jpg,75.5,190.5,0.2359375,0.79375,0.096875,0.20416666666666666
1002-2021_03_20_192735.jpg,lorry_truck,17,232,320,17,240,104,2,249,121,LTAdatasets/1002/annotate/1002-2021_03_20_192735.jpg,240.5,112.5,0.7515625,0.46875,0.053125,0.07083333333333333
1002-2021_03_20_093724.jpg,lorry_truck,31,61,320,49,240,168,2,92,217,LTAdatasets/1002/annotate/1002-2021_03_20_093724.jpg,76.5,192.5,0.2390625,0.8020833333333334,0.096875,0.20416666666666666
1002-2021_03_20_093724.jpg,car,19,262,320,15,240,145,1,281,160,LTAdatasets/1002/annotate/1002-2021_03_20_093724.jpg,271.5,152.5,0.8484375,0.6354166666666666,0.059375,0.0625
1002-2021_03_20_093724.jpg,van,9,70,320,15,240,88,3,79,103,LTAdatasets/1002/annotate/1002-2021_03_20_093724.jpg,74.5,95.5,0.2328125,0.39791666666666664,0.028125,0.0625
1002-2021_03_20_085822.jpg,lorry_truck,40,247,320,25,240,110,2,287,135,LTAdatasets/1002/annotate/1002-2021_03_20_085822.jpg,267.0,122.5,0.834375,0.5104166666666666,0.125,0.10416666666666667
1002-2021_03_20_083340.jpg,car,24,56,320,33,240,170,1,80,203,LTAdatasets/1002/annotate/1002-2021_03_20_083340.jpg,68.0,186.5,0.2125,0.7770833333333333,0.075,0.1375
1002-2021_03_20_083340.jpg,van,16,51,320,18,240,102,3,67,120,LTAdatasets/1002/annotate/1002-2021_03_20_083340.jpg,59.0,111.0,0.184375,0.4625,0.05,0.075
1002-2021_03_20_083340.jpg,van,10,67,320,13,240,93,3,77,106,LTAdatasets/1002/annotate/1002-2021_03_20_083340.jpg,72.0,99.5,0.225,0.41458333333333336,0.03125,0.05416666666666667
1002-2021_03_20_083340.jpg,car,17,260,320,14,240,146,1,277,160,LTAdatasets/1002/annotate/1002-2021_03_20_083340.jpg,268.5,153.0,0.8390625,0.6375,0.053125,0.058333333333333334
1002-2021_03_20_095205.jpg,car,15,77,320,15,240,121,1,92,136,LTAdatasets/1002/annotate/1002-2021_03_20_095205.jpg,84.5,128.5,0.2640625,0.5354166666666667,0.046875,0.0625
1002-2021_03_20_095205.jpg,car,12,177,320,9,240,102,1,189,111,LTAdatasets/1002/annotate/1002-2021_03_20_095205.jpg,183.0,106.5,0.571875,0.44375,0.0375,0.0375
1002-2021_03_20_095205.jpg,car,15,256,320,24,240,156,1,271,180,LTAdatasets/1002/annotate/1002-2021_03_20_095205.jpg,263.5,168.0,0.8234375,0.7,0.046875,0.1
1002-2021_03_20_094904.jpg,car,25,55,320,25,240,150,1,80,175,LTAdatasets/1002/annotate/1002-2021_03_20_094904.jpg,67.5,162.5,0.2109375,0.6770833333333334,0.078125,0.10416666666666667
1002-2021_03_20_094904.jpg,car,38,113,320,33,240,207,1,151,240,LTAdatasets/1002/annotate/1002-2021_03_20_094904.jpg,132.0,223.5,0.4125,0.93125,0.11875,0.1375
1002-2021_03_20_094904.jpg,car,11,56,320,12,240,104,1,67,116,LTAdatasets/1002/annotate/1002-2021_03_20_094904.jpg,61.5,110.0,0.1921875,0.4583333333333333,0.034375,0.05
1002-2021_03_20_094904.jpg,car,13,179,320,9,240,110,1,192,119,LTAdatasets/1002/annotate/1002-2021_03_20_094904.jpg,185.5,114.5,0.5796875,0.47708333333333336,0.040625,0.0375
1002-2021_03_20_094904.jpg,lorry_truck,56,264,320,49,240,148,2,320,197,LTAdatasets/1002/annotate/1002-2021_03_20_094904.jpg,292.0,172.5,0.9125,0.71875,0.175,0.20416666666666666
1002-2021_03_20_075818.jpg,bike,13,57,320,21,240,135,4,70,156,LTAdatasets/1002/annotate/1002-2021_03_20_075818.jpg,63.5,145.5,0.1984375,0.60625,0.040625,0.0875
1002-2021_03_20_075818.jpg,lorry_truck,16,171,320,16,240,102,2,187,118,LTAdatasets/1002/annotate/1002-2021_03_20_075818.jpg,179.0,110.0,0.559375,0.4583333333333333,0.05,0.06666666666666667
1002-2021_03_20_183112.jpg,car,14,55,320,15,240,105,1,69,120,LTAdatasets/1002/annotate/1002-2021_03_20_183112.jpg,62.0,112.5,0.19375,0.46875,0.04375,0.0625
1002-2021_03_20_183112.jpg,car,15,305,320,21,240,167,1,320,188,LTAdatasets/1002/annotate/1002-2021_03_20_183112.jpg,312.5,177.5,0.9765625,0.7395833333333334,0.046875,0.0875
1002-2021_03_20_183112.jpg,car,31,78,320,23,240,217,1,109,240,LTAdatasets/1002/annotate/1002-2021_03_20_183112.jpg,93.5,228.5,0.2921875,0.9520833333333333,0.096875,0.09583333333333334
1002-2021_03_20_183112.jpg,bus,28,180,320,27,240,97,5,208,124,LTAdatasets/1002/annotate/1002-2021_03_20_183112.jpg,194.0,110.5,0.60625,0.46041666666666664,0.0875,0.1125
1002-2021_03_20_183112.jpg,car,20,255,320,13,240,123,1,275,136,LTAdatasets/1002/annotate/1002-2021_03_20_183112.jpg,265.0,129.5,0.828125,0.5395833333333333,0.0625,0.05416666666666667
1002-2021_03_20_183712.jpg,car,15,55,320,22,240,136,1,70,158,LTAdatasets/1002/annotate/1002-2021_03_20_183712.jpg,62.5,147.0,0.1953125,0.6125,0.046875,0.09166666666666666
1002-2021_03_20_183712.jpg,car,9,55,320,15,240,98,1,64,113,LTAdatasets/1002/annotate/1002-2021_03_20_183712.jpg,59.5,105.5,0.1859375,0.4395833333333333,0.028125,0.0625
1002-2021_03_20_183712.jpg,car,11,170,320,5,240,103,1,181,108,LTAdatasets/1002/annotate/1002-2021_03_20_183712.jpg,175.5,105.5,0.5484375,0.4395833333333333,0.034375,0.020833333333333332
1002-2021_03_20_183712.jpg,car,12,260,320,14,240,116,1,272,130,LTAdatasets/1002/annotate/1002-2021_03_20_183712.jpg,266.0,123.0,0.83125,0.5125,0.0375,0.058333333333333334
1002-2021_03_20_220403.jpg,lorry_truck,15,55,320,27,240,87,2,70,114,LTAdatasets/1002/annotate/1002-2021_03_20_220403.jpg,62.5,100.5,0.1953125,0.41875,0.046875,0.1125
1002-2021_03_20_220403.jpg,car,17,303,320,17,240,145,1,320,162,LTAdatasets/1002/annotate/1002-2021_03_20_220403.jpg,311.5,153.5,0.9734375,0.6395833333333333,0.053125,0.07083333333333333
1002-2021_03_20_202758.jpg,van,19,264,320,14,240,122,3,283,136,LTAdatasets/1002/annotate/1002-2021_03_20_202758.jpg,273.5,129.0,0.8546875,0.5375,0.059375,0.058333333333333334
1002-2021_03_20_202758.jpg,lorry_truck,14,306,320,21,240,129,2,320,150,LTAdatasets/1002/annotate/1002-2021_03_20_202758.jpg,313.0,139.5,0.978125,0.58125,0.04375,0.0875
1002-2021_03_20_202758.jpg,car,14,180,320,11,240,109,1,194,120,LTAdatasets/1002/annotate/1002-2021_03_20_202758.jpg,187.0,114.5,0.584375,0.47708333333333336,0.04375,0.04583333333333333
1002-2021_03_20_100405.jpg,car,39,97,320,33,240,188,1,136,221,LTAdatasets/1002/annotate/1002-2021_03_20_100405.jpg,116.5,204.5,0.3640625,0.8520833333333333,0.121875,0.1375
1002-2021_03_20_100405.jpg,lorry_truck,12,228,320,19,240,96,2,240,115,LTAdatasets/1002/annotate/1002-2021_03_20_100405.jpg,234.0,105.5,0.73125,0.4395833333333333,0.0375,0.07916666666666666
1002-2021_03_20_201917.jpg,lorry_truck,17,265,320,19,240,113,2,282,132,LTAdatasets/1002/annotate/1002-2021_03_20_201917.jpg,273.5,122.5,0.8546875,0.5104166666666666,0.053125,0.07916666666666666
1002-2021_03_20_201917.jpg,car,18,231,320,10,240,116,1,249,126,LTAdatasets/1002/annotate/1002-2021_03_20_201917.jpg,240.0,121.0,0.75,0.5041666666666667,0.05625,0.041666666666666664
1002-2021_03_20_201917.jpg,car,16,279,320,9,240,141,1,295,150,LTAdatasets/1002/annotate/1002-2021_03_20_201917.jpg,287.0,145.5,0.896875,0.60625,0.05,0.0375
1002-2021_03_20_081920.jpg,van,24,85,320,32,240,145,3,109,177,LTAdatasets/1002/annotate/1002-2021_03_20_081920.jpg,97.0,161.0,0.303125,0.6708333333333333,0.075,0.13333333333333333
1002-2021_03_20_081920.jpg,car,14,67,320,12,240,96,1,81,108,LTAdatasets/1002/annotate/1002-2021_03_20_081920.jpg,74.0,102.0,0.23125,0.425,0.04375,0.05
1002-2021_03_20_071616.jpg,van,33,62,320,57,240,172,3,95,229,LTAdatasets/1002/annotate/1002-2021_03_20_071616.jpg,78.5,200.5,0.2453125,0.8354166666666667,0.103125,0.2375
1002-2021_03_20_071616.jpg,lorry_truck,18,56,320,29,240,105,2,74,134,LTAdatasets/1002/annotate/1002-2021_03_20_071616.jpg,65.0,119.5,0.203125,0.4979166666666667,0.05625,0.12083333333333333
1002-2021_03_20_071616.jpg,car,12,170,320,9,240,104,1,182,113,LTAdatasets/1002/annotate/1002-2021_03_20_071616.jpg,176.0,108.5,0.55,0.45208333333333334,0.0375,0.0375
1002-2021_03_20_212801.jpg,car,15,277,320,11,240,134,1,292,145,LTAdatasets/1002/annotate/1002-2021_03_20_212801.jpg,284.5,139.5,0.8890625,0.58125,0.046875,0.04583333333333333
1002-2021_03_20_212801.jpg,car,18,266,320,11,240,121,1,284,132,LTAdatasets/1002/annotate/1002-2021_03_20_212801.jpg,275.0,126.5,0.859375,0.5270833333333333,0.05625,0.04583333333333333
1002-2021_03_20_212801.jpg,car,17,178,320,13,240,108,1,195,121,LTAdatasets/1002/annotate/1002-2021_03_20_212801.jpg,186.5,114.5,0.5828125,0.47708333333333336,0.053125,0.05416666666666667
1002-2021_03_20_212801.jpg,car,17,55,320,15,240,125,1,72,140,LTAdatasets/1002/annotate/1002-2021_03_20_212801.jpg,63.5,132.5,0.1984375,0.5520833333333334,0.053125,0.0625
1002-2021_03_20_212801.jpg,car,11,52,320,11,240,92,1,63,103,LTAdatasets/1002/annotate/1002-2021_03_20_212801.jpg,57.5,97.5,0.1796875,0.40625,0.034375,0.04583333333333333
1002-2021_03_20_212801.jpg,car,13,67,320,13,240,93,1,80,106,LTAdatasets/1002/annotate/1002-2021_03_20_212801.jpg,73.5,99.5,0.2296875,0.41458333333333336,0.040625,0.05416666666666667
1002-2021_03_20_191234.jpg,lorry_truck,42,257,320,30,240,106,2,299,136,LTAdatasets/1002/annotate/1002-2021_03_20_191234.jpg,278.0,121.0,0.86875,0.5041666666666667,0.13125,0.125
1002-2021_03_20_072216.jpg,car,14,53,320,11,240,89,1,67,100,LTAdatasets/1002/annotate/1002-2021_03_20_072216.jpg,60.0,94.5,0.1875,0.39375,0.04375,0.04583333333333333
1002-2021_03_20_072216.jpg,car,11,173,320,10,240,107,1,184,117,LTAdatasets/1002/annotate/1002-2021_03_20_072216.jpg,178.5,112.0,0.5578125,0.4666666666666667,0.034375,0.041666666666666664
1002-2021_03_20_220643.jpg,car,27,67,320,32,240,189,1,94,221,LTAdatasets/1002/annotate/1002-2021_03_20_220643.jpg,80.5,205.0,0.2515625,0.8541666666666666,0.084375,0.13333333333333333
1002-2021_03_20_220643.jpg,van,14,52,320,16,240,91,3,66,107,LTAdatasets/1002/annotate/1002-2021_03_20_220643.jpg,59.0,99.0,0.184375,0.4125,0.04375,0.06666666666666667
1002-2021_03_20_220643.jpg,car,15,264,320,11,240,122,1,279,133,LTAdatasets/1002/annotate/1002-2021_03_20_220643.jpg,271.5,127.5,0.8484375,0.53125,0.046875,0.04583333333333333
1002-2021_03_20_211300.jpg,car,16,259,320,14,240,120,1,275,134,LTAdatasets/1002/annotate/1002-2021_03_20_211300.jpg,267.0,127.0,0.834375,0.5291666666666667,0.05,0.058333333333333334
1002-2021_03_20_211300.jpg,car,15,54,320,22,240,115,1,69,137,LTAdatasets/1002/annotate/1002-2021_03_20_211300.jpg,61.5,126.0,0.1921875,0.525,0.046875,0.09166666666666666
1002-2021_03_20_211300.jpg,car,10,54,320,9,240,87,1,64,96,LTAdatasets/1002/annotate/1002-2021_03_20_211300.jpg,59.0,91.5,0.184375,0.38125,0.03125,0.0375
1002-2021_03_20_211300.jpg,car,11,177,320,10,240,104,1,188,114,LTAdatasets/1002/annotate/1002-2021_03_20_211300.jpg,182.5,109.0,0.5703125,0.45416666666666666,0.034375,0.041666666666666664
1002-2021_03_20_211300.jpg,car,12,67,320,8,240,88,1,79,96,LTAdatasets/1002/annotate/1002-2021_03_20_211300.jpg,73.0,92.0,0.228125,0.38333333333333336,0.0375,0.03333333333333333
1002-2021_03_20_182752.jpg,car,23,84,320,22,240,145,1,107,167,LTAdatasets/1002/annotate/1002-2021_03_20_182752.jpg,95.5,156.0,0.2984375,0.65,0.071875,0.09166666666666666
1002-2021_03_20_182752.jpg,car,26,64,320,38,240,201,1,90,239,LTAdatasets/1002/annotate/1002-2021_03_20_182752.jpg,77.0,220.0,0.240625,0.9166666666666666,0.08125,0.15833333333333333
1002-2021_03_20_182752.jpg,car,15,56,320,14,240,107,1,71,121,LTAdatasets/1002/annotate/1002-2021_03_20_182752.jpg,63.5,114.0,0.1984375,0.475,0.046875,0.058333333333333334
1002-2021_03_20_182752.jpg,car,15,305,320,19,240,141,1,320,160,LTAdatasets/1002/annotate/1002-2021_03_20_182752.jpg,312.5,150.5,0.9765625,0.6270833333333333,0.046875,0.07916666666666666
1002-2021_03_20_092143.jpg,car,11,76,320,19,240,113,1,87,132,LTAdatasets/1002/annotate/1002-2021_03_20_092143.jpg,81.5,122.5,0.2546875,0.5104166666666666,0.034375,0.07916666666666666
1002-2021_03_20_092143.jpg,car,10,69,320,9,240,95,1,79,104,LTAdatasets/1002/annotate/1002-2021_03_20_092143.jpg,74.0,99.5,0.23125,0.41458333333333336,0.03125,0.0375
1002-2021_03_20_092143.jpg,car,19,291,320,19,240,132,1,310,151,LTAdatasets/1002/annotate/1002-2021_03_20_092143.jpg,300.5,141.5,0.9390625,0.5895833333333333,0.059375,0.07916666666666666
1002-2021_03_20_084601.jpg,van,11,183,320,11,240,102,3,194,113,LTAdatasets/1002/annotate/1002-2021_03_20_084601.jpg,188.5,107.5,0.5890625,0.4479166666666667,0.034375,0.04583333333333333
1002-2021_03_20_084601.jpg,van,16,178,320,13,240,112,3,194,125,LTAdatasets/1002/annotate/1002-2021_03_20_084601.jpg,186.0,118.5,0.58125,0.49375,0.05,0.05416666666666667
1002-2021_03_20_195736.jpg,car,13,54,320,13,240,101,1,67,114,LTAdatasets/1002/annotate/1002-2021_03_20_195736.jpg,60.5,107.5,0.1890625,0.4479166666666667,0.040625,0.05416666666666667
1002-2021_03_20_195736.jpg,car,14,73,320,12,240,99,1,87,111,LTAdatasets/1002/annotate/1002-2021_03_20_195736.jpg,80.0,105.0,0.25,0.4375,0.04375,0.05
1002-2021_03_20_195736.jpg,car,12,268,320,11,240,121,1,280,132,LTAdatasets/1002/annotate/1002-2021_03_20_195736.jpg,274.0,126.5,0.85625,0.5270833333333333,0.0375,0.04583333333333333
1002-2021_03_20_090702.jpg,bike,12,131,320,29,240,189,4,143,218,LTAdatasets/1002/annotate/1002-2021_03_20_090702.jpg,137.0,203.5,0.428125,0.8479166666666667,0.0375,0.12083333333333333
1002-2021_03_20_090702.jpg,car,30,69,320,33,240,207,1,99,240,LTAdatasets/1002/annotate/1002-2021_03_20_090702.jpg,84.0,223.5,0.2625,0.93125,0.09375,0.1375
1002-2021_03_20_090702.jpg,car,13,58,320,21,240,126,1,71,147,LTAdatasets/1002/annotate/1002-2021_03_20_090702.jpg,64.5,136.5,0.2015625,0.56875,0.040625,0.0875
1002-2021_03_20_090702.jpg,car,12,55,320,8,240,99,1,67,107,LTAdatasets/1002/annotate/1002-2021_03_20_090702.jpg,61.0,103.0,0.190625,0.42916666666666664,0.0375,0.03333333333333333
1002-2021_03_20_090702.jpg,van,12,252,320,15,240,115,3,264,130,LTAdatasets/1002/annotate/1002-2021_03_20_090702.jpg,258.0,122.5,0.80625,0.5104166666666666,0.0375,0.0625
1002-2021_03_20_090702.jpg,van,16,174,320,12,240,105,3,190,117,LTAdatasets/1002/annotate/1002-2021_03_20_090702.jpg,182.0,111.0,0.56875,0.4625,0.05,0.05
1002-2021_03_20_180410.jpg,lorry_truck,33,108,320,49,240,171,2,141,220,LTAdatasets/1002/annotate/1002-2021_03_20_180410.jpg,124.5,195.5,0.3890625,0.8145833333333333,0.103125,0.20416666666666666
1002-2021_03_20_180410.jpg,lorry_truck,31,58,320,64,240,153,2,89,217,LTAdatasets/1002/annotate/1002-2021_03_20_180410.jpg,73.5,185.0,0.2296875,0.7708333333333334,0.096875,0.26666666666666666
1002-2021_03_20_180410.jpg,car,15,180,320,11,240,111,1,195,122,LTAdatasets/1002/annotate/1002-2021_03_20_180410.jpg,187.5,116.5,0.5859375,0.48541666666666666,0.046875,0.04583333333333333
1002-2021_03_20_062754.jpg,car,15,268,320,9,240,123,1,283,132,LTAdatasets/1002/annotate/1002-2021_03_20_062754.jpg,275.5,127.5,0.8609375,0.53125,0.046875,0.0375
1002-2021_03_20_062754.jpg,car,12,170,320,10,240,103,1,182,113,LTAdatasets/1002/annotate/1002-2021_03_20_062754.jpg,176.0,108.0,0.55,0.45,0.0375,0.041666666666666664
1002-2021_03_20_200637.jpg,car,15,65,320,23,240,152,1,80,175,LTAdatasets/1002/annotate/1002-2021_03_20_200637.jpg,72.5,163.5,0.2265625,0.68125,0.046875,0.09583333333333334
1002-2021_03_20_200637.jpg,car,12,67,320,10,240,91,1,79,101,LTAdatasets/1002/annotate/1002-2021_03_20_200637.jpg,73.0,96.0,0.228125,0.4,0.0375,0.041666666666666664
1002-2021_03_20_211900.jpg,car,17,86,320,23,240,132,1,103,155,LTAdatasets/1002/annotate/1002-2021_03_20_211900.jpg,94.5,143.5,0.2953125,0.5979166666666667,0.053125,0.09583333333333334
1002-2021_03_20_211900.jpg,car,12,54,320,11,240,99,1,66,110,LTAdatasets/1002/annotate/1002-2021_03_20_211900.jpg,60.0,104.5,0.1875,0.4354166666666667,0.0375,0.04583333333333333
1002-2021_03_20_211900.jpg,car,16,243,320,12,240,120,1,259,132,LTAdatasets/1002/annotate/1002-2021_03_20_211900.jpg,251.0,126.0,0.784375,0.525,0.05,0.05
1002-2021_03_20_211900.jpg,car,11,168,320,7,240,97,1,179,104,LTAdatasets/1002/annotate/1002-2021_03_20_211900.jpg,173.5,100.5,0.5421875,0.41875,0.034375,0.029166666666666667
1002-2021_03_20_211900.jpg,car,13,262,320,9,240,121,1,275,130,LTAdatasets/1002/annotate/1002-2021_03_20_211900.jpg,268.5,125.5,0.8390625,0.5229166666666667,0.040625,0.0375
1002-2021_03_20_190634.jpg,lorry_truck,13,56,320,16,240,106,2,69,122,LTAdatasets/1002/annotate/1002-2021_03_20_190634.jpg,62.5,114.0,0.1953125,0.475,0.040625,0.06666666666666667
1002-2021_03_20_185153.jpg,car,28,67,320,31,240,209,1,95,240,LTAdatasets/1002/annotate/1002-2021_03_20_185153.jpg,81.0,224.5,0.253125,0.9354166666666667,0.0875,0.12916666666666668
1002-2021_03_20_185153.jpg,car,39,114,320,24,240,216,1,153,240,LTAdatasets/1002/annotate/1002-2021_03_20_185153.jpg,133.5,228.0,0.4171875,0.95,0.121875,0.1
1002-2021_03_20_185153.jpg,car,17,52,320,12,240,101,1,69,113,LTAdatasets/1002/annotate/1002-2021_03_20_185153.jpg,60.5,107.0,0.1890625,0.44583333333333336,0.053125,0.05
1002-2021_03_20_185153.jpg,car,16,281,320,11,240,134,1,297,145,LTAdatasets/1002/annotate/1002-2021_03_20_185153.jpg,289.0,139.5,0.903125,0.58125,0.05,0.04583333333333333
1002-2021_03_20_185153.jpg,van,16,268,320,13,240,119,3,284,132,LTAdatasets/1002/annotate/1002-2021_03_20_185153.jpg,276.0,125.5,0.8625,0.5229166666666667,0.05,0.05416666666666667
1002-2021_03_20_185153.jpg,lorry_truck,17,246,320,20,240,110,2,263,130,LTAdatasets/1002/annotate/1002-2021_03_20_185153.jpg,254.5,120.0,0.7953125,0.5,0.053125,0.08333333333333333
1002-2021_03_20_091302.jpg,car,13,75,320,12,240,116,1,88,128,LTAdatasets/1002/annotate/1002-2021_03_20_091302.jpg,81.5,122.0,0.2546875,0.5083333333333333,0.040625,0.05
1002-2021_03_20_091302.jpg,car,13,60,320,17,240,116,1,73,133,LTAdatasets/1002/annotate/1002-2021_03_20_091302.jpg,66.5,124.5,0.2078125,0.51875,0.040625,0.07083333333333333
1002-2021_03_20_091302.jpg,lorry_truck,25,236,320,22,240,99,2,261,121,LTAdatasets/1002/annotate/1002-2021_03_20_091302.jpg,248.5,110.0,0.7765625,0.4583333333333333,0.078125,0.09166666666666666
1002-2021_03_20_091302.jpg,car,7,176,320,12,240,103,1,183,115,LTAdatasets/1002/annotate/1002-2021_03_20_091302.jpg,179.5,109.0,0.5609375,0.45416666666666666,0.021875,0.05
1002-2021_03_20_080119.jpg,car,22,53,320,22,240,149,1,75,171,LTAdatasets/1002/annotate/1002-2021_03_20_080119.jpg,64.0,160.0,0.2,0.6666666666666666,0.06875,0.09166666666666666
1002-2021_03_20_080119.jpg,car,13,55,320,11,240,119,1,68,130,LTAdatasets/1002/annotate/1002-2021_03_20_080119.jpg,61.5,124.5,0.1921875,0.51875,0.040625,0.04583333333333333
1002-2021_03_20_080119.jpg,lorry_truck,18,179,320,19,240,104,2,197,123,LTAdatasets/1002/annotate/1002-2021_03_20_080119.jpg,188.0,113.5,0.5875,0.47291666666666665,0.05625,0.07916666666666666
1002-2021_03_20_181251.jpg,car,29,99,320,34,240,175,1,128,209,LTAdatasets/1002/annotate/1002-2021_03_20_181251.jpg,113.5,192.0,0.3546875,0.8,0.090625,0.14166666666666666
1002-2021_03_20_181251.jpg,van,13,262,320,17,240,153,3,275,170,LTAdatasets/1002/annotate/1002-2021_03_20_181251.jpg,268.5,161.5,0.8390625,0.6729166666666667,0.040625,0.07083333333333333
1002-2021_03_20_181251.jpg,car,15,57,320,14,240,121,1,72,135,LTAdatasets/1002/annotate/1002-2021_03_20_181251.jpg,64.5,128.0,0.2015625,0.5333333333333333,0.046875,0.058333333333333334
1002-2021_03_20_181251.jpg,car,10,58,320,9,240,99,1,68,108,LTAdatasets/1002/annotate/1002-2021_03_20_181251.jpg,63.0,103.5,0.196875,0.43125,0.03125,0.0375
1002-2021_03_20_181251.jpg,lorry_truck,14,227,320,15,240,101,2,241,116,LTAdatasets/1002/annotate/1002-2021_03_20_181251.jpg,234.0,108.5,0.73125,0.45208333333333334,0.04375,0.0625
1002-2021_03_20_181251.jpg,lorry_truck,18,279,320,15,240,123,2,297,138,LTAdatasets/1002/annotate/1002-2021_03_20_181251.jpg,288.0,130.5,0.9,0.54375,0.05625,0.0625
1002-2021_03_20_093424.jpg,lorry_truck,20,77,320,23,240,117,2,97,140,LTAdatasets/1002/annotate/1002-2021_03_20_093424.jpg,87.0,128.5,0.271875,0.5354166666666667,0.0625,0.09583333333333334
1002-2021_03_20_093424.jpg,car,14,295,320,13,240,130,1,309,143,LTAdatasets/1002/annotate/1002-2021_03_20_093424.jpg,302.0,136.5,0.94375,0.56875,0.04375,0.05416666666666667
1002-2021_03_20_093424.jpg,van,13,273,320,13,240,122,3,286,135,LTAdatasets/1002/annotate/1002-2021_03_20_093424.jpg,279.5,128.5,0.8734375,0.5354166666666667,0.040625,0.05416666666666667
1002-2021_03_20_093424.jpg,car,15,243,320,12,240,114,1,258,126,LTAdatasets/1002/annotate/1002-2021_03_20_093424.jpg,250.5,120.0,0.7828125,0.5,0.046875,0.05
1002-2021_03_20_061853.jpg,car,12,187,320,13,240,109,1,199,122,LTAdatasets/1002/annotate/1002-2021_03_20_061853.jpg,193.0,115.5,0.603125,0.48125,0.0375,0.05416666666666667
1002-2021_03_20_075138.jpg,bus,38,244,320,23,240,110,5,282,133,LTAdatasets/1002/annotate/1002-2021_03_20_075138.jpg,263.0,121.5,0.821875,0.50625,0.11875,0.09583333333333334
1002-2021_03_20_075138.jpg,lorry_truck,16,178,320,14,240,101,2,194,115,LTAdatasets/1002/annotate/1002-2021_03_20_075138.jpg,186.0,108.0,0.58125,0.45,0.05,0.058333333333333334
1002-2021_03_20_075138.jpg,car,35,104,320,35,240,205,1,139,240,LTAdatasets/1002/annotate/1002-2021_03_20_075138.jpg,121.5,222.5,0.3796875,0.9270833333333334,0.109375,0.14583333333333334
1002-2021_03_20_193635.jpg,car,14,73,320,11,240,110,1,87,121,LTAdatasets/1002/annotate/1002-2021_03_20_193635.jpg,80.0,115.5,0.25,0.48125,0.04375,0.04583333333333333
1002-2021_03_20_193635.jpg,car,9,67,320,12,240,81,1,76,93,LTAdatasets/1002/annotate/1002-2021_03_20_193635.jpg,71.5,87.0,0.2234375,0.3625,0.028125,0.05
1002-2021_03_20_193635.jpg,car,14,296,320,15,240,137,1,310,152,LTAdatasets/1002/annotate/1002-2021_03_20_193635.jpg,303.0,144.5,0.946875,0.6020833333333333,0.04375,0.0625
1002-2021_03_20_193635.jpg,car,13,259,320,12,240,113,1,272,125,LTAdatasets/1002/annotate/1002-2021_03_20_193635.jpg,265.5,119.0,0.8296875,0.49583333333333335,0.040625,0.05
1002-2021_03_20_213701.jpg,car,12,59,320,14,240,116,1,71,130,LTAdatasets/1002/annotate/1002-2021_03_20_213701.jpg,65.0,123.0,0.203125,0.5125,0.0375,0.058333333333333334
1002-2021_03_20_213701.jpg,car,15,50,320,12,240,93,1,65,105,LTAdatasets/1002/annotate/1002-2021_03_20_213701.jpg,57.5,99.0,0.1796875,0.4125,0.046875,0.05
1002-2021_03_20_213701.jpg,car,11,168,320,8,240,97,1,179,105,LTAdatasets/1002/annotate/1002-2021_03_20_213701.jpg,173.5,101.0,0.5421875,0.42083333333333334,0.034375,0.03333333333333333
1002-2021_03_20_213701.jpg,lorry_truck,20,226,320,18,240,96,2,246,114,LTAdatasets/1002/annotate/1002-2021_03_20_213701.jpg,236.0,105.0,0.7375,0.4375,0.0625,0.075
1002-2021_03_20_215802.jpg,car,10,54,320,8,240,94,1,64,102,LTAdatasets/1002/annotate/1002-2021_03_20_215802.jpg,59.0,98.0,0.184375,0.4083333333333333,0.03125,0.03333333333333333
1002-2021_03_20_215802.jpg,car,10,65,320,6,240,88,1,75,94,LTAdatasets/1002/annotate/1002-2021_03_20_215802.jpg,70.0,91.0,0.21875,0.37916666666666665,0.03125,0.025
1002-2021_03_20_215802.jpg,car,13,188,320,11,240,109,1,201,120,LTAdatasets/1002/annotate/1002-2021_03_20_215802.jpg,194.5,114.5,0.6078125,0.47708333333333336,0.040625,0.04583333333333333
1002-2021_03_20_215802.jpg,car,15,253,320,10,240,116,1,268,126,LTAdatasets/1002/annotate/1002-2021_03_20_215802.jpg,260.5,121.0,0.8140625,0.5041666666666667,0.046875,0.041666666666666664
1002-2021_03_20_190413.jpg,car,14,80,320,16,240,126,1,94,142,LTAdatasets/1002/annotate/1002-2021_03_20_190413.jpg,87.0,134.0,0.271875,0.5583333333333333,0.04375,0.06666666666666667
1002-2021_03_20_190413.jpg,car,20,59,320,26,240,153,1,79,179,LTAdatasets/1002/annotate/1002-2021_03_20_190413.jpg,69.0,166.0,0.215625,0.6916666666666667,0.0625,0.10833333333333334
1002-2021_03_20_190413.jpg,car,14,54,320,13,240,110,1,68,123,LTAdatasets/1002/annotate/1002-2021_03_20_190413.jpg,61.0,116.5,0.190625,0.48541666666666666,0.04375,0.05416666666666667
1002-2021_03_20_190413.jpg,car,10,55,320,11,240,98,1,65,109,LTAdatasets/1002/annotate/1002-2021_03_20_190413.jpg,60.0,103.5,0.1875,0.43125,0.03125,0.04583333333333333
1002-2021_03_20_190413.jpg,lorry_truck,25,230,320,20,240,104,2,255,124,LTAdatasets/1002/annotate/1002-2021_03_20_190413.jpg,242.5,114.0,0.7578125,0.475,0.078125,0.08333333333333333
1002-2021_03_20_190413.jpg,car,13,178,320,12,240,105,1,191,117,LTAdatasets/1002/annotate/1002-2021_03_20_190413.jpg,184.5,111.0,0.5765625,0.4625,0.040625,0.05
1002-2021_03_20_092803.jpg,car,22,87,320,26,240,157,1,109,183,LTAdatasets/1002/annotate/1002-2021_03_20_092803.jpg,98.0,170.0,0.30625,0.7083333333333334,0.06875,0.10833333333333334
1002-2021_03_20_092803.jpg,car,10,54,320,12,240,97,1,64,109,LTAdatasets/1002/annotate/1002-2021_03_20_092803.jpg,59.0,103.0,0.184375,0.42916666666666664,0.03125,0.05
1002-2021_03_20_182151.jpg,lorry_truck,14,269,320,13,240,118,2,283,131,LTAdatasets/1002/annotate/1002-2021_03_20_182151.jpg,276.0,124.5,0.8625,0.51875,0.04375,0.05416666666666667
1002-2021_03_20_182151.jpg,lorry_truck,13,243,320,14,240,116,2,256,130,LTAdatasets/1002/annotate/1002-2021_03_20_182151.jpg,249.5,123.0,0.7796875,0.5125,0.040625,0.058333333333333334
1002-2021_03_20_182151.jpg,car,9,65,320,10,240,96,1,74,106,LTAdatasets/1002/annotate/1002-2021_03_20_182151.jpg,69.5,101.0,0.2171875,0.42083333333333334,0.028125,0.041666666666666664
1002-2021_03_20_182151.jpg,lorry_truck,17,300,320,44,240,170,2,317,214,LTAdatasets/1002/annotate/1002-2021_03_20_182151.jpg,308.5,192.0,0.9640625,0.8,0.053125,0.18333333333333332
1002-2021_03_20_182151.jpg,car,17,303,320,11,240,137,1,320,148,LTAdatasets/1002/annotate/1002-2021_03_20_182151.jpg,311.5,142.5,0.9734375,0.59375,0.053125,0.04583333333333333
1002-2021_03_20_204919.jpg,car,15,277,320,14,240,133,1,292,147,LTAdatasets/1002/annotate/1002-2021_03_20_204919.jpg,284.5,140.0,0.8890625,0.5833333333333334,0.046875,0.058333333333333334
1002-2021_03_20_204919.jpg,car,13,267,320,11,240,123,1,280,134,LTAdatasets/1002/annotate/1002-2021_03_20_204919.jpg,273.5,128.5,0.8546875,0.5354166666666667,0.040625,0.04583333333333333
1002-2021_03_20_204919.jpg,car,18,241,320,11,240,119,1,259,130,LTAdatasets/1002/annotate/1002-2021_03_20_204919.jpg,250.0,124.5,0.78125,0.51875,0.05625,0.04583333333333333
1002-2021_03_20_204919.jpg,car,17,182,320,9,240,108,1,199,117,LTAdatasets/1002/annotate/1002-2021_03_20_204919.jpg,190.5,112.5,0.5953125,0.46875,0.053125,0.0375
1002-2021_03_20_204919.jpg,car,15,262,320,15,240,146,1,277,161,LTAdatasets/1002/annotate/1002-2021_03_20_204919.jpg,269.5,153.5,0.8421875,0.6395833333333333,0.046875,0.0625
1002-2021_03_20_202217.jpg,lorry_truck,11,67,320,13,240,83,2,78,96,LTAdatasets/1002/annotate/1002-2021_03_20_202217.jpg,72.5,89.5,0.2265625,0.3729166666666667,0.034375,0.05416666666666667
1002-2021_03_20_202217.jpg,car,12,232,320,11,240,106,1,244,117,LTAdatasets/1002/annotate/1002-2021_03_20_202217.jpg,238.0,111.5,0.74375,0.46458333333333335,0.0375,0.04583333333333333
1002-2021_03_20_091903.jpg,car,17,56,320,20,240,124,1,73,144,LTAdatasets/1002/annotate/1002-2021_03_20_091903.jpg,64.5,134.0,0.2015625,0.5583333333333333,0.053125,0.08333333333333333
1002-2021_03_20_091903.jpg,car,21,299,320,15,240,141,1,320,156,LTAdatasets/1002/annotate/1002-2021_03_20_091903.jpg,309.5,148.5,0.9671875,0.61875,0.065625,0.0625
1002-2021_03_20_091903.jpg,car,10,193,320,10,240,110,1,203,120,LTAdatasets/1002/annotate/1002-2021_03_20_091903.jpg,198.0,115.0,0.61875,0.4791666666666667,0.03125,0.041666666666666664
1002-2021_03_20_091903.jpg,lorry_truck,12,55,320,12,240,94,2,67,106,LTAdatasets/1002/annotate/1002-2021_03_20_091903.jpg,61.0,100.0,0.190625,0.4166666666666667,0.0375,0.05
1002-2021_03_20_192214.jpg,lorry_truck,30,89,320,51,240,150,2,119,201,LTAdatasets/1002/annotate/1002-2021_03_20_192214.jpg,104.0,175.5,0.325,0.73125,0.09375,0.2125
1002-2021_03_20_192214.jpg,car,15,56,320,16,240,119,1,71,135,LTAdatasets/1002/annotate/1002-2021_03_20_192214.jpg,63.5,127.0,0.1984375,0.5291666666666667,0.046875,0.06666666666666667
1002-2021_03_20_192214.jpg,car,11,51,320,8,240,98,1,62,106,LTAdatasets/1002/annotate/1002-2021_03_20_192214.jpg,56.5,102.0,0.1765625,0.425,0.034375,0.03333333333333333
1002-2021_03_20_192214.jpg,car,9,68,320,9,240,90,1,77,99,LTAdatasets/1002/annotate/1002-2021_03_20_192214.jpg,72.5,94.5,0.2265625,0.39375,0.028125,0.0375
1002-2021_03_20_192214.jpg,car,9,177,320,10,240,102,1,186,112,LTAdatasets/1002/annotate/1002-2021_03_20_192214.jpg,181.5,107.0,0.5671875,0.44583333333333336,0.028125,0.041666666666666664
1002-2021_03_20_192214.jpg,car,9,65,320,7,240,85,1,74,92,LTAdatasets/1002/annotate/1002-2021_03_20_192214.jpg,69.5,88.5,0.2171875,0.36875,0.028125,0.029166666666666667
1002-2021_03_20_192214.jpg,car,17,303,320,13,240,145,1,320,158,LTAdatasets/1002/annotate/1002-2021_03_20_192214.jpg,311.5,151.5,0.9734375,0.63125,0.053125,0.05416666666666667
1002-2021_03_20_212140.jpg,car,19,82,320,22,240,143,1,101,165,LTAdatasets/1002/annotate/1002-2021_03_20_212140.jpg,91.5,154.0,0.2859375,0.6416666666666667,0.059375,0.09166666666666666
1002-2021_03_20_212140.jpg,car,12,54,320,13,240,96,1,66,109,LTAdatasets/1002/annotate/1002-2021_03_20_212140.jpg,60.0,102.5,0.1875,0.4270833333333333,0.0375,0.05416666666666667
1002-2021_03_20_212140.jpg,car,11,269,320,12,240,122,1,280,134,LTAdatasets/1002/annotate/1002-2021_03_20_212140.jpg,274.5,128.0,0.8578125,0.5333333333333333,0.034375,0.05
1002-2021_03_20_071236.jpg,car,12,174,320,10,240,107,1,186,117,LTAdatasets/1002/annotate/1002-2021_03_20_071236.jpg,180.0,112.0,0.5625,0.4666666666666667,0.0375,0.041666666666666664
1002-2021_03_20_071236.jpg,car,11,169,320,9,240,99,1,180,108,LTAdatasets/1002/annotate/1002-2021_03_20_071236.jpg,174.5,103.5,0.5453125,0.43125,0.034375,0.0375
1002-2021_03_20_094305.jpg,car,17,84,320,20,240,134,1,101,154,LTAdatasets/1002/annotate/1002-2021_03_20_094305.jpg,92.5,144.0,0.2890625,0.6,0.053125,0.08333333333333333
1002-2021_03_20_094305.jpg,car,18,55,320,16,240,126,1,73,142,LTAdatasets/1002/annotate/1002-2021_03_20_094305.jpg,64.0,134.0,0.2,0.5583333333333333,0.05625,0.06666666666666667
1002-2021_03_20_094305.jpg,lorry_truck,17,303,320,37,240,180,2,320,217,LTAdatasets/1002/annotate/1002-2021_03_20_094305.jpg,311.5,198.5,0.9734375,0.8270833333333333,0.053125,0.15416666666666667
1002-2021_03_20_094305.jpg,car,10,54,320,6,240,99,1,64,105,LTAdatasets/1002/annotate/1002-2021_03_20_094305.jpg,59.0,102.0,0.184375,0.425,0.03125,0.025
1002-2021_03_20_094305.jpg,car,9,55,320,9,240,88,1,64,97,LTAdatasets/1002/annotate/1002-2021_03_20_094305.jpg,59.5,92.5,0.1859375,0.3854166666666667,0.028125,0.0375
1002-2021_03_20_094305.jpg,car,13,182,320,9,240,110,1,195,119,LTAdatasets/1002/annotate/1002-2021_03_20_094305.jpg,188.5,114.5,0.5890625,0.47708333333333336,0.040625,0.0375
1002-2021_03_20_094305.jpg,lorry_truck,15,256,320,27,240,146,2,271,173,LTAdatasets/1002/annotate/1002-2021_03_20_094305.jpg,263.5,159.5,0.8234375,0.6645833333333333,0.046875,0.1125
1002-2021_03_20_185753.jpg,van,16,259,320,15,240,123,3,275,138,LTAdatasets/1002/annotate/1002-2021_03_20_185753.jpg,267.0,130.5,0.834375,0.54375,0.05,0.0625
1002-2021_03_20_185753.jpg,car,16,287,320,16,240,129,1,303,145,LTAdatasets/1002/annotate/1002-2021_03_20_185753.jpg,295.0,137.0,0.921875,0.5708333333333333,0.05,0.06666666666666667
1002-2021_03_20_185753.jpg,car,10,181,320,12,240,103,1,191,115,LTAdatasets/1002/annotate/1002-2021_03_20_185753.jpg,186.0,109.0,0.58125,0.45416666666666666,0.03125,0.05
1002-2021_03_20_193415.jpg,bike,10,102,320,28,240,171,4,112,199,LTAdatasets/1002/annotate/1002-2021_03_20_193415.jpg,107.0,185.0,0.334375,0.7708333333333334,0.03125,0.11666666666666667
1002-2021_03_20_193415.jpg,car,14,306,320,15,240,140,1,320,155,LTAdatasets/1002/annotate/1002-2021_03_20_193415.jpg,313.0,147.5,0.978125,0.6145833333333334,0.04375,0.0625
1002-2021_03_20_193415.jpg,car,15,68,320,17,240,106,1,83,123,LTAdatasets/1002/annotate/1002-2021_03_20_193415.jpg,75.5,114.5,0.2359375,0.47708333333333336,0.046875,0.07083333333333333
1002-2021_03_20_100105.jpg,van,20,256,320,18,240,150,3,276,168,LTAdatasets/1002/annotate/1002-2021_03_20_100105.jpg,266.0,159.0,0.83125,0.6625,0.0625,0.075
1002-2021_03_20_100105.jpg,car,11,54,320,9,240,94,1,65,103,LTAdatasets/1002/annotate/1002-2021_03_20_100105.jpg,59.5,98.5,0.1859375,0.41041666666666665,0.034375,0.0375
1002-2021_03_20_100105.jpg,car,10,70,320,9,240,93,1,80,102,LTAdatasets/1002/annotate/1002-2021_03_20_100105.jpg,75.0,97.5,0.234375,0.40625,0.03125,0.0375
1002-2021_03_20_100105.jpg,bike,7,59,320,19,240,124,4,66,143,LTAdatasets/1002/annotate/1002-2021_03_20_100105.jpg,62.5,133.5,0.1953125,0.55625,0.021875,0.07916666666666666
1002-2021_03_20_215222.jpg,van,19,182,320,14,240,111,3,201,125,LTAdatasets/1002/annotate/1002-2021_03_20_215222.jpg,191.5,118.0,0.5984375,0.49166666666666664,0.059375,0.058333333333333334
1002-2021_03_20_215222.jpg,car,9,56,320,9,240,87,1,65,96,LTAdatasets/1002/annotate/1002-2021_03_20_215222.jpg,60.5,91.5,0.1890625,0.38125,0.028125,0.0375
1002-2021_03_20_215222.jpg,lorry_truck,12,226,320,16,240,99,2,238,115,LTAdatasets/1002/annotate/1002-2021_03_20_215222.jpg,232.0,107.0,0.725,0.44583333333333336,0.0375,0.06666666666666667
1002-2021_03_20_215222.jpg,car,11,238,320,12,240,118,1,249,130,LTAdatasets/1002/annotate/1002-2021_03_20_215222.jpg,243.5,124.0,0.7609375,0.5166666666666667,0.034375,0.05
1002-2021_03_20_205139.jpg,car,17,85,320,21,240,135,1,102,156,LTAdatasets/1002/annotate/1002-2021_03_20_205139.jpg,93.5,145.5,0.2921875,0.60625,0.053125,0.0875
1002-2021_03_20_205139.jpg,car,19,68,320,14,240,103,1,87,117,LTAdatasets/1002/annotate/1002-2021_03_20_205139.jpg,77.5,110.0,0.2421875,0.4583333333333333,0.059375,0.058333333333333334
1002-2021_03_20_205139.jpg,car,12,189,320,11,240,114,1,201,125,LTAdatasets/1002/annotate/1002-2021_03_20_205139.jpg,195.0,119.5,0.609375,0.4979166666666667,0.0375,0.04583333333333333
1002-2021_03_20_205139.jpg,lorry_truck,16,168,320,22,240,93,2,184,115,LTAdatasets/1002/annotate/1002-2021_03_20_205139.jpg,176.0,104.0,0.55,0.43333333333333335,0.05,0.09166666666666666
1002-2021_03_20_072817.jpg,lorry_truck,14,57,320,24,240,113,2,71,137,LTAdatasets/1002/annotate/1002-2021_03_20_072817.jpg,64.0,125.0,0.2,0.5208333333333334,0.04375,0.1
1002-2021_03_20_072817.jpg,van,15,177,320,13,240,105,3,192,118,LTAdatasets/1002/annotate/1002-2021_03_20_072817.jpg,184.5,111.5,0.5765625,0.46458333333333335,0.046875,0.05416666666666667
1002-2021_03_20_083640.jpg,lorry_truck,43,62,320,40,240,200,2,105,240,LTAdatasets/1002/annotate/1002-2021_03_20_083640.jpg,83.5,220.0,0.2609375,0.9166666666666666,0.134375,0.16666666666666666
1002-2021_03_20_083640.jpg,car,6,56,320,7,240,87,1,62,94,LTAdatasets/1002/annotate/1002-2021_03_20_083640.jpg,59.0,90.5,0.184375,0.3770833333333333,0.01875,0.029166666666666667
1002-2021_03_20_201317.jpg,car,18,76,320,22,240,141,1,94,163,LTAdatasets/1002/annotate/1002-2021_03_20_201317.jpg,85.0,152.0,0.265625,0.6333333333333333,0.05625,0.09166666666666666
1002-2021_03_20_201317.jpg,car,11,55,320,11,240,101,1,66,112,LTAdatasets/1002/annotate/1002-2021_03_20_201317.jpg,60.5,106.5,0.1890625,0.44375,0.034375,0.04583333333333333
1002-2021_03_20_201317.jpg,car,14,257,320,15,240,152,1,271,167,LTAdatasets/1002/annotate/1002-2021_03_20_201317.jpg,264.0,159.5,0.825,0.6645833333333333,0.04375,0.0625
1002-2021_03_20_201317.jpg,car,10,270,320,12,240,128,1,280,140,LTAdatasets/1002/annotate/1002-2021_03_20_201317.jpg,275.0,134.0,0.859375,0.5583333333333333,0.03125,0.05
1002-2021_03_20_201317.jpg,car,12,183,320,9,240,107,1,195,116,LTAdatasets/1002/annotate/1002-2021_03_20_201317.jpg,189.0,111.5,0.590625,0.46458333333333335,0.0375,0.0375
1002-2021_03_20_201317.jpg,car,10,70,320,11,240,93,1,80,104,LTAdatasets/1002/annotate/1002-2021_03_20_201317.jpg,75.0,98.5,0.234375,0.41041666666666665,0.03125,0.04583333333333333
1002-2021_03_20_180710.jpg,car,15,55,320,15,240,115,1,70,130,LTAdatasets/1002/annotate/1002-2021_03_20_180710.jpg,62.5,122.5,0.1953125,0.5104166666666666,0.046875,0.0625
1002-2021_03_20_180710.jpg,car,12,54,320,11,240,95,1,66,106,LTAdatasets/1002/annotate/1002-2021_03_20_180710.jpg,60.0,100.5,0.1875,0.41875,0.0375,0.04583333333333333
1002-2021_03_20_180710.jpg,car,12,174,320,10,240,107,1,186,117,LTAdatasets/1002/annotate/1002-2021_03_20_180710.jpg,180.0,112.0,0.5625,0.4666666666666667,0.0375,0.041666666666666664
2708-2021_03_20_094904.jpg,car,23,120,640,21,360,124,1,143,145,LTAdatasets/2708/annotate/2708-2021_03_20_094904.jpg,131.5,134.5,0.20546875,0.3736111111111111,0.0359375,0.058333333333333334
2708-2021_03_20_094904.jpg,car,32,468,640,19,360,143,1,500,162,LTAdatasets/2708/annotate/2708-2021_03_20_094904.jpg,484.0,152.5,0.75625,0.4236111111111111,0.05,0.05277777777777778
2708-2021_03_20_075518.jpg,lorry_truck,30,209,640,35,360,99,2,239,134,LTAdatasets/2708/annotate/2708-2021_03_20_075518.jpg,224.0,116.5,0.35,0.3236111111111111,0.046875,0.09722222222222222
2708-2021_03_20_075518.jpg,bike,8,404,640,18,360,117,4,412,135,LTAdatasets/2708/annotate/2708-2021_03_20_075518.jpg,408.0,126.0,0.6375,0.35,0.0125,0.05
2708-2021_03_20_075518.jpg,bike,9,208,640,17,360,70,4,217,87,LTAdatasets/2708/annotate/2708-2021_03_20_075518.jpg,212.5,78.5,0.33203125,0.21805555555555556,0.0140625,0.04722222222222222
2708-2021_03_20_081920.jpg,car,36,473,640,29,360,168,1,509,197,LTAdatasets/2708/annotate/2708-2021_03_20_081920.jpg,491.0,182.5,0.7671875,0.5069444444444444,0.05625,0.08055555555555556
2708-2021_03_20_081920.jpg,car,29,306,640,21,360,134,1,335,155,LTAdatasets/2708/annotate/2708-2021_03_20_081920.jpg,320.5,144.5,0.50078125,0.4013888888888889,0.0453125,0.058333333333333334
2708-2021_03_20_081920.jpg,car,29,611,640,37,360,200,1,640,237,LTAdatasets/2708/annotate/2708-2021_03_20_081920.jpg,625.5,218.5,0.97734375,0.6069444444444444,0.0453125,0.10277777777777777
2708-2021_03_20_100105.jpg,car,57,483,640,50,360,268,1,540,318,LTAdatasets/2708/annotate/2708-2021_03_20_100105.jpg,511.5,293.0,0.79921875,0.8138888888888889,0.0890625,0.1388888888888889
2708-2021_03_20_100105.jpg,car,26,381,640,28,360,121,1,407,149,LTAdatasets/2708/annotate/2708-2021_03_20_100105.jpg,394.0,135.0,0.615625,0.375,0.040625,0.07777777777777778
2708-2021_03_20_085141.jpg,car,40,336,640,38,360,203,1,376,241,LTAdatasets/2708/annotate/2708-2021_03_20_085141.jpg,356.0,222.0,0.55625,0.6166666666666667,0.0625,0.10555555555555556
2708-2021_03_20_085141.jpg,car,45,421,640,32,360,223,1,466,255,LTAdatasets/2708/annotate/2708-2021_03_20_085141.jpg,443.5,239.0,0.69296875,0.6638888888888889,0.0703125,0.08888888888888889
2708-2021_03_20_085141.jpg,van,30,127,640,28,360,157,3,157,185,LTAdatasets/2708/annotate/2708-2021_03_20_085141.jpg,142.0,171.0,0.221875,0.475,0.046875,0.07777777777777778
2708-2021_03_20_085141.jpg,lorry_truck,24,123,640,24,360,130,2,147,154,LTAdatasets/2708/annotate/2708-2021_03_20_085141.jpg,135.0,142.0,0.2109375,0.39444444444444443,0.0375,0.06666666666666667
2708-2021_03_20_085141.jpg,lorry_truck,27,234,640,31,360,144,2,261,175,LTAdatasets/2708/annotate/2708-2021_03_20_085141.jpg,247.5,159.5,0.38671875,0.44305555555555554,0.0421875,0.08611111111111111
2708-2021_03_20_085141.jpg,bike,10,272,640,28,360,130,4,282,158,LTAdatasets/2708/annotate/2708-2021_03_20_085141.jpg,277.0,144.0,0.4328125,0.4,0.015625,0.07777777777777778
2708-2021_03_20_085141.jpg,car,29,285,640,18,360,123,1,314,141,LTAdatasets/2708/annotate/2708-2021_03_20_085141.jpg,299.5,132.0,0.46796875,0.36666666666666664,0.0453125,0.05
2708-2021_03_20_085141.jpg,car,17,391,640,12,360,118,1,408,130,LTAdatasets/2708/annotate/2708-2021_03_20_085141.jpg,399.5,124.0,0.62421875,0.34444444444444444,0.0265625,0.03333333333333333
2708-2021_03_20_074318.jpg,car,63,414,640,49,360,274,1,477,323,LTAdatasets/2708/annotate/2708-2021_03_20_074318.jpg,445.5,298.5,0.69609375,0.8291666666666667,0.0984375,0.1361111111111111
2708-2021_03_20_074318.jpg,lorry_truck,23,403,640,26,360,116,2,426,142,LTAdatasets/2708/annotate/2708-2021_03_20_074318.jpg,414.5,129.0,0.64765625,0.35833333333333334,0.0359375,0.07222222222222222
2708-2021_03_20_074318.jpg,bike,14,295,640,20,360,127,4,309,147,LTAdatasets/2708/annotate/2708-2021_03_20_074318.jpg,302.0,137.0,0.471875,0.38055555555555554,0.021875,0.05555555555555555
2708-2021_03_20_074318.jpg,car,34,575,640,26,360,230,1,609,256,LTAdatasets/2708/annotate/2708-2021_03_20_074318.jpg,592.0,243.0,0.925,0.675,0.053125,0.07222222222222222
2708-2021_03_20_183412.jpg,car,68,475,640,58,360,268,1,543,326,LTAdatasets/2708/annotate/2708-2021_03_20_183412.jpg,509.0,297.0,0.7953125,0.825,0.10625,0.16111111111111112
2708-2021_03_20_183412.jpg,bike,17,477,640,21,360,153,4,494,174,LTAdatasets/2708/annotate/2708-2021_03_20_183412.jpg,485.5,163.5,0.75859375,0.45416666666666666,0.0265625,0.058333333333333334
2708-2021_03_20_183412.jpg,car,15,222,640,12,360,89,1,237,101,LTAdatasets/2708/annotate/2708-2021_03_20_183412.jpg,229.5,95.0,0.35859375,0.2638888888888889,0.0234375,0.03333333333333333
2708-2021_03_20_183412.jpg,car,15,250,640,10,360,89,1,265,99,LTAdatasets/2708/annotate/2708-2021_03_20_183412.jpg,257.5,94.0,0.40234375,0.2611111111111111,0.0234375,0.027777777777777776
2708-2021_03_20_191234.jpg,car,51,344,640,39,360,215,1,395,254,LTAdatasets/2708/annotate/2708-2021_03_20_191234.jpg,369.5,234.5,0.57734375,0.6513888888888889,0.0796875,0.10833333333333334
2708-2021_03_20_191234.jpg,car,27,468,640,24,360,135,1,495,159,LTAdatasets/2708/annotate/2708-2021_03_20_191234.jpg,481.5,147.0,0.75234375,0.4083333333333333,0.0421875,0.06666666666666667
2708-2021_03_20_191234.jpg,car,22,126,640,17,360,127,1,148,144,LTAdatasets/2708/annotate/2708-2021_03_20_191234.jpg,137.0,135.5,0.2140625,0.3763888888888889,0.034375,0.04722222222222222
2708-2021_03_20_191234.jpg,car,18,237,640,18,360,101,1,255,119,LTAdatasets/2708/annotate/2708-2021_03_20_191234.jpg,246.0,110.0,0.384375,0.3055555555555556,0.028125,0.05
2708-2021_03_20_090702.jpg,bike,17,323,640,22,360,180,4,340,202,LTAdatasets/2708/annotate/2708-2021_03_20_090702.jpg,331.5,191.0,0.51796875,0.5305555555555556,0.0265625,0.06111111111111111
2708-2021_03_20_090702.jpg,bike,16,466,640,14,360,146,4,482,160,LTAdatasets/2708/annotate/2708-2021_03_20_090702.jpg,474.0,153.0,0.740625,0.425,0.025,0.03888888888888889
2708-2021_03_20_090702.jpg,van,34,238,640,37,360,155,3,272,192,LTAdatasets/2708/annotate/2708-2021_03_20_090702.jpg,255.0,173.5,0.3984375,0.48194444444444445,0.053125,0.10277777777777777
2708-2021_03_20_193415.jpg,van,35,308,640,36,360,174,3,343,210,LTAdatasets/2708/annotate/2708-2021_03_20_193415.jpg,325.5,192.0,0.50859375,0.5333333333333333,0.0546875,0.1
2708-2021_03_20_193415.jpg,car,17,350,640,23,360,161,1,367,184,LTAdatasets/2708/annotate/2708-2021_03_20_193415.jpg,358.5,172.5,0.56015625,0.4791666666666667,0.0265625,0.06388888888888888
2708-2021_03_20_193415.jpg,car,16,369,640,24,360,191,1,385,215,LTAdatasets/2708/annotate/2708-2021_03_20_193415.jpg,377.0,203.0,0.5890625,0.5638888888888889,0.025,0.06666666666666667
2708-2021_03_20_193415.jpg,car,22,136,640,29,360,250,1,158,279,LTAdatasets/2708/annotate/2708-2021_03_20_193415.jpg,147.0,264.5,0.2296875,0.7347222222222223,0.034375,0.08055555555555556
2708-2021_03_20_193415.jpg,lorry_truck,39,116,640,44,360,162,2,155,206,LTAdatasets/2708/annotate/2708-2021_03_20_193415.jpg,135.5,184.0,0.21171875,0.5111111111111111,0.0609375,0.12222222222222222
2708-2021_03_20_193415.jpg,bike,17,463,640,20,360,149,4,480,169,LTAdatasets/2708/annotate/2708-2021_03_20_193415.jpg,471.5,159.0,0.73671875,0.44166666666666665,0.0265625,0.05555555555555555
2708-2021_03_20_193415.jpg,van,23,122,640,17,360,113,3,145,130,LTAdatasets/2708/annotate/2708-2021_03_20_193415.jpg,133.5,121.5,0.20859375,0.3375,0.0359375,0.04722222222222222
2708-2021_03_20_193415.jpg,bike,22,606,640,21,360,213,4,628,234,LTAdatasets/2708/annotate/2708-2021_03_20_193415.jpg,617.0,223.5,0.9640625,0.6208333333333333,0.034375,0.058333333333333334
2708-2021_03_20_193415.jpg,car,47,163,640,37,360,323,1,210,360,LTAdatasets/2708/annotate/2708-2021_03_20_193415.jpg,186.5,341.5,0.29140625,0.9486111111111111,0.0734375,0.10277777777777777
2708-2021_03_20_193415.jpg,van,16,208,640,16,360,99,3,224,115,LTAdatasets/2708/annotate/2708-2021_03_20_193415.jpg,216.0,107.0,0.3375,0.2972222222222222,0.025,0.044444444444444446
2708-2021_03_20_094305.jpg,car,17,242,640,15,360,105,1,259,120,LTAdatasets/2708/annotate/2708-2021_03_20_094305.jpg,250.5,112.5,0.39140625,0.3125,0.0265625,0.041666666666666664
2708-2021_03_20_094305.jpg,car,30,435,640,17,360,139,1,465,156,LTAdatasets/2708/annotate/2708-2021_03_20_094305.jpg,450.0,147.5,0.703125,0.4097222222222222,0.046875,0.04722222222222222
2708-2021_03_20_094305.jpg,lorry_truck,35,439,640,32,360,104,2,474,136,LTAdatasets/2708/annotate/2708-2021_03_20_094305.jpg,456.5,120.0,0.71328125,0.3333333333333333,0.0546875,0.08888888888888889
2708-2021_03_20_094305.jpg,car,19,122,640,18,360,102,1,141,120,LTAdatasets/2708/annotate/2708-2021_03_20_094305.jpg,131.5,111.0,0.20546875,0.30833333333333335,0.0296875,0.05
2708-2021_03_20_080939.jpg,car,26,270,640,20,360,131,1,296,151,LTAdatasets/2708/annotate/2708-2021_03_20_080939.jpg,283.0,141.0,0.4421875,0.39166666666666666,0.040625,0.05555555555555555
2708-2021_03_20_080939.jpg,bike,15,115,640,18,360,137,4,130,155,LTAdatasets/2708/annotate/2708-2021_03_20_080939.jpg,122.5,146.0,0.19140625,0.40555555555555556,0.0234375,0.05
2708-2021_03_20_080939.jpg,car,20,123,640,12,360,103,1,143,115,LTAdatasets/2708/annotate/2708-2021_03_20_080939.jpg,133.0,109.0,0.2078125,0.30277777777777776,0.03125,0.03333333333333333
2708-2021_03_20_191914.jpg,bus,139,303,640,110,360,250,5,442,360,LTAdatasets/2708/annotate/2708-2021_03_20_191914.jpg,372.5,305.0,0.58203125,0.8472222222222222,0.2171875,0.3055555555555556
2708-2021_03_20_191914.jpg,bus,39,210,640,60,360,94,5,249,154,LTAdatasets/2708/annotate/2708-2021_03_20_191914.jpg,229.5,124.0,0.35859375,0.34444444444444444,0.0609375,0.16666666666666666
2708-2021_03_20_191914.jpg,car,29,274,640,22,360,134,1,303,156,LTAdatasets/2708/annotate/2708-2021_03_20_191914.jpg,288.5,145.0,0.45078125,0.4027777777777778,0.0453125,0.06111111111111111
2708-2021_03_20_191914.jpg,car,39,347,640,30,360,170,1,386,200,LTAdatasets/2708/annotate/2708-2021_03_20_191914.jpg,366.5,185.0,0.57265625,0.5138888888888888,0.0609375,0.08333333333333333
2708-2021_03_20_190634.jpg,car,56,458,640,44,360,252,1,514,296,LTAdatasets/2708/annotate/2708-2021_03_20_190634.jpg,486.0,274.0,0.759375,0.7611111111111111,0.0875,0.12222222222222222
2708-2021_03_20_190634.jpg,car,28,283,640,31,360,145,1,311,176,LTAdatasets/2708/annotate/2708-2021_03_20_190634.jpg,297.0,160.5,0.4640625,0.44583333333333336,0.04375,0.08611111111111111
2708-2021_03_20_190634.jpg,lorry_truck,13,129,640,19,360,87,2,142,106,LTAdatasets/2708/annotate/2708-2021_03_20_190634.jpg,135.5,96.5,0.21171875,0.26805555555555555,0.0203125,0.05277777777777778
2708-2021_03_20_094605.jpg,car,48,354,640,49,360,214,1,402,263,LTAdatasets/2708/annotate/2708-2021_03_20_094605.jpg,378.0,238.5,0.590625,0.6625,0.075,0.1361111111111111
2708-2021_03_20_094605.jpg,car,50,144,640,60,360,275,1,194,335,LTAdatasets/2708/annotate/2708-2021_03_20_094605.jpg,169.0,305.0,0.2640625,0.8472222222222222,0.078125,0.16666666666666666
2708-2021_03_20_094605.jpg,lorry_truck,45,217,640,46,360,118,2,262,164,LTAdatasets/2708/annotate/2708-2021_03_20_094605.jpg,239.5,141.0,0.37421875,0.39166666666666666,0.0703125,0.12777777777777777
2708-2021_03_20_094605.jpg,van,18,129,640,26,360,121,3,147,147,LTAdatasets/2708/annotate/2708-2021_03_20_094605.jpg,138.0,134.0,0.215625,0.37222222222222223,0.028125,0.07222222222222222
2708-2021_03_20_094605.jpg,lorry_truck,22,186,640,31,360,60,2,208,91,LTAdatasets/2708/annotate/2708-2021_03_20_094605.jpg,197.0,75.5,0.3078125,0.20972222222222223,0.034375,0.08611111111111111
2708-2021_03_20_203058.jpg,car,34,294,640,26,360,163,1,328,189,LTAdatasets/2708/annotate/2708-2021_03_20_203058.jpg,311.0,176.0,0.4859375,0.4888888888888889,0.053125,0.07222222222222222
2708-2021_03_20_203058.jpg,lorry_truck,28,122,640,32,360,123,2,150,155,LTAdatasets/2708/annotate/2708-2021_03_20_203058.jpg,136.0,139.0,0.2125,0.3861111111111111,0.04375,0.08888888888888889
2708-2021_03_20_203058.jpg,lorry_truck,62,147,640,103,360,246,2,209,349,LTAdatasets/2708/annotate/2708-2021_03_20_203058.jpg,178.0,297.5,0.278125,0.8263888888888888,0.096875,0.2861111111111111
2708-2021_03_20_082740.jpg,car,28,466,640,31,360,148,1,494,179,LTAdatasets/2708/annotate/2708-2021_03_20_082740.jpg,480.0,163.5,0.75,0.45416666666666666,0.04375,0.08611111111111111
2708-2021_03_20_082740.jpg,car,28,387,640,23,360,127,1,415,150,LTAdatasets/2708/annotate/2708-2021_03_20_082740.jpg,401.0,138.5,0.6265625,0.38472222222222224,0.04375,0.06388888888888888
2708-2021_03_20_082740.jpg,bike,14,237,640,17,360,96,4,251,113,LTAdatasets/2708/annotate/2708-2021_03_20_082740.jpg,244.0,104.5,0.38125,0.2902777777777778,0.021875,0.04722222222222222
2708-2021_03_20_091302.jpg,car,33,311,640,26,360,182,1,344,208,LTAdatasets/2708/annotate/2708-2021_03_20_091302.jpg,327.5,195.0,0.51171875,0.5416666666666666,0.0515625,0.07222222222222222
2708-2021_03_20_091302.jpg,car,28,333,640,21,360,153,1,361,174,LTAdatasets/2708/annotate/2708-2021_03_20_091302.jpg,347.0,163.5,0.5421875,0.45416666666666666,0.04375,0.058333333333333334
2708-2021_03_20_091302.jpg,car,26,285,640,18,360,121,1,311,139,LTAdatasets/2708/annotate/2708-2021_03_20_091302.jpg,298.0,130.0,0.465625,0.3611111111111111,0.040625,0.05
2708-2021_03_20_091302.jpg,lorry_truck,41,215,640,49,360,96,2,256,145,LTAdatasets/2708/annotate/2708-2021_03_20_091302.jpg,235.5,120.5,0.36796875,0.3347222222222222,0.0640625,0.1361111111111111
2708-2021_03_20_074918.jpg,lorry_truck,48,344,640,58,360,192,2,392,250,LTAdatasets/2708/annotate/2708-2021_03_20_074918.jpg,368.0,221.0,0.575,0.6138888888888889,0.075,0.16111111111111112
2708-2021_03_20_074918.jpg,bike,29,477,640,33,360,250,4,506,283,LTAdatasets/2708/annotate/2708-2021_03_20_074918.jpg,491.5,266.5,0.76796875,0.7402777777777778,0.0453125,0.09166666666666666
2708-2021_03_20_074918.jpg,bike,33,322,640,47,360,297,4,355,344,LTAdatasets/2708/annotate/2708-2021_03_20_074918.jpg,338.5,320.5,0.52890625,0.8902777777777777,0.0515625,0.13055555555555556
2708-2021_03_20_074918.jpg,lorry_truck,26,405,640,26,360,99,2,431,125,LTAdatasets/2708/annotate/2708-2021_03_20_074918.jpg,418.0,112.0,0.653125,0.3111111111111111,0.040625,0.07222222222222222
2708-2021_03_20_073417.jpg,car,56,368,640,44,360,234,1,424,278,LTAdatasets/2708/annotate/2708-2021_03_20_073417.jpg,396.0,256.0,0.61875,0.7111111111111111,0.0875,0.12222222222222222
2708-2021_03_20_073417.jpg,bus,32,464,640,49,360,119,5,496,168,LTAdatasets/2708/annotate/2708-2021_03_20_073417.jpg,480.0,143.5,0.75,0.39861111111111114,0.05,0.1361111111111111
2708-2021_03_20_073417.jpg,lorry_truck,24,210,640,27,360,101,2,234,128,LTAdatasets/2708/annotate/2708-2021_03_20_073417.jpg,222.0,114.5,0.346875,0.31805555555555554,0.0375,0.075
2708-2021_03_20_090102.jpg,car,27,392,640,26,360,127,1,419,153,LTAdatasets/2708/annotate/2708-2021_03_20_090102.jpg,405.5,140.0,0.63359375,0.3888888888888889,0.0421875,0.07222222222222222
2708-2021_03_20_090102.jpg,van,19,208,640,20,360,109,3,227,129,LTAdatasets/2708/annotate/2708-2021_03_20_090102.jpg,217.5,119.0,0.33984375,0.33055555555555555,0.0296875,0.05555555555555555
2708-2021_03_20_090102.jpg,car,18,237,640,14,360,102,1,255,116,LTAdatasets/2708/annotate/2708-2021_03_20_090102.jpg,246.0,109.0,0.384375,0.30277777777777776,0.028125,0.03888888888888889
2708-2021_03_20_083340.jpg,bike,24,312,640,32,360,189,4,336,221,LTAdatasets/2708/annotate/2708-2021_03_20_083340.jpg,324.0,205.0,0.50625,0.5694444444444444,0.0375,0.08888888888888889
2708-2021_03_20_083340.jpg,bike,13,301,640,24,360,147,4,314,171,LTAdatasets/2708/annotate/2708-2021_03_20_083340.jpg,307.5,159.0,0.48046875,0.44166666666666665,0.0203125,0.06666666666666667
2708-2021_03_20_083340.jpg,car,56,401,640,35,360,217,1,457,252,LTAdatasets/2708/annotate/2708-2021_03_20_083340.jpg,429.0,234.5,0.6703125,0.6513888888888889,0.0875,0.09722222222222222
2708-2021_03_20_083340.jpg,car,29,409,640,20,360,140,1,438,160,LTAdatasets/2708/annotate/2708-2021_03_20_083340.jpg,423.5,150.0,0.66171875,0.4166666666666667,0.0453125,0.05555555555555555
2708-2021_03_20_180710.jpg,bike,7,136,640,17,360,136,4,143,153,LTAdatasets/2708/annotate/2708-2021_03_20_180710.jpg,139.5,144.5,0.21796875,0.4013888888888889,0.0109375,0.04722222222222222
2708-2021_03_20_180710.jpg,bike,15,115,640,18,360,140,4,130,158,LTAdatasets/2708/annotate/2708-2021_03_20_180710.jpg,122.5,149.0,0.19140625,0.41388888888888886,0.0234375,0.05
2708-2021_03_20_180710.jpg,car,25,375,640,23,360,118,1,400,141,LTAdatasets/2708/annotate/2708-2021_03_20_180710.jpg,387.5,129.5,0.60546875,0.3597222222222222,0.0390625,0.06388888888888888
2708-2021_03_20_073037.jpg,bike,23,343,640,32,360,201,4,366,233,LTAdatasets/2708/annotate/2708-2021_03_20_073037.jpg,354.5,217.0,0.55390625,0.6027777777777777,0.0359375,0.08888888888888889
2708-2021_03_20_073037.jpg,bike,18,122,640,19,360,172,4,140,191,LTAdatasets/2708/annotate/2708-2021_03_20_073037.jpg,131.0,181.5,0.2046875,0.5041666666666667,0.028125,0.05277777777777778
2708-2021_03_20_073037.jpg,bike,17,121,640,22,360,128,4,138,150,LTAdatasets/2708/annotate/2708-2021_03_20_073037.jpg,129.5,139.0,0.20234375,0.3861111111111111,0.0265625,0.06111111111111111
2708-2021_03_20_073037.jpg,car,24,464,640,29,360,144,1,488,173,LTAdatasets/2708/annotate/2708-2021_03_20_073037.jpg,476.0,158.5,0.74375,0.44027777777777777,0.0375,0.08055555555555556
2708-2021_03_20_073037.jpg,car,24,405,640,18,360,112,1,429,130,LTAdatasets/2708/annotate/2708-2021_03_20_073037.jpg,417.0,121.0,0.6515625,0.33611111111111114,0.0375,0.05
2708-2021_03_20_073037.jpg,bike,20,597,640,23,360,228,4,617,251,LTAdatasets/2708/annotate/2708-2021_03_20_073037.jpg,607.0,239.5,0.9484375,0.6652777777777777,0.03125,0.06388888888888888
2708-2021_03_20_201917.jpg,car,25,435,640,28,360,137,1,460,165,LTAdatasets/2708/annotate/2708-2021_03_20_201917.jpg,447.5,151.0,0.69921875,0.41944444444444445,0.0390625,0.07777777777777778
2708-2021_03_20_201917.jpg,car,17,246,640,15,360,112,1,263,127,LTAdatasets/2708/annotate/2708-2021_03_20_201917.jpg,254.5,119.5,0.39765625,0.33194444444444443,0.0265625,0.041666666666666664
2708-2021_03_20_201917.jpg,lorry_truck,24,616,640,36,360,189,2,640,225,LTAdatasets/2708/annotate/2708-2021_03_20_201917.jpg,628.0,207.0,0.98125,0.575,0.0375,0.1
2708-2021_03_20_092803.jpg,lorry_truck,51,260,640,51,360,177,2,311,228,LTAdatasets/2708/annotate/2708-2021_03_20_092803.jpg,285.5,202.5,0.44609375,0.5625,0.0796875,0.14166666666666666
2708-2021_03_20_092803.jpg,van,39,281,640,30,360,145,3,320,175,LTAdatasets/2708/annotate/2708-2021_03_20_092803.jpg,300.5,160.0,0.46953125,0.4444444444444444,0.0609375,0.08333333333333333
2708-2021_03_20_092803.jpg,van,29,474,640,27,360,148,3,503,175,LTAdatasets/2708/annotate/2708-2021_03_20_092803.jpg,488.5,161.5,0.76328125,0.4486111111111111,0.0453125,0.075
2708-2021_03_20_092803.jpg,van,50,521,640,31,360,198,3,571,229,LTAdatasets/2708/annotate/2708-2021_03_20_092803.jpg,546.0,213.5,0.853125,0.5930555555555556,0.078125,0.08611111111111111
2708-2021_03_20_085501.jpg,van,28,466,640,38,360,139,3,494,177,LTAdatasets/2708/annotate/2708-2021_03_20_085501.jpg,480.0,158.0,0.75,0.4388888888888889,0.04375,0.10555555555555556
2708-2021_03_20_093424.jpg,bike,15,256,640,22,360,141,4,271,163,LTAdatasets/2708/annotate/2708-2021_03_20_093424.jpg,263.5,152.0,0.41171875,0.4222222222222222,0.0234375,0.06111111111111111
2708-2021_03_20_093424.jpg,lorry_truck,27,204,640,29,360,88,2,231,117,LTAdatasets/2708/annotate/2708-2021_03_20_093424.jpg,217.5,102.5,0.33984375,0.2847222222222222,0.0421875,0.08055555555555556
2708-2021_03_20_093424.jpg,lorry_truck,15,435,640,20,360,135,2,450,155,LTAdatasets/2708/annotate/2708-2021_03_20_093424.jpg,442.5,145.0,0.69140625,0.4027777777777778,0.0234375,0.05555555555555555
2708-2021_03_20_203358.jpg,car,47,419,640,49,360,216,1,466,265,LTAdatasets/2708/annotate/2708-2021_03_20_203358.jpg,442.5,240.5,0.69140625,0.6680555555555555,0.0734375,0.1361111111111111
2708-2021_03_20_203358.jpg,car,21,119,640,17,360,105,1,140,122,LTAdatasets/2708/annotate/2708-2021_03_20_203358.jpg,129.5,113.5,0.20234375,0.31527777777777777,0.0328125,0.04722222222222222
2708-2021_03_20_203358.jpg,car,20,219,640,16,360,85,1,239,101,LTAdatasets/2708/annotate/2708-2021_03_20_203358.jpg,229.0,93.0,0.3578125,0.25833333333333336,0.03125,0.044444444444444446
2708-2021_03_20_081539.jpg,bike,17,329,640,26,360,193,4,346,219,LTAdatasets/2708/annotate/2708-2021_03_20_081539.jpg,337.5,206.0,0.52734375,0.5722222222222222,0.0265625,0.07222222222222222
2708-2021_03_20_081539.jpg,car,31,124,640,19,360,148,1,155,167,LTAdatasets/2708/annotate/2708-2021_03_20_081539.jpg,139.5,157.5,0.21796875,0.4375,0.0484375,0.05277777777777778
2708-2021_03_20_081539.jpg,car,21,118,640,18,360,103,1,139,121,LTAdatasets/2708/annotate/2708-2021_03_20_081539.jpg,128.5,112.0,0.20078125,0.3111111111111111,0.0328125,0.05
2708-2021_03_20_081539.jpg,lorry_truck,27,473,640,31,360,135,2,500,166,LTAdatasets/2708/annotate/2708-2021_03_20_081539.jpg,486.5,150.5,0.76015625,0.41805555555555557,0.0421875,0.08611111111111111
2708-2021_03_20_081539.jpg,car,29,415,640,18,360,139,1,444,157,LTAdatasets/2708/annotate/2708-2021_03_20_081539.jpg,429.5,148.0,0.67109375,0.4111111111111111,0.0453125,0.05
2708-2021_03_20_192515.jpg,lorry_truck,24,125,640,43,360,140,2,149,183,LTAdatasets/2708/annotate/2708-2021_03_20_192515.jpg,137.0,161.5,0.2140625,0.4486111111111111,0.0375,0.11944444444444445
2708-2021_03_20_192515.jpg,car,68,141,640,56,360,304,1,209,360,LTAdatasets/2708/annotate/2708-2021_03_20_192515.jpg,175.0,332.0,0.2734375,0.9222222222222223,0.10625,0.15555555555555556
2708-2021_03_20_080119.jpg,car,64,476,640,41,360,319,1,540,360,LTAdatasets/2708/annotate/2708-2021_03_20_080119.jpg,508.0,339.5,0.79375,0.9430555555555555,0.1,0.11388888888888889
2708-2021_03_20_080119.jpg,car,33,291,640,26,360,159,1,324,185,LTAdatasets/2708/annotate/2708-2021_03_20_080119.jpg,307.5,172.0,0.48046875,0.4777777777777778,0.0515625,0.07222222222222222
2708-2021_03_20_080119.jpg,van,18,250,640,23,360,112,3,268,135,LTAdatasets/2708/annotate/2708-2021_03_20_080119.jpg,259.0,123.5,0.4046875,0.34305555555555556,0.028125,0.06388888888888888
2708-2021_03_20_080119.jpg,van,17,280,640,18,360,111,3,297,129,LTAdatasets/2708/annotate/2708-2021_03_20_080119.jpg,288.5,120.0,0.45078125,0.3333333333333333,0.0265625,0.05
2708-2021_03_20_080119.jpg,car,18,395,640,14,360,108,1,413,122,LTAdatasets/2708/annotate/2708-2021_03_20_080119.jpg,404.0,115.0,0.63125,0.3194444444444444,0.028125,0.03888888888888889
2708-2021_03_20_075138.jpg,car,66,436,640,58,360,302,1,502,360,LTAdatasets/2708/annotate/2708-2021_03_20_075138.jpg,469.0,331.0,0.7328125,0.9194444444444444,0.103125,0.16111111111111112
2708-2021_03_20_075138.jpg,car,40,288,640,30,360,157,1,328,187,LTAdatasets/2708/annotate/2708-2021_03_20_075138.jpg,308.0,172.0,0.48125,0.4777777777777778,0.0625,0.08333333333333333
2708-2021_03_20_075138.jpg,car,21,294,640,21,360,120,1,315,141,LTAdatasets/2708/annotate/2708-2021_03_20_075138.jpg,304.5,130.5,0.47578125,0.3625,0.0328125,0.058333333333333334
2708-2021_03_20_075138.jpg,car,20,253,640,23,360,119,1,273,142,LTAdatasets/2708/annotate/2708-2021_03_20_075138.jpg,263.0,130.5,0.4109375,0.3625,0.03125,0.06388888888888888
2708-2021_03_20_075138.jpg,lorry_truck,36,417,640,40,360,98,2,453,138,LTAdatasets/2708/annotate/2708-2021_03_20_075138.jpg,435.0,118.0,0.6796875,0.3277777777777778,0.05625,0.1111111111111111
2708-2021_03_20_184613.jpg,car,51,402,640,37,360,201,1,453,238,LTAdatasets/2708/annotate/2708-2021_03_20_184613.jpg,427.5,219.5,0.66796875,0.6097222222222223,0.0796875,0.10277777777777777
2708-2021_03_20_184613.jpg,car,33,466,640,37,360,157,1,499,194,LTAdatasets/2708/annotate/2708-2021_03_20_184613.jpg,482.5,175.5,0.75390625,0.4875,0.0515625,0.10277777777777777
2708-2021_03_20_184613.jpg,car,24,305,640,21,360,133,1,329,154,LTAdatasets/2708/annotate/2708-2021_03_20_184613.jpg,317.0,143.5,0.4953125,0.39861111111111114,0.0375,0.058333333333333334
2708-2021_03_20_184613.jpg,van,30,130,640,29,360,146,3,160,175,LTAdatasets/2708/annotate/2708-2021_03_20_184613.jpg,145.0,160.5,0.2265625,0.44583333333333336,0.046875,0.08055555555555556
2708-2021_03_20_184613.jpg,bike,16,124,640,25,360,189,4,140,214,LTAdatasets/2708/annotate/2708-2021_03_20_184613.jpg,132.0,201.5,0.20625,0.5597222222222222,0.025,0.06944444444444445
2708-2021_03_20_183712.jpg,lorry_truck,49,334,640,46,360,194,2,383,240,LTAdatasets/2708/annotate/2708-2021_03_20_183712.jpg,358.5,217.0,0.56015625,0.6027777777777777,0.0765625,0.12777777777777777
2708-2021_03_20_183712.jpg,car,35,373,640,30,360,186,1,408,216,LTAdatasets/2708/annotate/2708-2021_03_20_183712.jpg,390.5,201.0,0.61015625,0.5583333333333333,0.0546875,0.08333333333333333
2708-2021_03_20_183712.jpg,bike,18,132,640,24,360,174,4,150,198,LTAdatasets/2708/annotate/2708-2021_03_20_183712.jpg,141.0,186.0,0.2203125,0.5166666666666667,0.028125,0.06666666666666667
2708-2021_03_20_183712.jpg,car,21,407,640,26,360,105,1,428,131,LTAdatasets/2708/annotate/2708-2021_03_20_183712.jpg,417.5,118.0,0.65234375,0.3277777777777778,0.0328125,0.07222222222222222
2708-2021_03_20_183112.jpg,bike,28,371,640,31,360,230,4,399,261,LTAdatasets/2708/annotate/2708-2021_03_20_183112.jpg,385.0,245.5,0.6015625,0.6819444444444445,0.04375,0.08611111111111111
2708-2021_03_20_183112.jpg,car,28,125,640,21,360,134,1,153,155,LTAdatasets/2708/annotate/2708-2021_03_20_183112.jpg,139.0,144.5,0.2171875,0.4013888888888889,0.04375,0.058333333333333334
2708-2021_03_20_183112.jpg,car,28,290,640,21,360,120,1,318,141,LTAdatasets/2708/annotate/2708-2021_03_20_183112.jpg,304.0,130.5,0.475,0.3625,0.04375,0.058333333333333334
2708-2021_03_20_183112.jpg,car,31,445,640,25,360,140,1,476,165,LTAdatasets/2708/annotate/2708-2021_03_20_183112.jpg,460.5,152.5,0.71953125,0.4236111111111111,0.0484375,0.06944444444444445
2708-2021_03_20_183112.jpg,car,16,121,640,17,360,100,1,137,117,LTAdatasets/2708/annotate/2708-2021_03_20_183112.jpg,129.0,108.5,0.2015625,0.3013888888888889,0.025,0.04722222222222222
2708-2021_03_20_191014.jpg,lorry_truck,73,282,640,64,360,208,2,355,272,LTAdatasets/2708/annotate/2708-2021_03_20_191014.jpg,318.5,240.0,0.49765625,0.6666666666666666,0.1140625,0.17777777777777778
2708-2021_03_20_191014.jpg,car,42,484,640,32,360,175,1,526,207,LTAdatasets/2708/annotate/2708-2021_03_20_191014.jpg,505.0,191.0,0.7890625,0.5305555555555556,0.065625,0.08888888888888889
2708-2021_03_20_191014.jpg,car,23,398,640,20,360,131,1,421,151,LTAdatasets/2708/annotate/2708-2021_03_20_191014.jpg,409.5,141.0,0.63984375,0.39166666666666666,0.0359375,0.05555555555555555
2708-2021_03_20_191014.jpg,car,21,128,640,26,360,145,1,149,171,LTAdatasets/2708/annotate/2708-2021_03_20_191014.jpg,138.5,158.0,0.21640625,0.4388888888888889,0.0328125,0.07222222222222222
2708-2021_03_20_191014.jpg,car,36,604,640,42,360,235,1,640,277,LTAdatasets/2708/annotate/2708-2021_03_20_191014.jpg,622.0,256.0,0.971875,0.7111111111111111,0.05625,0.11666666666666667
2708-2021_03_20_191014.jpg,lorry_truck,28,112,640,40,360,83,2,140,123,LTAdatasets/2708/annotate/2708-2021_03_20_191014.jpg,126.0,103.0,0.196875,0.2861111111111111,0.04375,0.1111111111111111
2708-2021_03_20_082220.jpg,car,54,131,640,45,360,259,1,185,304,LTAdatasets/2708/annotate/2708-2021_03_20_082220.jpg,158.0,281.5,0.246875,0.7819444444444444,0.084375,0.125
2708-2021_03_20_082220.jpg,car,35,316,640,32,360,176,1,351,208,LTAdatasets/2708/annotate/2708-2021_03_20_082220.jpg,333.5,192.0,0.52109375,0.5333333333333333,0.0546875,0.08888888888888889
2708-2021_03_20_201617.jpg,car,52,347,640,50,360,209,1,399,259,LTAdatasets/2708/annotate/2708-2021_03_20_201617.jpg,373.0,234.0,0.5828125,0.65,0.08125,0.1388888888888889
2708-2021_03_20_201617.jpg,car,80,341,640,39,360,317,1,421,356,LTAdatasets/2708/annotate/2708-2021_03_20_201617.jpg,381.0,336.5,0.5953125,0.9347222222222222,0.125,0.10833333333333334
2708-2021_03_20_201617.jpg,car,97,543,640,45,360,315,1,640,360,LTAdatasets/2708/annotate/2708-2021_03_20_201617.jpg,591.5,337.5,0.92421875,0.9375,0.1515625,0.125
2708-2021_03_20_201617.jpg,car,34,341,640,28,360,156,1,375,184,LTAdatasets/2708/annotate/2708-2021_03_20_201617.jpg,358.0,170.0,0.559375,0.4722222222222222,0.053125,0.07777777777777778
2708-2021_03_20_201617.jpg,car,34,119,640,21,360,145,1,153,166,LTAdatasets/2708/annotate/2708-2021_03_20_201617.jpg,136.0,155.5,0.2125,0.43194444444444446,0.053125,0.058333333333333334
2708-2021_03_20_201617.jpg,lorry_truck,22,217,640,35,360,105,2,239,140,LTAdatasets/2708/annotate/2708-2021_03_20_201617.jpg,228.0,122.5,0.35625,0.3402777777777778,0.034375,0.09722222222222222
2708-2021_03_20_201617.jpg,car,19,247,640,22,360,104,1,266,126,LTAdatasets/2708/annotate/2708-2021_03_20_201617.jpg,256.5,115.0,0.40078125,0.3194444444444444,0.0296875,0.06111111111111111
2708-2021_03_20_204018.jpg,car,81,370,640,67,360,282,1,451,349,LTAdatasets/2708/annotate/2708-2021_03_20_204018.jpg,410.5,315.5,0.64140625,0.8763888888888889,0.1265625,0.18611111111111112
2708-2021_03_20_204018.jpg,car,81,531,640,64,360,296,1,612,360,LTAdatasets/2708/annotate/2708-2021_03_20_204018.jpg,571.5,328.0,0.89296875,0.9111111111111111,0.1265625,0.17777777777777778
2708-2021_03_20_204018.jpg,car,32,311,640,29,360,135,1,343,164,LTAdatasets/2708/annotate/2708-2021_03_20_204018.jpg,327.0,149.5,0.5109375,0.4152777777777778,0.05,0.08055555555555556
2708-2021_03_20_204018.jpg,car,24,261,640,14,360,134,1,285,148,LTAdatasets/2708/annotate/2708-2021_03_20_204018.jpg,273.0,141.0,0.4265625,0.39166666666666666,0.0375,0.03888888888888889
2708-2021_03_20_200416.jpg,car,28,127,640,23,360,156,1,155,179,LTAdatasets/2708/annotate/2708-2021_03_20_200416.jpg,141.0,167.5,0.2203125,0.4652777777777778,0.04375,0.06388888888888888
2708-2021_03_20_200416.jpg,car,31,246,640,23,360,115,1,277,138,LTAdatasets/2708/annotate/2708-2021_03_20_200416.jpg,261.5,126.5,0.40859375,0.35138888888888886,0.0484375,0.06388888888888888
2708-2021_03_20_200416.jpg,car,73,501,640,50,360,288,1,574,338,LTAdatasets/2708/annotate/2708-2021_03_20_200416.jpg,537.5,313.0,0.83984375,0.8694444444444445,0.1140625,0.1388888888888889
2708-2021_03_20_200416.jpg,car,30,422,640,20,360,148,1,452,168,LTAdatasets/2708/annotate/2708-2021_03_20_200416.jpg,437.0,158.0,0.6828125,0.4388888888888889,0.046875,0.05555555555555555
2708-2021_03_20_200416.jpg,lorry_truck,39,413,640,36,360,98,2,452,134,LTAdatasets/2708/annotate/2708-2021_03_20_200416.jpg,432.5,116.0,0.67578125,0.32222222222222224,0.0609375,0.1
2708-2021_03_20_183952.jpg,car,35,130,640,29,360,174,1,165,203,LTAdatasets/2708/annotate/2708-2021_03_20_183952.jpg,147.5,188.5,0.23046875,0.5236111111111111,0.0546875,0.08055555555555556
2708-2021_03_20_183952.jpg,car,23,241,640,14,360,86,1,264,100,LTAdatasets/2708/annotate/2708-2021_03_20_183952.jpg,252.5,93.0,0.39453125,0.25833333333333336,0.0359375,0.03888888888888889
2708-2021_03_20_080719.jpg,car,30,466,640,28,360,144,1,496,172,LTAdatasets/2708/annotate/2708-2021_03_20_080719.jpg,481.0,158.0,0.7515625,0.4388888888888889,0.046875,0.07777777777777778
2708-2021_03_20_080719.jpg,bike,16,385,640,22,360,124,4,401,146,LTAdatasets/2708/annotate/2708-2021_03_20_080719.jpg,393.0,135.0,0.6140625,0.375,0.025,0.06111111111111111
2708-2021_03_20_080719.jpg,car,23,243,640,20,360,110,1,266,130,LTAdatasets/2708/annotate/2708-2021_03_20_080719.jpg,254.5,120.0,0.39765625,0.3333333333333333,0.0359375,0.05555555555555555
2708-2021_03_20_185153.jpg,van,94,390,640,79,360,255,3,484,334,LTAdatasets/2708/annotate/2708-2021_03_20_185153.jpg,437.0,294.5,0.6828125,0.8180555555555555,0.146875,0.21944444444444444
2708-2021_03_20_185153.jpg,lorry_truck,73,117,640,100,360,204,2,190,304,LTAdatasets/2708/annotate/2708-2021_03_20_185153.jpg,153.5,254.0,0.23984375,0.7055555555555556,0.1140625,0.2777777777777778
2708-2021_03_20_185153.jpg,car,33,264,640,23,360,131,1,297,154,LTAdatasets/2708/annotate/2708-2021_03_20_185153.jpg,280.5,142.5,0.43828125,0.3958333333333333,0.0515625,0.06388888888888888
2708-2021_03_20_185153.jpg,bike,19,308,640,20,360,137,4,327,157,LTAdatasets/2708/annotate/2708-2021_03_20_185153.jpg,317.5,147.0,0.49609375,0.4083333333333333,0.0296875,0.05555555555555555
2708-2021_03_20_085822.jpg,van,38,274,640,31,360,142,3,312,173,LTAdatasets/2708/annotate/2708-2021_03_20_085822.jpg,293.0,157.5,0.4578125,0.4375,0.059375,0.08611111111111111
2708-2021_03_20_085822.jpg,bike,14,298,640,19,360,127,4,312,146,LTAdatasets/2708/annotate/2708-2021_03_20_085822.jpg,305.0,136.5,0.4765625,0.37916666666666665,0.021875,0.05277777777777778
2708-2021_03_20_085822.jpg,bus,33,395,640,32,360,94,5,428,126,LTAdatasets/2708/annotate/2708-2021_03_20_085822.jpg,411.5,110.0,0.64296875,0.3055555555555556,0.0515625,0.08888888888888889
2708-2021_03_20_085822.jpg,bike,10,407,640,15,360,127,4,417,142,LTAdatasets/2708/annotate/2708-2021_03_20_085822.jpg,412.0,134.5,0.64375,0.3736111111111111,0.015625,0.041666666666666664
2708-2021_03_20_095505.jpg,car,28,476,640,23,360,153,1,504,176,LTAdatasets/2708/annotate/2708-2021_03_20_095505.jpg,490.0,164.5,0.765625,0.45694444444444443,0.04375,0.06388888888888888
2708-2021_03_20_095505.jpg,car,17,623,640,41,360,226,1,640,267,LTAdatasets/2708/annotate/2708-2021_03_20_095505.jpg,631.5,246.5,0.98671875,0.6847222222222222,0.0265625,0.11388888888888889
2708-2021_03_20_095505.jpg,car,15,123,640,13,360,96,1,138,109,LTAdatasets/2708/annotate/2708-2021_03_20_095505.jpg,130.5,102.5,0.20390625,0.2847222222222222,0.0234375,0.03611111111111111
2708-2021_03_20_095505.jpg,car,15,437,640,23,360,146,1,452,169,LTAdatasets/2708/annotate/2708-2021_03_20_095505.jpg,444.5,157.5,0.69453125,0.4375,0.0234375,0.06388888888888888
2708-2021_03_20_073717.jpg,car,65,327,640,54,360,306,1,392,360,LTAdatasets/2708/annotate/2708-2021_03_20_073717.jpg,359.5,333.0,0.56171875,0.925,0.1015625,0.15
2708-2021_03_20_073717.jpg,lorry_truck,54,209,640,64,360,117,2,263,181,LTAdatasets/2708/annotate/2708-2021_03_20_073717.jpg,236.0,149.0,0.36875,0.41388888888888886,0.084375,0.17777777777777778
2708-2021_03_20_073717.jpg,car,26,419,640,21,360,142,1,445,163,LTAdatasets/2708/annotate/2708-2021_03_20_073717.jpg,432.0,152.5,0.675,0.4236111111111111,0.040625,0.058333333333333334
2708-2021_03_20_073717.jpg,lorry_truck,18,96,640,30,360,112,2,114,142,LTAdatasets/2708/annotate/2708-2021_03_20_073717.jpg,105.0,127.0,0.1640625,0.3527777777777778,0.028125,0.08333333333333333
2708-2021_03_20_073717.jpg,car,18,257,640,14,360,97,1,275,111,LTAdatasets/2708/annotate/2708-2021_03_20_073717.jpg,266.0,104.0,0.415625,0.28888888888888886,0.028125,0.03888888888888889
2708-2021_03_20_073717.jpg,bike,12,205,640,15,360,78,4,217,93,LTAdatasets/2708/annotate/2708-2021_03_20_073717.jpg,211.0,85.5,0.3296875,0.2375,0.01875,0.041666666666666664
2708-2021_03_20_084901.jpg,bike,16,284,640,17,360,140,4,300,157,LTAdatasets/2708/annotate/2708-2021_03_20_084901.jpg,292.0,148.5,0.45625,0.4125,0.025,0.04722222222222222
2708-2021_03_20_084901.jpg,car,61,414,640,50,360,291,1,475,341,LTAdatasets/2708/annotate/2708-2021_03_20_084901.jpg,444.5,316.0,0.69453125,0.8777777777777778,0.0953125,0.1388888888888889
2708-2021_03_20_084901.jpg,car,31,319,640,28,360,145,1,350,173,LTAdatasets/2708/annotate/2708-2021_03_20_084901.jpg,334.5,159.0,0.52265625,0.44166666666666665,0.0484375,0.07777777777777778
2708-2021_03_20_084901.jpg,lorry_truck,30,119,640,46,360,115,2,149,161,LTAdatasets/2708/annotate/2708-2021_03_20_084901.jpg,134.0,138.0,0.209375,0.38333333333333336,0.046875,0.12777777777777777
2708-2021_03_20_084901.jpg,lorry_truck,24,433,640,22,360,133,2,457,155,LTAdatasets/2708/annotate/2708-2021_03_20_084901.jpg,445.0,144.0,0.6953125,0.4,0.0375,0.06111111111111111
2708-2021_03_20_091903.jpg,van,59,281,640,63,360,211,3,340,274,LTAdatasets/2708/annotate/2708-2021_03_20_091903.jpg,310.5,242.5,0.48515625,0.6736111111111112,0.0921875,0.175
2708-2021_03_20_091903.jpg,car,38,490,640,18,360,185,1,528,203,LTAdatasets/2708/annotate/2708-2021_03_20_091903.jpg,509.0,194.0,0.7953125,0.5388888888888889,0.059375,0.05
2708-2021_03_20_084301.jpg,car,66,469,640,60,360,257,1,535,317,LTAdatasets/2708/annotate/2708-2021_03_20_084301.jpg,502.0,287.0,0.784375,0.7972222222222223,0.103125,0.16666666666666666
2708-2021_03_20_084301.jpg,car,47,592,640,37,360,234,1,639,271,LTAdatasets/2708/annotate/2708-2021_03_20_084301.jpg,615.5,252.5,0.96171875,0.7013888888888888,0.0734375,0.10277777777777777
2708-2021_03_20_084301.jpg,lorry_truck,47,281,640,47,360,197,2,328,244,LTAdatasets/2708/annotate/2708-2021_03_20_084301.jpg,304.5,220.5,0.47578125,0.6125,0.0734375,0.13055555555555556
2708-2021_03_20_084301.jpg,car,19,270,640,21,360,135,1,289,156,LTAdatasets/2708/annotate/2708-2021_03_20_084301.jpg,279.5,145.5,0.43671875,0.4041666666666667,0.0296875,0.058333333333333334
2708-2021_03_20_084301.jpg,car,26,294,640,17,360,129,1,320,146,LTAdatasets/2708/annotate/2708-2021_03_20_084301.jpg,307.0,137.5,0.4796875,0.3819444444444444,0.040625,0.04722222222222222
2708-2021_03_20_084301.jpg,car,25,391,640,19,360,134,1,416,153,LTAdatasets/2708/annotate/2708-2021_03_20_084301.jpg,403.5,143.5,0.63046875,0.39861111111111114,0.0390625,0.05277777777777778
2708-2021_03_20_084301.jpg,lorry_truck,61,397,640,48,360,85,2,458,133,LTAdatasets/2708/annotate/2708-2021_03_20_084301.jpg,427.5,109.0,0.66796875,0.30277777777777776,0.0953125,0.13333333333333333
2708-2021_03_20_084301.jpg,lorry_truck,32,608,640,35,360,192,2,640,227,LTAdatasets/2708/annotate/2708-2021_03_20_084301.jpg,624.0,209.5,0.975,0.5819444444444445,0.05,0.09722222222222222
2708-2021_03_20_203658.jpg,car,39,138,640,35,360,233,1,177,268,LTAdatasets/2708/annotate/2708-2021_03_20_203658.jpg,157.5,250.5,0.24609375,0.6958333333333333,0.0609375,0.09722222222222222
2708-2021_03_20_203658.jpg,car,29,288,640,31,360,155,1,317,186,LTAdatasets/2708/annotate/2708-2021_03_20_203658.jpg,302.5,170.5,0.47265625,0.4736111111111111,0.0453125,0.08611111111111111
2708-2021_03_20_203658.jpg,van,21,127,640,24,360,109,3,148,133,LTAdatasets/2708/annotate/2708-2021_03_20_203658.jpg,137.5,121.0,0.21484375,0.33611111111111114,0.0328125,0.06666666666666667
2708-2021_03_20_084001.jpg,lorry_truck,83,331,640,77,360,283,2,414,360,LTAdatasets/2708/annotate/2708-2021_03_20_084001.jpg,372.5,321.5,0.58203125,0.8930555555555556,0.1296875,0.21388888888888888
2708-2021_03_20_193115.jpg,lorry_truck,103,336,640,66,360,294,2,439,360,LTAdatasets/2708/annotate/2708-2021_03_20_193115.jpg,387.5,327.0,0.60546875,0.9083333333333333,0.1609375,0.18333333333333332
2708-2021_03_20_193115.jpg,car,25,399,640,18,360,119,1,424,137,LTAdatasets/2708/annotate/2708-2021_03_20_193115.jpg,411.5,128.0,0.64296875,0.35555555555555557,0.0390625,0.05
2708-2021_03_20_193115.jpg,car,34,295,640,28,360,159,1,329,187,LTAdatasets/2708/annotate/2708-2021_03_20_193115.jpg,312.0,173.0,0.4875,0.48055555555555557,0.053125,0.07777777777777778
2708-2021_03_20_193115.jpg,car,26,134,640,23,360,166,1,160,189,LTAdatasets/2708/annotate/2708-2021_03_20_193115.jpg,147.0,177.5,0.2296875,0.4930555555555556,0.040625,0.06388888888888888
2708-2021_03_20_193115.jpg,bike,16,307,640,18,360,127,4,323,145,LTAdatasets/2708/annotate/2708-2021_03_20_193115.jpg,315.0,136.0,0.4921875,0.37777777777777777,0.025,0.05
2708-2021_03_20_193115.jpg,bike,13,258,640,18,360,101,4,271,119,LTAdatasets/2708/annotate/2708-2021_03_20_193115.jpg,264.5,110.0,0.41328125,0.3055555555555556,0.0203125,0.05
2708-2021_03_20_193115.jpg,van,19,126,640,20,360,116,3,145,136,LTAdatasets/2708/annotate/2708-2021_03_20_193115.jpg,135.5,126.0,0.21171875,0.35,0.0296875,0.05555555555555555
2708-2021_03_20_202758.jpg,car,61,138,640,57,360,291,1,199,348,LTAdatasets/2708/annotate/2708-2021_03_20_202758.jpg,168.5,319.5,0.26328125,0.8875,0.0953125,0.15833333333333333
2708-2021_03_20_202758.jpg,car,29,339,640,28,360,157,1,368,185,LTAdatasets/2708/annotate/2708-2021_03_20_202758.jpg,353.5,171.0,0.55234375,0.475,0.0453125,0.07777777777777778
2708-2021_03_20_202758.jpg,car,29,110,640,18,360,129,1,139,147,LTAdatasets/2708/annotate/2708-2021_03_20_202758.jpg,124.5,138.0,0.19453125,0.38333333333333336,0.0453125,0.05
2708-2021_03_20_202758.jpg,car,15,238,640,19,360,100,1,253,119,LTAdatasets/2708/annotate/2708-2021_03_20_202758.jpg,245.5,109.5,0.38359375,0.30416666666666664,0.0234375,0.05277777777777778
2708-2021_03_20_202758.jpg,car,29,424,640,29,360,145,1,453,174,LTAdatasets/2708/annotate/2708-2021_03_20_202758.jpg,438.5,159.5,0.68515625,0.44305555555555554,0.0453125,0.08055555555555556
2708-2021_03_20_202758.jpg,car,11,125,640,11,360,102,1,136,113,LTAdatasets/2708/annotate/2708-2021_03_20_202758.jpg,130.5,107.5,0.20390625,0.2986111111111111,0.0171875,0.030555555555555555
2708-2021_03_20_202758.jpg,car,20,238,640,15,360,81,1,258,96,LTAdatasets/2708/annotate/2708-2021_03_20_202758.jpg,248.0,88.5,0.3875,0.24583333333333332,0.03125,0.041666666666666664
2708-2021_03_20_195736.jpg,lorry_truck,38,215,640,38,360,111,2,253,149,LTAdatasets/2708/annotate/2708-2021_03_20_195736.jpg,234.0,130.0,0.365625,0.3611111111111111,0.059375,0.10555555555555556
2708-2021_03_20_195736.jpg,van,22,262,640,22,360,123,3,284,145,LTAdatasets/2708/annotate/2708-2021_03_20_195736.jpg,273.0,134.0,0.4265625,0.37222222222222223,0.034375,0.06111111111111111
2708-2021_03_20_195736.jpg,car,23,294,640,24,360,118,1,317,142,LTAdatasets/2708/annotate/2708-2021_03_20_195736.jpg,305.5,130.0,0.47734375,0.3611111111111111,0.0359375,0.06666666666666667
2708-2021_03_20_190413.jpg,van,55,353,640,46,360,208,3,408,254,LTAdatasets/2708/annotate/2708-2021_03_20_190413.jpg,380.5,231.0,0.59453125,0.6416666666666667,0.0859375,0.12777777777777777
2708-2021_03_20_190413.jpg,car,30,465,640,26,360,148,1,495,174,LTAdatasets/2708/annotate/2708-2021_03_20_190413.jpg,480.0,161.0,0.75,0.44722222222222224,0.046875,0.07222222222222222
2708-2021_03_20_190413.jpg,car,19,314,640,20,360,142,1,333,162,LTAdatasets/2708/annotate/2708-2021_03_20_190413.jpg,323.5,152.0,0.50546875,0.4222222222222222,0.0296875,0.05555555555555555
2708-2021_03_20_190413.jpg,lorry_truck,19,260,640,23,360,119,2,279,142,LTAdatasets/2708/annotate/2708-2021_03_20_190413.jpg,269.5,130.5,0.42109375,0.3625,0.0296875,0.06388888888888888
2708-2021_03_20_190413.jpg,car,14,232,640,12,360,97,1,246,109,LTAdatasets/2708/annotate/2708-2021_03_20_190413.jpg,239.0,103.0,0.3734375,0.2861111111111111,0.021875,0.03333333333333333
2708-2021_03_20_190413.jpg,car,16,259,640,13,360,96,1,275,109,LTAdatasets/2708/annotate/2708-2021_03_20_190413.jpg,267.0,102.5,0.4171875,0.2847222222222222,0.025,0.03611111111111111
2708-2021_03_20_190413.jpg,lorry_truck,25,403,640,26,360,103,2,428,129,LTAdatasets/2708/annotate/2708-2021_03_20_190413.jpg,415.5,116.0,0.64921875,0.32222222222222224,0.0390625,0.07222222222222222
2708-2021_03_20_192735.jpg,bus,88,274,640,71,360,198,5,362,269,LTAdatasets/2708/annotate/2708-2021_03_20_192735.jpg,318.0,233.5,0.496875,0.6486111111111111,0.1375,0.19722222222222222
2708-2021_03_20_192735.jpg,bus,27,194,640,32,360,72,5,221,104,LTAdatasets/2708/annotate/2708-2021_03_20_192735.jpg,207.5,88.0,0.32421875,0.24444444444444444,0.0421875,0.08888888888888889
2708-2021_03_20_192735.jpg,bike,14,246,640,17,360,97,4,260,114,LTAdatasets/2708/annotate/2708-2021_03_20_192735.jpg,253.0,105.5,0.3953125,0.29305555555555557,0.021875,0.04722222222222222
2708-2021_03_20_194315.jpg,lorry_truck,63,286,640,61,360,227,2,349,288,LTAdatasets/2708/annotate/2708-2021_03_20_194315.jpg,317.5,257.5,0.49609375,0.7152777777777778,0.0984375,0.16944444444444445
2708-2021_03_20_194315.jpg,car,43,393,640,44,360,247,1,436,291,LTAdatasets/2708/annotate/2708-2021_03_20_194315.jpg,414.5,269.0,0.64765625,0.7472222222222222,0.0671875,0.12222222222222222
2708-2021_03_20_194315.jpg,car,21,256,640,16,360,122,1,277,138,LTAdatasets/2708/annotate/2708-2021_03_20_194315.jpg,266.5,130.0,0.41640625,0.3611111111111111,0.0328125,0.044444444444444446
2708-2021_03_20_194315.jpg,car,28,395,640,19,360,132,1,423,151,LTAdatasets/2708/annotate/2708-2021_03_20_194315.jpg,409.0,141.5,0.6390625,0.39305555555555555,0.04375,0.05277777777777778
2708-2021_03_20_180410.jpg,car,34,269,640,33,360,201,1,303,234,LTAdatasets/2708/annotate/2708-2021_03_20_180410.jpg,286.0,217.5,0.446875,0.6041666666666666,0.053125,0.09166666666666666
2708-2021_03_20_180410.jpg,car,34,513,640,30,360,195,1,547,225,LTAdatasets/2708/annotate/2708-2021_03_20_180410.jpg,530.0,210.0,0.828125,0.5833333333333334,0.053125,0.08333333333333333
2708-2021_03_20_180410.jpg,van,31,120,640,30,360,131,3,151,161,LTAdatasets/2708/annotate/2708-2021_03_20_180410.jpg,135.5,146.0,0.21171875,0.40555555555555556,0.0484375,0.08333333333333333
2708-2021_03_20_180410.jpg,car,14,124,640,14,360,101,1,138,115,LTAdatasets/2708/annotate/2708-2021_03_20_180410.jpg,131.0,108.0,0.2046875,0.3,0.021875,0.03888888888888889
2708-2021_03_20_180410.jpg,van,22,227,640,12,360,98,3,249,110,LTAdatasets/2708/annotate/2708-2021_03_20_180410.jpg,238.0,104.0,0.371875,0.28888888888888886,0.034375,0.03333333333333333
2708-2021_03_20_200637.jpg,car,31,474,640,26,360,170,1,505,196,LTAdatasets/2708/annotate/2708-2021_03_20_200637.jpg,489.5,183.0,0.76484375,0.5083333333333333,0.0484375,0.07222222222222222
2708-2021_03_20_185453.jpg,lorry_truck,35,279,640,29,360,148,2,314,177,LTAdatasets/2708/annotate/2708-2021_03_20_185453.jpg,296.5,162.5,0.46328125,0.4513888888888889,0.0546875,0.08055555555555556
2708-2021_03_20_185453.jpg,van,31,609,640,41,360,203,3,640,244,LTAdatasets/2708/annotate/2708-2021_03_20_185453.jpg,624.5,223.5,0.97578125,0.6208333333333333,0.0484375,0.11388888888888889
2708-2021_03_20_185453.jpg,car,22,133,640,22,360,141,1,155,163,LTAdatasets/2708/annotate/2708-2021_03_20_185453.jpg,144.0,152.0,0.225,0.4222222222222222,0.034375,0.06111111111111111
2708-2021_03_20_185453.jpg,car,18,119,640,11,360,112,1,137,123,LTAdatasets/2708/annotate/2708-2021_03_20_185453.jpg,128.0,117.5,0.2,0.3263888888888889,0.028125,0.030555555555555555
2708-2021_03_20_185453.jpg,car,18,244,640,14,360,111,1,262,125,LTAdatasets/2708/annotate/2708-2021_03_20_185453.jpg,253.0,118.0,0.3953125,0.3277777777777778,0.028125,0.03888888888888889
2708-2021_03_20_182752.jpg,bike,16,335,640,24,360,193,4,351,217,LTAdatasets/2708/annotate/2708-2021_03_20_182752.jpg,343.0,205.0,0.5359375,0.5694444444444444,0.025,0.06666666666666667
2708-2021_03_20_182752.jpg,bike,15,314,640,22,360,151,4,329,173,LTAdatasets/2708/annotate/2708-2021_03_20_182752.jpg,321.5,162.0,0.50234375,0.45,0.0234375,0.06111111111111111
2708-2021_03_20_182752.jpg,car,26,127,640,27,360,179,1,153,206,LTAdatasets/2708/annotate/2708-2021_03_20_182752.jpg,140.0,192.5,0.21875,0.5347222222222222,0.040625,0.075
2708-2021_03_20_182752.jpg,bike,28,251,640,21,360,124,4,279,145,LTAdatasets/2708/annotate/2708-2021_03_20_182752.jpg,265.0,134.5,0.4140625,0.3736111111111111,0.04375,0.058333333333333334
2708-2021_03_20_182752.jpg,bike,51,159,640,52,360,293,4,210,345,LTAdatasets/2708/annotate/2708-2021_03_20_182752.jpg,184.5,319.0,0.28828125,0.8861111111111111,0.0796875,0.14444444444444443
2708-2021_03_20_182752.jpg,lorry_truck,19,409,640,26,360,115,2,428,141,LTAdatasets/2708/annotate/2708-2021_03_20_182752.jpg,418.5,128.0,0.65390625,0.35555555555555557,0.0296875,0.07222222222222222
2708-2021_03_20_083640.jpg,car,25,280,640,22,360,146,1,305,168,LTAdatasets/2708/annotate/2708-2021_03_20_083640.jpg,292.5,157.0,0.45703125,0.4361111111111111,0.0390625,0.06111111111111111
2708-2021_03_20_083640.jpg,car,26,597,640,34,360,222,1,623,256,LTAdatasets/2708/annotate/2708-2021_03_20_083640.jpg,610.0,239.0,0.953125,0.6638888888888889,0.040625,0.09444444444444444
2708-2021_03_20_083640.jpg,van,35,443,640,23,360,140,3,478,163,LTAdatasets/2708/annotate/2708-2021_03_20_083640.jpg,460.5,151.5,0.71953125,0.42083333333333334,0.0546875,0.06388888888888888
2708-2021_03_20_083640.jpg,car,19,124,640,17,360,94,1,143,111,LTAdatasets/2708/annotate/2708-2021_03_20_083640.jpg,133.5,102.5,0.20859375,0.2847222222222222,0.0296875,0.04722222222222222
2708-2021_03_20_083640.jpg,car,12,199,640,12,360,92,1,211,104,LTAdatasets/2708/annotate/2708-2021_03_20_083640.jpg,205.0,98.0,0.3203125,0.2722222222222222,0.01875,0.03333333333333333
2708-2021_03_20_191614.jpg,car,42,312,640,30,360,187,1,354,217,LTAdatasets/2708/annotate/2708-2021_03_20_191614.jpg,333.0,202.0,0.5203125,0.5611111111111111,0.065625,0.08333333333333333
2708-2021_03_20_191614.jpg,car,28,127,640,24,360,157,1,155,181,LTAdatasets/2708/annotate/2708-2021_03_20_191614.jpg,141.0,169.0,0.2203125,0.46944444444444444,0.04375,0.06666666666666667
2708-2021_03_20_191614.jpg,car,19,119,640,18,360,108,1,138,126,LTAdatasets/2708/annotate/2708-2021_03_20_191614.jpg,128.5,117.0,0.20078125,0.325,0.0296875,0.05
2708-2021_03_20_082440.jpg,car,24,125,640,24,360,142,1,149,166,LTAdatasets/2708/annotate/2708-2021_03_20_082440.jpg,137.0,154.0,0.2140625,0.42777777777777776,0.0375,0.06666666666666667
2708-2021_03_20_082440.jpg,lorry_truck,13,485,640,37,360,128,2,498,165,LTAdatasets/2708/annotate/2708-2021_03_20_082440.jpg,491.5,146.5,0.76796875,0.40694444444444444,0.0203125,0.10277777777777777
2708-2021_03_20_181851.jpg,van,51,288,640,57,360,206,3,339,263,LTAdatasets/2708/annotate/2708-2021_03_20_181851.jpg,313.5,234.5,0.48984375,0.6513888888888889,0.0796875,0.15833333333333333
2708-2021_03_20_181851.jpg,van,33,238,640,36,360,153,3,271,189,LTAdatasets/2708/annotate/2708-2021_03_20_181851.jpg,254.5,171.0,0.39765625,0.475,0.0515625,0.1
2708-2021_03_20_181851.jpg,car,41,378,640,29,360,190,1,419,219,LTAdatasets/2708/annotate/2708-2021_03_20_181851.jpg,398.5,204.5,0.62265625,0.5680555555555555,0.0640625,0.08055555555555556
2708-2021_03_20_181851.jpg,car,26,611,640,24,360,218,1,637,242,LTAdatasets/2708/annotate/2708-2021_03_20_181851.jpg,624.0,230.0,0.975,0.6388888888888888,0.040625,0.06666666666666667
2708-2021_03_20_181851.jpg,van,58,136,640,70,360,281,3,194,351,LTAdatasets/2708/annotate/2708-2021_03_20_181851.jpg,165.0,316.0,0.2578125,0.8777777777777778,0.090625,0.19444444444444445
2708-2021_03_20_181851.jpg,car,15,438,640,16,360,137,1,453,153,LTAdatasets/2708/annotate/2708-2021_03_20_181851.jpg,445.5,145.0,0.69609375,0.4027777777777778,0.0234375,0.044444444444444446
2708-2021_03_20_092543.jpg,car,37,298,640,22,360,176,1,335,198,LTAdatasets/2708/annotate/2708-2021_03_20_092543.jpg,316.5,187.0,0.49453125,0.5194444444444445,0.0578125,0.06111111111111111
2708-2021_03_20_092543.jpg,van,36,132,640,41,360,163,3,168,204,LTAdatasets/2708/annotate/2708-2021_03_20_092543.jpg,150.0,183.5,0.234375,0.5097222222222222,0.05625,0.11388888888888889
2708-2021_03_20_092543.jpg,lorry_truck,15,128,640,23,360,127,2,143,150,LTAdatasets/2708/annotate/2708-2021_03_20_092543.jpg,135.5,138.5,0.21171875,0.38472222222222224,0.0234375,0.06388888888888888
2708-2021_03_20_092543.jpg,van,18,406,640,19,360,122,3,424,141,LTAdatasets/2708/annotate/2708-2021_03_20_092543.jpg,415.0,131.5,0.6484375,0.36527777777777776,0.028125,0.05277777777777778
2708-2021_03_20_202437.jpg,lorry_truck,16,376,640,24,360,88,2,392,112,LTAdatasets/2708/annotate/2708-2021_03_20_202437.jpg,384.0,100.0,0.6,0.2777777777777778,0.025,0.06666666666666667
2708-2021_03_20_190113.jpg,car,38,352,640,33,360,210,1,390,243,LTAdatasets/2708/annotate/2708-2021_03_20_190113.jpg,371.0,226.5,0.5796875,0.6291666666666667,0.059375,0.09166666666666666
2708-2021_03_20_190113.jpg,car,28,342,640,29,360,154,1,370,183,LTAdatasets/2708/annotate/2708-2021_03_20_190113.jpg,356.0,168.5,0.55625,0.46805555555555556,0.04375,0.08055555555555556
2708-2021_03_20_190113.jpg,car,22,264,640,21,360,136,1,286,157,LTAdatasets/2708/annotate/2708-2021_03_20_190113.jpg,275.0,146.5,0.4296875,0.40694444444444444,0.034375,0.058333333333333334
2708-2021_03_20_190113.jpg,bike,16,249,640,18,360,103,4,265,121,LTAdatasets/2708/annotate/2708-2021_03_20_190113.jpg,257.0,112.0,0.4015625,0.3111111111111111,0.025,0.05
2708-2021_03_20_190113.jpg,lorry_truck,15,126,640,16,360,90,2,141,106,LTAdatasets/2708/annotate/2708-2021_03_20_190113.jpg,133.5,98.0,0.20859375,0.2722222222222222,0.0234375,0.044444444444444446
2708-2021_03_20_075818.jpg,car,22,296,640,18,360,129,1,318,147,LTAdatasets/2708/annotate/2708-2021_03_20_075818.jpg,307.0,138.0,0.4796875,0.38333333333333336,0.034375,0.05
2708-2021_03_20_074618.jpg,car,14,228,640,11,360,76,1,242,87,LTAdatasets/2708/annotate/2708-2021_03_20_074618.jpg,235.0,81.5,0.3671875,0.2263888888888889,0.021875,0.030555555555555555
2708-2021_03_20_074618.jpg,lorry_truck,16,205,640,12,360,76,2,221,88,LTAdatasets/2708/annotate/2708-2021_03_20_074618.jpg,213.0,82.0,0.3328125,0.22777777777777777,0.025,0.03333333333333333
2708-2021_03_20_074618.jpg,bike,9,119,640,11,360,84,4,128,95,LTAdatasets/2708/annotate/2708-2021_03_20_074618.jpg,123.5,89.5,0.19296875,0.24861111111111112,0.0140625,0.030555555555555555
2708-2021_03_20_091002.jpg,van,21,222,640,18,360,123,3,243,141,LTAdatasets/2708/annotate/2708-2021_03_20_091002.jpg,232.5,132.0,0.36328125,0.36666666666666664,0.0328125,0.05
2708-2021_03_20_091002.jpg,car,85,553,640,34,360,326,1,638,360,LTAdatasets/2708/annotate/2708-2021_03_20_091002.jpg,595.5,343.0,0.93046875,0.9527777777777777,0.1328125,0.09444444444444444
2708-2021_03_20_091002.jpg,lorry_truck,21,193,640,30,360,72,2,214,102,LTAdatasets/2708/annotate/2708-2021_03_20_091002.jpg,203.5,87.0,0.31796875,0.24166666666666667,0.0328125,0.08333333333333333
2708-2021_03_20_091002.jpg,lorry_truck,21,439,640,25,360,114,2,460,139,LTAdatasets/2708/annotate/2708-2021_03_20_091002.jpg,449.5,126.5,0.70234375,0.35138888888888886,0.0328125,0.06944444444444445
2708-2021_03_20_091002.jpg,lorry_truck,18,122,640,17,360,89,2,140,106,LTAdatasets/2708/annotate/2708-2021_03_20_091002.jpg,131.0,97.5,0.2046875,0.2708333333333333,0.028125,0.04722222222222222
2708-2021_03_20_200116.jpg,car,55,349,640,32,360,222,1,404,254,LTAdatasets/2708/annotate/2708-2021_03_20_200116.jpg,376.5,238.0,0.58828125,0.6611111111111111,0.0859375,0.08888888888888889
2708-2021_03_20_200116.jpg,car,56,409,640,37,360,211,1,465,248,LTAdatasets/2708/annotate/2708-2021_03_20_200116.jpg,437.0,229.5,0.6828125,0.6375,0.0875,0.10277777777777777
2708-2021_03_20_200116.jpg,car,26,120,640,18,360,136,1,146,154,LTAdatasets/2708/annotate/2708-2021_03_20_200116.jpg,133.0,145.0,0.2078125,0.4027777777777778,0.040625,0.05
2708-2021_03_20_200116.jpg,bike,13,121,640,18,360,161,4,134,179,LTAdatasets/2708/annotate/2708-2021_03_20_200116.jpg,127.5,170.0,0.19921875,0.4722222222222222,0.0203125,0.05
2708-2021_03_20_200116.jpg,lorry_truck,20,249,640,28,360,105,2,269,133,LTAdatasets/2708/annotate/2708-2021_03_20_200116.jpg,259.0,119.0,0.4046875,0.33055555555555555,0.03125,0.07777777777777778
2708-2021_03_20_200116.jpg,car,21,212,640,19,360,111,1,233,130,LTAdatasets/2708/annotate/2708-2021_03_20_200116.jpg,222.5,120.5,0.34765625,0.3347222222222222,0.0328125,0.05277777777777778
2708-2021_03_20_200116.jpg,car,26,395,640,18,360,116,1,421,134,LTAdatasets/2708/annotate/2708-2021_03_20_200116.jpg,408.0,125.0,0.6375,0.3472222222222222,0.040625,0.05
2708-2021_03_20_200116.jpg,car,16,243,640,10,360,84,1,259,94,LTAdatasets/2708/annotate/2708-2021_03_20_200116.jpg,251.0,89.0,0.3921875,0.24722222222222223,0.025,0.027777777777777776
2708-2021_03_20_073937.jpg,bike,12,255,640,20,360,122,4,267,142,LTAdatasets/2708/annotate/2708-2021_03_20_073937.jpg,261.0,132.0,0.4078125,0.36666666666666664,0.01875,0.05555555555555555
2708-2021_03_20_073937.jpg,car,39,297,640,27,360,167,1,336,194,LTAdatasets/2708/annotate/2708-2021_03_20_073937.jpg,316.5,180.5,0.49453125,0.5013888888888889,0.0609375,0.075
2708-2021_03_20_073937.jpg,car,18,122,640,17,360,94,1,140,111,LTAdatasets/2708/annotate/2708-2021_03_20_073937.jpg,131.0,102.5,0.2046875,0.2847222222222222,0.028125,0.04722222222222222
2708-2021_03_20_073937.jpg,lorry_truck,29,383,640,29,360,103,2,412,132,LTAdatasets/2708/annotate/2708-2021_03_20_073937.jpg,397.5,117.5,0.62109375,0.3263888888888889,0.0453125,0.08055555555555556
2708-2021_03_20_180110.jpg,car,43,432,640,43,360,226,1,475,269,LTAdatasets/2708/annotate/2708-2021_03_20_180110.jpg,453.5,247.5,0.70859375,0.6875,0.0671875,0.11944444444444445
2708-2021_03_20_180110.jpg,lorry_truck,44,135,640,57,360,220,2,179,277,LTAdatasets/2708/annotate/2708-2021_03_20_180110.jpg,157.0,248.5,0.2453125,0.6902777777777778,0.06875,0.15833333333333333
2708-2021_03_20_180110.jpg,car,37,334,640,23,360,159,1,371,182,LTAdatasets/2708/annotate/2708-2021_03_20_180110.jpg,352.5,170.5,0.55078125,0.4736111111111111,0.0578125,0.06388888888888888
2708-2021_03_20_180110.jpg,car,25,277,640,20,360,148,1,302,168,LTAdatasets/2708/annotate/2708-2021_03_20_180110.jpg,289.5,158.0,0.45234375,0.4388888888888889,0.0390625,0.05555555555555555
2708-2021_03_20_180110.jpg,lorry_truck,30,229,640,32,360,142,2,259,174,LTAdatasets/2708/annotate/2708-2021_03_20_180110.jpg,244.0,158.0,0.38125,0.4388888888888889,0.046875,0.08888888888888889
2708-2021_03_20_180110.jpg,lorry_truck,103,456,640,42,360,318,2,559,360,LTAdatasets/2708/annotate/2708-2021_03_20_180110.jpg,507.5,339.0,0.79296875,0.9416666666666667,0.1609375,0.11666666666666667
2708-2021_03_20_180110.jpg,van,18,241,640,17,360,111,3,259,128,LTAdatasets/2708/annotate/2708-2021_03_20_180110.jpg,250.0,119.5,0.390625,0.33194444444444443,0.028125,0.04722222222222222
2708-2021_03_20_180110.jpg,lorry_truck,23,207,640,20,360,102,2,230,122,LTAdatasets/2708/annotate/2708-2021_03_20_180110.jpg,218.5,112.0,0.34140625,0.3111111111111111,0.0359375,0.05555555555555555
2708-2021_03_20_090402.jpg,car,23,289,640,15,360,125,1,312,140,LTAdatasets/2708/annotate/2708-2021_03_20_090402.jpg,300.5,132.5,0.46953125,0.3680555555555556,0.0359375,0.041666666666666664
2708-2021_03_20_090402.jpg,car,46,581,640,36,360,229,1,627,265,LTAdatasets/2708/annotate/2708-2021_03_20_090402.jpg,604.0,247.0,0.94375,0.6861111111111111,0.071875,0.1
2708-2021_03_20_090402.jpg,car,26,401,640,19,360,138,1,427,157,LTAdatasets/2708/annotate/2708-2021_03_20_090402.jpg,414.0,147.5,0.646875,0.4097222222222222,0.040625,0.05277777777777778
2708-2021_03_20_204238.jpg,car,23,119,640,14,360,125,1,142,139,LTAdatasets/2708/annotate/2708-2021_03_20_204238.jpg,130.5,132.0,0.20390625,0.36666666666666664,0.0359375,0.03888888888888889
2708-2021_03_20_204238.jpg,car,24,238,640,14,360,109,1,262,123,LTAdatasets/2708/annotate/2708-2021_03_20_204238.jpg,250.0,116.0,0.390625,0.32222222222222224,0.0375,0.03888888888888889
2708-2021_03_20_091623.jpg,car,21,269,640,16,360,139,1,290,155,LTAdatasets/2708/annotate/2708-2021_03_20_091623.jpg,279.5,147.0,0.43671875,0.4083333333333333,0.0328125,0.044444444444444446
2708-2021_03_20_091623.jpg,car,25,125,640,19,360,155,1,150,174,LTAdatasets/2708/annotate/2708-2021_03_20_091623.jpg,137.5,164.5,0.21484375,0.45694444444444443,0.0390625,0.05277777777777778
2708-2021_03_20_091623.jpg,car,18,131,640,12,360,127,1,149,139,LTAdatasets/2708/annotate/2708-2021_03_20_091623.jpg,140.0,133.0,0.21875,0.36944444444444446,0.028125,0.03333333333333333
2708-2021_03_20_201317.jpg,car,37,335,640,37,360,198,1,372,235,LTAdatasets/2708/annotate/2708-2021_03_20_201317.jpg,353.5,216.5,0.55234375,0.6013888888888889,0.0578125,0.10277777777777777
2708-2021_03_20_201317.jpg,car,21,269,640,17,360,126,1,290,143,LTAdatasets/2708/annotate/2708-2021_03_20_201317.jpg,279.5,134.5,0.43671875,0.3736111111111111,0.0328125,0.04722222222222222
2708-2021_03_20_201317.jpg,van,28,128,640,22,360,152,3,156,174,LTAdatasets/2708/annotate/2708-2021_03_20_201317.jpg,142.0,163.0,0.221875,0.4527777777777778,0.04375,0.06111111111111111
2708-2021_03_20_201317.jpg,lorry_truck,40,131,640,60,360,180,2,171,240,LTAdatasets/2708/annotate/2708-2021_03_20_201317.jpg,151.0,210.0,0.2359375,0.5833333333333334,0.0625,0.16666666666666666
2708-2021_03_20_201317.jpg,lorry_truck,17,124,640,24,360,88,2,141,112,LTAdatasets/2708/annotate/2708-2021_03_20_201317.jpg,132.5,100.0,0.20703125,0.2777777777777778,0.0265625,0.06666666666666667
2708-2021_03_20_181011.jpg,bus,51,375,640,37,360,87,5,426,124,LTAdatasets/2708/annotate/2708-2021_03_20_181011.jpg,400.5,105.5,0.62578125,0.29305555555555557,0.0796875,0.10277777777777777
2708-2021_03_20_181011.jpg,car,22,386,640,19,360,131,1,408,150,LTAdatasets/2708/annotate/2708-2021_03_20_181011.jpg,397.0,140.5,0.6203125,0.3902777777777778,0.034375,0.05277777777777778
2708-2021_03_20_181011.jpg,car,69,450,640,30,360,330,1,519,360,LTAdatasets/2708/annotate/2708-2021_03_20_181011.jpg,484.5,345.0,0.75703125,0.9583333333333334,0.1078125,0.08333333333333333
2708-2021_03_20_181011.jpg,car,25,284,640,15,360,123,1,309,138,LTAdatasets/2708/annotate/2708-2021_03_20_181011.jpg,296.5,130.5,0.46328125,0.3625,0.0390625,0.041666666666666664
2708-2021_03_20_181011.jpg,lorry_truck,39,294,640,36,360,159,2,333,195,LTAdatasets/2708/annotate/2708-2021_03_20_181011.jpg,313.5,177.0,0.48984375,0.49166666666666664,0.0609375,0.1
2708-2021_03_20_181011.jpg,van,48,285,640,48,360,215,3,333,263,LTAdatasets/2708/annotate/2708-2021_03_20_181011.jpg,309.0,239.0,0.4828125,0.6638888888888889,0.075,0.13333333333333333
2708-2021_03_20_181011.jpg,van,41,124,640,37,360,209,3,165,246,LTAdatasets/2708/annotate/2708-2021_03_20_181011.jpg,144.5,227.5,0.22578125,0.6319444444444444,0.0640625,0.10277777777777777
2708-2021_03_20_181011.jpg,car,22,234,640,12,360,104,1,256,116,LTAdatasets/2708/annotate/2708-2021_03_20_181011.jpg,245.0,110.0,0.3828125,0.3055555555555556,0.034375,0.03333333333333333
2708-2021_03_20_095205.jpg,car,32,313,640,27,360,179,1,345,206,LTAdatasets/2708/annotate/2708-2021_03_20_095205.jpg,329.0,192.5,0.5140625,0.5347222222222222,0.05,0.075
2708-2021_03_20_095205.jpg,car,54,130,640,52,360,277,1,184,329,LTAdatasets/2708/annotate/2708-2021_03_20_095205.jpg,157.0,303.0,0.2453125,0.8416666666666667,0.084375,0.14444444444444443
2708-2021_03_20_095205.jpg,car,31,309,640,19,360,138,1,340,157,LTAdatasets/2708/annotate/2708-2021_03_20_095205.jpg,324.5,147.5,0.50703125,0.4097222222222222,0.0484375,0.05277777777777778
2708-2021_03_20_095205.jpg,car,26,382,640,13,360,131,1,408,144,LTAdatasets/2708/annotate/2708-2021_03_20_095205.jpg,395.0,137.5,0.6171875,0.3819444444444444,0.040625,0.03611111111111111
2708-2021_03_20_095205.jpg,car,15,406,640,19,360,122,1,421,141,LTAdatasets/2708/annotate/2708-2021_03_20_095205.jpg,413.5,131.5,0.64609375,0.36527777777777776,0.0234375,0.05277777777777778
2708-2021_03_20_095205.jpg,car,34,467,640,28,360,169,1,501,197,LTAdatasets/2708/annotate/2708-2021_03_20_095205.jpg,484.0,183.0,0.75625,0.5083333333333333,0.053125,0.07777777777777778
2708-2021_03_20_095205.jpg,lorry_truck,23,237,640,35,360,132,2,260,167,LTAdatasets/2708/annotate/2708-2021_03_20_095205.jpg,248.5,149.5,0.38828125,0.4152777777777778,0.0359375,0.09722222222222222
2708-2021_03_20_095205.jpg,lorry_truck,29,120,640,45,360,114,2,149,159,LTAdatasets/2708/annotate/2708-2021_03_20_095205.jpg,134.5,136.5,0.21015625,0.37916666666666665,0.0453125,0.125
2708-2021_03_20_095205.jpg,lorry_truck,31,609,640,46,360,184,2,640,230,LTAdatasets/2708/annotate/2708-2021_03_20_095205.jpg,624.5,207.0,0.97578125,0.575,0.0484375,0.12777777777777777
2708-2021_03_20_202217.jpg,bike,12,308,640,31,360,149,4,320,180,LTAdatasets/2708/annotate/2708-2021_03_20_202217.jpg,314.0,164.5,0.490625,0.45694444444444443,0.01875,0.08611111111111111
2708-2021_03_20_202217.jpg,car,25,142,640,36,360,173,1,167,209,LTAdatasets/2708/annotate/2708-2021_03_20_202217.jpg,154.5,191.0,0.24140625,0.5305555555555556,0.0390625,0.1
2708-2021_03_20_202217.jpg,car,25,128,640,15,360,134,1,153,149,LTAdatasets/2708/annotate/2708-2021_03_20_202217.jpg,140.5,141.5,0.21953125,0.39305555555555555,0.0390625,0.041666666666666664
2708-2021_03_20_202217.jpg,bus,35,462,640,24,360,131,5,497,155,LTAdatasets/2708/annotate/2708-2021_03_20_202217.jpg,479.5,143.0,0.74921875,0.3972222222222222,0.0546875,0.06666666666666667
2708-2021_03_20_202217.jpg,van,20,213,640,15,360,88,3,233,103,LTAdatasets/2708/annotate/2708-2021_03_20_202217.jpg,223.0,95.5,0.3484375,0.2652777777777778,0.03125,0.041666666666666664
2708-2021_03_20_184913.jpg,lorry_truck,30,255,640,26,360,119,2,285,145,LTAdatasets/2708/annotate/2708-2021_03_20_184913.jpg,270.0,132.0,0.421875,0.36666666666666664,0.046875,0.07222222222222222
2708-2021_03_20_184913.jpg,lorry_truck,24,201,640,23,360,95,2,225,118,LTAdatasets/2708/annotate/2708-2021_03_20_184913.jpg,213.0,106.5,0.3328125,0.29583333333333334,0.0375,0.06388888888888888
2708-2021_03_20_184913.jpg,lorry_truck,17,233,640,16,360,99,2,250,115,LTAdatasets/2708/annotate/2708-2021_03_20_184913.jpg,241.5,107.0,0.37734375,0.2972222222222222,0.0265625,0.044444444444444446
2708-2021_03_20_184913.jpg,car,33,379,640,24,360,124,1,412,148,LTAdatasets/2708/annotate/2708-2021_03_20_184913.jpg,395.5,136.0,0.61796875,0.37777777777777777,0.0515625,0.06666666666666667
2708-2021_03_20_184913.jpg,bike,17,118,640,22,360,128,4,135,150,LTAdatasets/2708/annotate/2708-2021_03_20_184913.jpg,126.5,139.0,0.19765625,0.3861111111111111,0.0265625,0.06111111111111111
2708-2021_03_20_184913.jpg,car,9,123,640,12,360,84,1,132,96,LTAdatasets/2708/annotate/2708-2021_03_20_184913.jpg,127.5,90.0,0.19921875,0.25,0.0140625,0.03333333333333333
2708-2021_03_20_194616.jpg,car,34,139,640,33,360,175,1,173,208,LTAdatasets/2708/annotate/2708-2021_03_20_194616.jpg,156.0,191.5,0.24375,0.5319444444444444,0.053125,0.09166666666666666
2708-2021_03_20_194616.jpg,car,25,289,640,17,360,123,1,314,140,LTAdatasets/2708/annotate/2708-2021_03_20_194616.jpg,301.5,131.5,0.47109375,0.36527777777777776,0.0390625,0.04722222222222222
2708-2021_03_20_194616.jpg,car,20,215,640,22,360,118,1,235,140,LTAdatasets/2708/annotate/2708-2021_03_20_194616.jpg,225.0,129.0,0.3515625,0.35833333333333334,0.03125,0.06111111111111111
2708-2021_03_20_194616.jpg,car,17,239,640,14,360,84,1,256,98,LTAdatasets/2708/annotate/2708-2021_03_20_194616.jpg,247.5,91.0,0.38671875,0.25277777777777777,0.0265625,0.03888888888888889
2708-2021_03_20_194616.jpg,car,14,441,640,22,360,131,1,455,153,LTAdatasets/2708/annotate/2708-2021_03_20_194616.jpg,448.0,142.0,0.7,0.39444444444444443,0.021875,0.06111111111111111
2708-2021_03_20_093724.jpg,bus,62,411,640,40,360,97,5,473,137,LTAdatasets/2708/annotate/2708-2021_03_20_093724.jpg,442.0,117.0,0.690625,0.325,0.096875,0.1111111111111111
2708-2021_03_20_093724.jpg,car,26,389,640,19,360,129,1,415,148,LTAdatasets/2708/annotate/2708-2021_03_20_093724.jpg,402.0,138.5,0.628125,0.38472222222222224,0.040625,0.05277777777777778
2708-2021_03_20_093724.jpg,car,22,268,640,19,360,103,1,290,122,LTAdatasets/2708/annotate/2708-2021_03_20_093724.jpg,279.0,112.5,0.4359375,0.3125,0.034375,0.05277777777777778
2708-2021_03_20_093724.jpg,van,17,198,640,14,360,96,3,215,110,LTAdatasets/2708/annotate/2708-2021_03_20_093724.jpg,206.5,103.0,0.32265625,0.2861111111111111,0.0265625,0.03888888888888889
2708-2021_03_20_093724.jpg,car,14,224,640,16,360,90,1,238,106,LTAdatasets/2708/annotate/2708-2021_03_20_093724.jpg,231.0,98.0,0.3609375,0.2722222222222222,0.021875,0.044444444444444446
2708-2021_03_20_193935.jpg,car,18,274,640,21,360,102,1,292,123,LTAdatasets/2708/annotate/2708-2021_03_20_193935.jpg,283.0,112.5,0.4421875,0.3125,0.028125,0.058333333333333334
2708-2021_03_20_193935.jpg,car,15,128,640,17,360,99,1,143,116,LTAdatasets/2708/annotate/2708-2021_03_20_193935.jpg,135.5,107.5,0.21171875,0.2986111111111111,0.0234375,0.04722222222222222
2708-2021_03_20_193935.jpg,car,26,396,640,18,360,119,1,422,137,LTAdatasets/2708/annotate/2708-2021_03_20_193935.jpg,409.0,128.0,0.6390625,0.35555555555555557,0.040625,0.05
2708-2021_03_20_193935.jpg,car,12,245,640,16,360,86,1,257,102,LTAdatasets/2708/annotate/2708-2021_03_20_193935.jpg,251.0,94.0,0.3921875,0.2611111111111111,0.01875,0.044444444444444446
2708-2021_03_20_072817.jpg,car,30,294,640,26,360,130,1,324,156,LTAdatasets/2708/annotate/2708-2021_03_20_072817.jpg,309.0,143.0,0.4828125,0.3972222222222222,0.046875,0.07222222222222222
2708-2021_03_20_072817.jpg,car,35,133,640,36,360,219,1,168,255,LTAdatasets/2708/annotate/2708-2021_03_20_072817.jpg,150.5,237.0,0.23515625,0.6583333333333333,0.0546875,0.1
2708-2021_03_20_072817.jpg,bike,21,115,640,27,360,167,4,136,194,LTAdatasets/2708/annotate/2708-2021_03_20_072817.jpg,125.5,180.5,0.19609375,0.5013888888888889,0.0328125,0.075
2708-2021_03_20_072817.jpg,bike,10,123,640,20,360,122,4,133,142,LTAdatasets/2708/annotate/2708-2021_03_20_072817.jpg,128.0,132.0,0.2,0.36666666666666664,0.015625,0.05555555555555555
2708-2021_03_20_072817.jpg,bike,19,217,640,17,360,114,4,236,131,LTAdatasets/2708/annotate/2708-2021_03_20_072817.jpg,226.5,122.5,0.35390625,0.3402777777777778,0.0296875,0.04722222222222222
2708-2021_03_20_072817.jpg,lorry_truck,21,401,640,23,360,115,2,422,138,LTAdatasets/2708/annotate/2708-2021_03_20_072817.jpg,411.5,126.5,0.64296875,0.35138888888888886,0.0328125,0.06388888888888888
2708-2021_03_20_072817.jpg,lorry_truck,17,224,640,18,360,85,2,241,103,LTAdatasets/2708/annotate/2708-2021_03_20_072817.jpg,232.5,94.0,0.36328125,0.2611111111111111,0.0265625,0.05
2708-2021_03_20_185753.jpg,bike,24,402,640,30,360,241,4,426,271,LTAdatasets/2708/annotate/2708-2021_03_20_185753.jpg,414.0,256.0,0.646875,0.7111111111111111,0.0375,0.08333333333333333
2708-2021_03_20_185753.jpg,bike,31,495,640,34,360,276,4,526,310,LTAdatasets/2708/annotate/2708-2021_03_20_185753.jpg,510.5,293.0,0.79765625,0.8138888888888889,0.0484375,0.09444444444444444
2708-2021_03_20_185753.jpg,car,22,253,640,22,360,121,1,275,143,LTAdatasets/2708/annotate/2708-2021_03_20_185753.jpg,264.0,132.0,0.4125,0.36666666666666664,0.034375,0.06111111111111111
2708-2021_03_20_185753.jpg,car,19,398,640,19,360,116,1,417,135,LTAdatasets/2708/annotate/2708-2021_03_20_185753.jpg,407.5,125.5,0.63671875,0.3486111111111111,0.0296875,0.05277777777777778
2708-2021_03_20_185753.jpg,car,17,263,640,13,360,103,1,280,116,LTAdatasets/2708/annotate/2708-2021_03_20_185753.jpg,271.5,109.5,0.42421875,0.30416666666666664,0.0265625,0.03611111111111111
2708-2021_03_20_084601.jpg,car,52,332,640,36,360,209,1,384,245,LTAdatasets/2708/annotate/2708-2021_03_20_084601.jpg,358.0,227.0,0.559375,0.6305555555555555,0.08125,0.1
2708-2021_03_20_084601.jpg,car,25,278,640,11,360,116,1,303,127,LTAdatasets/2708/annotate/2708-2021_03_20_084601.jpg,290.5,121.5,0.45390625,0.3375,0.0390625,0.030555555555555555
2708-2021_03_20_084601.jpg,car,21,397,640,19,360,118,1,418,137,LTAdatasets/2708/annotate/2708-2021_03_20_084601.jpg,407.5,127.5,0.63671875,0.3541666666666667,0.0328125,0.05277777777777778
2708-2021_03_20_084601.jpg,car,45,595,640,23,360,234,1,640,257,LTAdatasets/2708/annotate/2708-2021_03_20_084601.jpg,617.5,245.5,0.96484375,0.6819444444444445,0.0703125,0.06388888888888888
2708-2021_03_20_200937.jpg,car,48,131,640,50,360,239,1,179,289,LTAdatasets/2708/annotate/2708-2021_03_20_200937.jpg,155.0,264.0,0.2421875,0.7333333333333333,0.075,0.1388888888888889
2708-2021_03_20_200937.jpg,bike,11,124,640,16,360,110,4,135,126,LTAdatasets/2708/annotate/2708-2021_03_20_200937.jpg,129.5,118.0,0.20234375,0.3277777777777778,0.0171875,0.044444444444444446
2708-2021_03_20_200937.jpg,lorry_truck,17,120,640,20,360,69,2,137,89,LTAdatasets/2708/annotate/2708-2021_03_20_200937.jpg,128.5,79.0,0.20078125,0.21944444444444444,0.0265625,0.05555555555555555
2708-2021_03_20_081319.jpg,car,42,142,640,52,360,275,1,184,327,LTAdatasets/2708/annotate/2708-2021_03_20_081319.jpg,163.0,301.0,0.2546875,0.8361111111111111,0.065625,0.14444444444444443
2708-2021_03_20_081319.jpg,bus,29,473,640,36,360,121,5,502,157,LTAdatasets/2708/annotate/2708-2021_03_20_081319.jpg,487.5,139.0,0.76171875,0.3861111111111111,0.0453125,0.1
2708-2021_03_20_081319.jpg,car,23,128,640,23,360,121,1,151,144,LTAdatasets/2708/annotate/2708-2021_03_20_081319.jpg,139.5,132.5,0.21796875,0.3680555555555556,0.0359375,0.06388888888888888
2708-2021_03_20_094024.jpg,van,83,338,640,41,360,319,3,421,360,LTAdatasets/2708/annotate/2708-2021_03_20_094024.jpg,379.5,339.5,0.59296875,0.9430555555555555,0.1296875,0.11388888888888889
2708-2021_03_20_094024.jpg,car,23,402,640,14,360,120,1,425,134,LTAdatasets/2708/annotate/2708-2021_03_20_094024.jpg,413.5,127.0,0.64609375,0.3527777777777778,0.0359375,0.03888888888888889
2708-2021_03_20_094024.jpg,car,20,405,640,14,360,140,1,425,154,LTAdatasets/2708/annotate/2708-2021_03_20_094024.jpg,415.0,147.0,0.6484375,0.4083333333333333,0.03125,0.03888888888888889
2708-2021_03_20_094024.jpg,van,32,603,640,32,360,206,3,635,238,LTAdatasets/2708/annotate/2708-2021_03_20_094024.jpg,619.0,222.0,0.9671875,0.6166666666666667,0.05,0.08888888888888889
2708-2021_03_20_094024.jpg,car,22,121,640,15,360,122,1,143,137,LTAdatasets/2708/annotate/2708-2021_03_20_094024.jpg,132.0,129.5,0.20625,0.3597222222222222,0.034375,0.041666666666666664
2708-2021_03_20_193635.jpg,van,78,436,640,63,360,297,3,514,360,LTAdatasets/2708/annotate/2708-2021_03_20_193635.jpg,475.0,328.5,0.7421875,0.9125,0.121875,0.175
2708-2021_03_20_193635.jpg,car,62,490,640,40,360,275,1,552,315,LTAdatasets/2708/annotate/2708-2021_03_20_193635.jpg,521.0,295.0,0.8140625,0.8194444444444444,0.096875,0.1111111111111111
2708-2021_03_20_193635.jpg,car,40,137,640,29,360,215,1,177,244,LTAdatasets/2708/annotate/2708-2021_03_20_193635.jpg,157.0,229.5,0.2453125,0.6375,0.0625,0.08055555555555556
2708-2021_03_20_193635.jpg,bike,14,122,640,17,360,125,4,136,142,LTAdatasets/2708/annotate/2708-2021_03_20_193635.jpg,129.0,133.5,0.2015625,0.37083333333333335,0.021875,0.04722222222222222
2708-2021_03_20_182151.jpg,lorry_truck,44,259,640,42,360,187,2,303,229,LTAdatasets/2708/annotate/2708-2021_03_20_182151.jpg,281.0,208.0,0.4390625,0.5777777777777777,0.06875,0.11666666666666667
2708-2021_03_20_182151.jpg,car,40,131,640,38,360,234,1,171,272,LTAdatasets/2708/annotate/2708-2021_03_20_182151.jpg,151.0,253.0,0.2359375,0.7027777777777777,0.0625,0.10555555555555556
2708-2021_03_20_182151.jpg,car,17,250,640,19,360,116,1,267,135,LTAdatasets/2708/annotate/2708-2021_03_20_182151.jpg,258.5,125.5,0.40390625,0.3486111111111111,0.0265625,0.05277777777777778
2708-2021_03_20_182451.jpg,lorry_truck,23,408,640,34,360,221,2,431,255,LTAdatasets/2708/annotate/2708-2021_03_20_182451.jpg,419.5,238.0,0.65546875,0.6611111111111111,0.0359375,0.09444444444444444
2708-2021_03_20_182451.jpg,lorry_truck,34,272,640,49,360,170,2,306,219,LTAdatasets/2708/annotate/2708-2021_03_20_182451.jpg,289.0,194.5,0.4515625,0.5402777777777777,0.053125,0.1361111111111111
2708-2021_03_20_182451.jpg,car,21,129,640,20,360,149,1,150,169,LTAdatasets/2708/annotate/2708-2021_03_20_182451.jpg,139.5,159.0,0.21796875,0.44166666666666665,0.0328125,0.05555555555555555
2708-2021_03_20_182451.jpg,car,13,123,640,16,360,95,1,136,111,LTAdatasets/2708/annotate/2708-2021_03_20_182451.jpg,129.5,103.0,0.20234375,0.2861111111111111,0.0203125,0.044444444444444446
2708-2021_03_20_093103.jpg,car,23,134,640,22,360,164,1,157,186,LTAdatasets/2708/annotate/2708-2021_03_20_093103.jpg,145.5,175.0,0.22734375,0.4861111111111111,0.0359375,0.06111111111111111
2708-2021_03_20_093103.jpg,van,25,116,640,22,360,105,3,141,127,LTAdatasets/2708/annotate/2708-2021_03_20_093103.jpg,128.5,116.0,0.20078125,0.32222222222222224,0.0390625,0.06111111111111111
2708-2021_03_20_093103.jpg,lorry_truck,32,396,640,30,360,98,2,428,128,LTAdatasets/2708/annotate/2708-2021_03_20_093103.jpg,412.0,113.0,0.64375,0.3138888888888889,0.05,0.08333333333333333
2708-2021_03_20_093103.jpg,car,19,383,640,16,360,126,1,402,142,LTAdatasets/2708/annotate/2708-2021_03_20_093103.jpg,392.5,134.0,0.61328125,0.37222222222222223,0.0296875,0.044444444444444446
2708-2021_03_20_195136.jpg,car,19,281,640,20,360,144,1,300,164,LTAdatasets/2708/annotate/2708-2021_03_20_195136.jpg,290.5,154.0,0.45390625,0.42777777777777776,0.0296875,0.05555555555555555
2708-2021_03_20_195136.jpg,lorry_truck,25,198,640,31,360,85,2,223,116,LTAdatasets/2708/annotate/2708-2021_03_20_195136.jpg,210.5,100.5,0.32890625,0.2791666666666667,0.0390625,0.08611111111111111
2708-2021_03_20_195136.jpg,car,30,136,640,34,360,195,1,166,229,LTAdatasets/2708/annotate/2708-2021_03_20_195136.jpg,151.0,212.0,0.2359375,0.5888888888888889,0.046875,0.09444444444444444
2708-2021_03_20_195136.jpg,lorry_truck,22,116,640,34,360,117,2,138,151,LTAdatasets/2708/annotate/2708-2021_03_20_195136.jpg,127.0,134.0,0.1984375,0.37222222222222223,0.034375,0.09444444444444444
2708-2021_03_20_195136.jpg,car,18,384,640,20,360,124,1,402,144,LTAdatasets/2708/annotate/2708-2021_03_20_195136.jpg,393.0,134.0,0.6140625,0.37222222222222223,0.028125,0.05555555555555555
2708-2021_03_20_092143.jpg,lorry_truck,59,255,640,84,360,146,2,314,230,LTAdatasets/2708/annotate/2708-2021_03_20_092143.jpg,284.5,188.0,0.44453125,0.5222222222222223,0.0921875,0.23333333333333334
2708-2021_03_20_092143.jpg,car,30,131,640,32,360,188,1,161,220,LTAdatasets/2708/annotate/2708-2021_03_20_092143.jpg,146.0,204.0,0.228125,0.5666666666666667,0.046875,0.08888888888888889
2708-2021_03_20_092143.jpg,bike,24,166,640,39,360,248,4,190,287,LTAdatasets/2708/annotate/2708-2021_03_20_092143.jpg,178.0,267.5,0.278125,0.7430555555555556,0.0375,0.10833333333333334
2708-2021_03_20_092143.jpg,car,72,462,640,35,360,325,1,534,360,LTAdatasets/2708/annotate/2708-2021_03_20_092143.jpg,498.0,342.5,0.778125,0.9513888888888888,0.1125,0.09722222222222222
2708-2021_03_20_092143.jpg,car,32,448,640,31,360,157,1,480,188,LTAdatasets/2708/annotate/2708-2021_03_20_092143.jpg,464.0,172.5,0.725,0.4791666666666667,0.05,0.08611111111111111
2708-2021_03_20_083120.jpg,car,26,320,640,31,360,135,1,346,166,LTAdatasets/2708/annotate/2708-2021_03_20_083120.jpg,333.0,150.5,0.5203125,0.41805555555555557,0.040625,0.08611111111111111
2708-2021_03_20_083120.jpg,van,31,609,640,43,360,208,3,640,251,LTAdatasets/2708/annotate/2708-2021_03_20_083120.jpg,624.5,229.5,0.97578125,0.6375,0.0484375,0.11944444444444445
2708-2021_03_20_083120.jpg,bike,15,406,640,17,360,135,4,421,152,LTAdatasets/2708/annotate/2708-2021_03_20_083120.jpg,413.5,143.5,0.64609375,0.39861111111111114,0.0234375,0.04722222222222222
2708-2021_03_20_083120.jpg,bike,8,415,640,20,360,110,4,423,130,LTAdatasets/2708/annotate/2708-2021_03_20_083120.jpg,419.0,120.0,0.6546875,0.3333333333333333,0.0125,0.05555555555555555
2708-2021_03_20_083120.jpg,car,21,244,640,12,360,88,1,265,100,LTAdatasets/2708/annotate/2708-2021_03_20_083120.jpg,254.5,94.0,0.39765625,0.2611111111111111,0.0328125,0.03333333333333333
2708-2021_03_20_083120.jpg,van,13,194,640,16,360,79,3,207,95,LTAdatasets/2708/annotate/2708-2021_03_20_083120.jpg,200.5,87.0,0.31328125,0.24166666666666667,0.0203125,0.044444444444444446
2708-2021_03_20_194916.jpg,car,31,393,640,28,360,124,1,424,152,LTAdatasets/2708/annotate/2708-2021_03_20_194916.jpg,408.5,138.0,0.63828125,0.38333333333333336,0.0484375,0.07777777777777778
2708-2021_03_20_194916.jpg,lorry_truck,21,619,640,58,360,171,2,640,229,LTAdatasets/2708/annotate/2708-2021_03_20_194916.jpg,629.5,200.0,0.98359375,0.5555555555555556,0.0328125,0.16111111111111112
2708-2021_03_20_194916.jpg,car,25,234,640,21,360,97,1,259,118,LTAdatasets/2708/annotate/2708-2021_03_20_194916.jpg,246.5,107.5,0.38515625,0.2986111111111111,0.0390625,0.058333333333333334
2708-2021_03_20_194916.jpg,bike,11,220,640,10,360,86,4,231,96,LTAdatasets/2708/annotate/2708-2021_03_20_194916.jpg,225.5,91.0,0.35234375,0.25277777777777777,0.0171875,0.027777777777777776
2708-2021_03_20_194916.jpg,lorry_truck,24,116,640,25,360,88,2,140,113,LTAdatasets/2708/annotate/2708-2021_03_20_194916.jpg,128.0,100.5,0.2,0.2791666666666667,0.0375,0.06944444444444445
